"degree";"indegree";"outdegree";"id_community";"period";"id_user"
"6";"1";"5";"9";"72";"28087"
"256";"193";"63";"9";"72";"28090"
"17";"8";"9";"9";"72";"28093"
"49";"30";"19";"9";"72";"28096"
"2";"1";"1";"9";"72";"28098"
"6";"1";"5";"9";"72";"28100"
"17";"2";"15";"9";"72";"28101"
"5";"1";"4";"9";"72";"28102"
"3";"0";"3";"9";"72";"28103"
"1";"1";"0";"9";"72";"28106"
"6";"4";"2";"9";"72";"28107"
"50";"28";"22";"9";"72";"28108"
"8";"1";"7";"9";"72";"28109"
"135";"63";"72";"9";"72";"28111"
"9";"2";"7";"9";"72";"28112"
"9";"5";"4";"9";"72";"28114"
"25";"14";"11";"9";"72";"28117"
"2";"0";"2";"9";"72";"28118"
"14";"11";"3";"9";"72";"28119"
"20";"5";"15";"9";"72";"28120"
"3";"2";"1";"9";"72";"28121"
"3";"3";"0";"9";"72";"28124"
"12";"2";"10";"9";"72";"28125"
"156";"78";"78";"9";"72";"28126"
"8";"3";"5";"9";"72";"28127"
"14";"6";"8";"9";"72";"28128"
"10";"4";"6";"9";"72";"28129"
"30";"19";"11";"9";"72";"28131"
"15";"4";"11";"9";"72";"28132"
"14";"9";"5";"9";"72";"28133"
"4";"0";"4";"9";"72";"28137"
"188";"140";"48";"9";"72";"28139"
"3";"0";"3";"9";"72";"28140"
"25";"15";"10";"9";"72";"28141"
"1";"1";"0";"9";"72";"28142"
"7";"0";"7";"9";"72";"28143"
"38";"1";"37";"9";"72";"28144"
"2";"2";"0";"9";"72";"28145"
"83";"45";"38";"9";"72";"28148"
"53";"37";"16";"9";"72";"28149"
"54";"34";"20";"9";"72";"28150"
"345";"258";"87";"9";"72";"28151"
"56";"41";"15";"9";"72";"28154"
"7";"3";"4";"9";"72";"28155"
"2";"0";"2";"9";"72";"28158"
"2";"2";"0";"9";"72";"28159"
"10";"5";"5";"9";"72";"28160"
"123";"56";"67";"9";"72";"28162"
"7";"4";"3";"9";"72";"28163"
"42";"11";"31";"9";"72";"28165"
"1";"1";"0";"9";"72";"28166"
"227";"107";"120";"9";"72";"28167"
"62";"44";"18";"9";"72";"28168"
"4";"0";"4";"9";"72";"28170"
"15";"3";"12";"9";"72";"28171"
"4";"2";"2";"9";"72";"28172"
"5";"3";"2";"9";"72";"28173"
"14";"3";"11";"9";"72";"28176"
"17";"7";"10";"9";"72";"28177"
"10";"4";"6";"9";"72";"28180"
"1";"0";"1";"9";"72";"28182"
"47";"4";"43";"9";"72";"28184"
"7";"3";"4";"9";"72";"28185"
"2";"2";"0";"9";"72";"28187"
"449";"351";"98";"9";"72";"28188"
"1";"1";"0";"9";"72";"28190"
"133";"85";"48";"9";"72";"28191"
"14";"4";"10";"9";"72";"28193"
"371";"312";"59";"9";"72";"28194"
"15";"7";"8";"9";"72";"28196"
"8";"5";"3";"9";"72";"28199"
"3";"1";"2";"9";"72";"28200"
"2";"1";"1";"9";"72";"28202"
"18";"3";"15";"9";"72";"28205"
"5";"2";"3";"9";"72";"28207"
"38";"20";"18";"9";"72";"28208"
"11";"4";"7";"9";"72";"28211"
"4";"0";"4";"9";"72";"28213"
"73";"49";"24";"9";"72";"28215"
"9";"5";"4";"9";"72";"28216"
"4";"1";"3";"9";"72";"28217"
"1";"0";"1";"9";"72";"28218"
"1";"0";"1";"9";"72";"28221"
"9";"6";"3";"9";"72";"28223"
"71";"16";"55";"9";"72";"28224"
"18";"8";"10";"9";"72";"28226"
"13";"3";"10";"9";"72";"28227"
"1";"1";"0";"9";"72";"28229"
"62";"13";"49";"9";"72";"28230"
"30";"19";"11";"9";"72";"28232"
"1";"0";"1";"9";"72";"28235"
"56";"13";"43";"9";"72";"28236"
"8";"2";"6";"9";"72";"28238"
"5";"1";"4";"9";"72";"28239"
"6";"0";"6";"9";"72";"28242"
"183";"145";"38";"9";"72";"28244"
"4";"2";"2";"9";"72";"28245"
"1";"1";"0";"9";"72";"28249"
"30";"15";"15";"9";"72";"28250"
"9";"2";"7";"9";"72";"28251"
"56";"26";"30";"9";"72";"28255"
"10";"4";"6";"9";"72";"28258"
"45";"27";"18";"9";"72";"28262"
"31";"10";"21";"9";"72";"28263"
"8";"2";"6";"9";"72";"28265"
"44";"31";"13";"9";"72";"28269"
"5";"2";"3";"9";"72";"28271"
"1";"1";"0";"9";"72";"28275"
"2";"1";"1";"9";"72";"28276"
"5";"3";"2";"9";"72";"28277"
"46";"9";"37";"9";"72";"28278"
"36";"19";"17";"9";"72";"28279"
"27";"3";"24";"9";"72";"28280"
"8";"3";"5";"9";"72";"28282"
"1";"1";"0";"9";"72";"28284"
"7";"1";"6";"9";"72";"28285"
"32";"18";"14";"9";"72";"28292"
"2";"0";"2";"9";"72";"28294"
"45";"41";"4";"9";"72";"28295"
"38";"17";"21";"9";"72";"28296"
"13";"4";"9";"9";"72";"28297"
"11";"2";"9";"9";"72";"28298"
"42";"15";"27";"9";"72";"28299"
"6";"0";"6";"9";"72";"28301"
"4";"3";"1";"9";"72";"28303"
"176";"133";"43";"9";"72";"28304"
"14";"5";"9";"9";"72";"28306"
"6";"1";"5";"9";"72";"28307"
"2";"2";"0";"9";"72";"28308"
"4";"2";"2";"9";"72";"28310"
"105";"40";"65";"9";"72";"28311"
"68";"43";"25";"9";"72";"28312"
"10";"3";"7";"9";"72";"28316"
"15";"4";"11";"9";"72";"28318"
"11";"3";"8";"9";"72";"28319"
"1";"1";"0";"9";"72";"28322"
"17";"3";"14";"9";"72";"28323"
"13";"11";"2";"9";"72";"28324"
"2";"0";"2";"9";"72";"28325"
"10";"2";"8";"9";"72";"28331"
"2";"2";"0";"9";"72";"28333"
"13";"4";"9";"9";"72";"28335"
"37";"4";"33";"9";"72";"28336"
"2";"1";"1";"9";"72";"28337"
"2";"1";"1";"9";"72";"28338"
"10";"7";"3";"9";"72";"28348"
"21";"12";"9";"9";"72";"28349"
"22";"13";"9";"9";"72";"28354"
"6";"2";"4";"9";"72";"28355"
"1";"0";"1";"9";"72";"28356"
"2";"0";"2";"9";"72";"28358"
"1";"1";"0";"9";"72";"28363"
"4";"2";"2";"9";"72";"28364"
"6";"6";"0";"9";"72";"28366"
"15";"1";"14";"9";"72";"28367"
"18";"5";"13";"9";"72";"28369"
"15";"6";"9";"9";"72";"28371"
"2";"0";"2";"9";"72";"28372"
"165";"68";"97";"9";"72";"28375"
"9";"4";"5";"9";"72";"28376"
"2";"1";"1";"9";"72";"28378"
"1";"0";"1";"9";"72";"28380"
"2";"2";"0";"9";"72";"28381"
"4";"2";"2";"9";"72";"28382"
"3";"1";"2";"9";"72";"28384"
"4";"0";"4";"9";"72";"28385"
"8";"2";"6";"9";"72";"28387"
"2";"0";"2";"9";"72";"28388"
"1";"1";"0";"9";"72";"28389"
"15";"3";"12";"9";"72";"28391"
"3";"0";"3";"9";"72";"28392"
"6";"1";"5";"9";"72";"28394"
"3";"3";"0";"9";"72";"28398"
"3";"0";"3";"9";"72";"28400"
"8";"6";"2";"9";"72";"28403"
"130";"62";"68";"9";"72";"28405"
"3";"1";"2";"9";"72";"28406"
"15";"3";"12";"9";"72";"28407"
"1";"1";"0";"9";"72";"28408"
"13";"3";"10";"9";"72";"28409"
"11";"11";"0";"9";"72";"28411"
"1";"0";"1";"9";"72";"28412"
"8";"5";"3";"9";"72";"28414"
"13";"4";"9";"9";"72";"28416"
"1";"1";"0";"9";"72";"28418"
"20";"1";"19";"9";"72";"28422"
"1";"1";"0";"9";"72";"28427"
"2";"0";"2";"9";"72";"28429"
"44";"17";"27";"9";"72";"28430"
"1";"1";"0";"9";"72";"28431"
"1";"1";"0";"9";"72";"28435"
"5";"2";"3";"9";"72";"28438"
"2";"1";"1";"9";"72";"28441"
"2";"2";"0";"9";"72";"28442"
"2";"0";"2";"9";"72";"28443"
"1";"1";"0";"9";"72";"28448"
"207";"111";"96";"9";"72";"28450"
"2";"1";"1";"9";"72";"28452"
"39";"8";"31";"9";"72";"28453"
"3";"2";"1";"9";"72";"28455"
"11";"4";"7";"9";"72";"28457"
"11";"6";"5";"9";"72";"28460"
"10";"1";"9";"9";"72";"28463"
"6";"2";"4";"9";"72";"28465"
"2";"1";"1";"9";"72";"28467"
"117";"44";"73";"9";"72";"28468"
"4";"3";"1";"9";"72";"28469"
"23";"3";"20";"9";"72";"28470"
"2";"0";"2";"9";"72";"28471"
"7";"3";"4";"9";"72";"28473"
"15";"4";"11";"9";"72";"28475"
"3";"1";"2";"9";"72";"28479"
"2";"0";"2";"9";"72";"28480"
"1";"1";"0";"9";"72";"28481"
"1";"0";"1";"9";"72";"28482"
"165";"101";"64";"9";"72";"28488"
"4";"0";"4";"9";"72";"28490"
"2";"1";"1";"9";"72";"28492"
"7";"1";"6";"9";"72";"28493"
"1";"1";"0";"9";"72";"28494"
"96";"59";"37";"9";"72";"28497"
"25";"13";"12";"9";"72";"28498"
"2";"2";"0";"9";"72";"28499"
"3";"2";"1";"9";"72";"28502"
"8";"6";"2";"9";"72";"28503"
"2";"1";"1";"9";"72";"28505"
"1";"1";"0";"9";"72";"28506"
"178";"134";"44";"9";"72";"28509"
"18";"8";"10";"9";"72";"28510"
"4";"2";"2";"9";"72";"28511"
"5";"1";"4";"9";"72";"28513"
"16";"3";"13";"9";"72";"28515"
"2";"1";"1";"9";"72";"28516"
"4";"2";"2";"9";"72";"28517"
"5";"5";"0";"9";"72";"28519"
"34";"17";"17";"9";"72";"28523"
"6";"3";"3";"9";"72";"28525"
"1";"0";"1";"9";"72";"28530"
"9";"2";"7";"9";"72";"28532"
"6";"3";"3";"9";"72";"28535"
"6";"1";"5";"9";"72";"28536"
"1";"1";"0";"9";"72";"28537"
"3";"1";"2";"9";"72";"28539"
"9";"2";"7";"9";"72";"28540"
"8";"2";"6";"9";"72";"28542"
"78";"41";"37";"9";"72";"28544"
"4";"1";"3";"9";"72";"28545"
"7";"1";"6";"9";"72";"28546"
"15";"3";"12";"9";"72";"28548"
"1";"1";"0";"9";"72";"28550"
"1";"1";"0";"9";"72";"28551"
"6";"3";"3";"9";"72";"28552"
"34";"21";"13";"9";"72";"28554"
"1";"1";"0";"9";"72";"28556"
"4";"1";"3";"9";"72";"28562"
"4";"3";"1";"9";"72";"28568"
"1";"1";"0";"9";"72";"28569"
"9";"6";"3";"9";"72";"28570"
"1";"1";"0";"9";"72";"28571"
"1";"1";"0";"9";"72";"28572"
"5";"2";"3";"9";"72";"28574"
"99";"66";"33";"9";"72";"28579"
"180";"114";"66";"9";"72";"28584"
"7";"2";"5";"9";"72";"28585"
"42";"20";"22";"9";"72";"28586"
"5";"2";"3";"9";"72";"28587"
"1";"1";"0";"9";"72";"28588"
"7";"0";"7";"9";"72";"28590"
"2";"0";"2";"9";"72";"28592"
"6";"3";"3";"9";"72";"28594"
"6";"1";"5";"9";"72";"28596"
"63";"20";"43";"9";"72";"28597"
"2";"1";"1";"9";"72";"28599"
"37";"4";"33";"9";"72";"28600"
"66";"19";"47";"9";"72";"28602"
"9";"5";"4";"9";"72";"28603"
"8";"4";"4";"9";"72";"28606"
"14";"3";"11";"9";"72";"28607"
"2";"0";"2";"9";"72";"28609"
"9";"1";"8";"9";"72";"28611"
"4";"2";"2";"9";"72";"28612"
"3";"0";"3";"9";"72";"28613"
"10";"0";"10";"9";"72";"28614"
"3";"0";"3";"9";"72";"28615"
"6";"3";"3";"9";"72";"28616"
"18";"4";"14";"9";"72";"28617"
"202";"51";"151";"9";"72";"28618"
"11";"2";"9";"9";"72";"28619"
"3";"1";"2";"9";"72";"28620"
"4";"0";"4";"9";"72";"28621"
"32";"11";"21";"9";"72";"28624"
"7";"2";"5";"9";"72";"28625"
"20";"7";"13";"9";"72";"28626"
"32";"26";"6";"9";"72";"28627"
"3";"1";"2";"9";"72";"28629"
"1";"0";"1";"9";"72";"28634"
"6";"0";"6";"9";"72";"28635"
"3";"1";"2";"9";"72";"28637"
"7";"1";"6";"9";"72";"28638"
"6";"1";"5";"9";"72";"28639"
"14";"2";"12";"9";"72";"28640"
"3";"0";"3";"9";"72";"28642"
"4";"2";"2";"9";"72";"28643"
"23";"2";"21";"9";"72";"28646"
"11";"4";"7";"9";"72";"28647"
"4";"0";"4";"9";"72";"28648"
"15";"1";"14";"9";"72";"28649"
"4";"1";"3";"9";"72";"28653"
"3";"1";"2";"9";"72";"28656"
"2";"0";"2";"9";"72";"28658"
"1";"0";"1";"9";"72";"28659"
"37";"2";"35";"9";"72";"28660"
"4";"1";"3";"9";"72";"28661"
"11";"3";"8";"9";"72";"28663"
"20";"7";"13";"9";"72";"28664"
"1";"1";"0";"9";"72";"28667"
"1";"1";"0";"9";"72";"28668"
"1";"0";"1";"9";"72";"28670"
"1";"1";"0";"9";"72";"28673"
"1";"1";"0";"9";"72";"28675"
"8";"1";"7";"9";"72";"28679"
"4";"0";"4";"9";"72";"28682"
"19";"12";"7";"9";"72";"28683"
"1";"1";"0";"9";"72";"28684"
"3";"0";"3";"9";"72";"28685"
"26";"15";"11";"9";"72";"28687"
"3";"0";"3";"9";"72";"28688"
"6";"2";"4";"9";"72";"28690"
"62";"22";"40";"9";"72";"28691"
"2";"0";"2";"9";"72";"28693"
"1";"1";"0";"9";"72";"28694"
"2";"0";"2";"9";"72";"28697"
"27";"3";"24";"9";"72";"28699"
"4";"2";"2";"9";"72";"28700"
"6";"4";"2";"9";"72";"28702"
"31";"10";"21";"9";"72";"28704"
"2";"1";"1";"9";"72";"28706"
"5";"1";"4";"9";"72";"28709"
"43";"5";"38";"9";"72";"28711"
"1";"1";"0";"9";"72";"28712"
"8";"1";"7";"9";"72";"28714"
"5";"3";"2";"9";"72";"28716"
"1";"1";"0";"9";"72";"28717"
"4";"1";"3";"9";"72";"28718"
"24";"18";"6";"9";"72";"28719"
"10";"0";"10";"9";"72";"28721"
"6";"1";"5";"9";"72";"28722"
"11";"3";"8";"9";"72";"28723"
"8";"7";"1";"9";"72";"28724"
"1";"1";"0";"9";"72";"28725"
"8";"4";"4";"9";"72";"28726"
"6";"2";"4";"9";"72";"28729"
"3";"3";"0";"9";"72";"28730"
"6";"2";"4";"9";"72";"28731"
"3";"1";"2";"9";"72";"28732"
"3";"0";"3";"9";"72";"28733"
"8";"6";"2";"9";"72";"28737"
"3";"1";"2";"9";"72";"28743"
"2";"2";"0";"9";"72";"28745"
"18";"2";"16";"9";"72";"28747"
"3";"3";"0";"9";"72";"28755"
"3";"1";"2";"9";"72";"28756"
"6";"2";"4";"9";"72";"28758"
"10";"2";"8";"9";"72";"28759"
"187";"120";"67";"9";"72";"28760"
"1";"0";"1";"9";"72";"28762"
"1";"0";"1";"9";"72";"28763"
"17";"8";"9";"9";"72";"28764"
"6";"1";"5";"9";"72";"28765"
"18";"5";"13";"9";"72";"28766"
"6";"3";"3";"9";"72";"28768"
"15";"5";"10";"9";"72";"28770"
"20";"15";"5";"9";"72";"28772"
"8";"2";"6";"9";"72";"28773"
"10";"6";"4";"9";"72";"28774"
"9";"3";"6";"9";"72";"28775"
"4";"1";"3";"9";"72";"28776"
"18";"11";"7";"9";"72";"28777"
"7";"4";"3";"9";"72";"28778"
"38";"27";"11";"9";"72";"28784"
"1";"0";"1";"9";"72";"28788"
"21";"5";"16";"9";"72";"28789"
"2";"0";"2";"9";"72";"28794"
"7";"3";"4";"9";"72";"28795"
"3";"0";"3";"9";"72";"28796"
"6";"0";"6";"9";"72";"28797"
"3";"2";"1";"9";"72";"28798"
"7";"1";"6";"9";"72";"28799"
"20";"4";"16";"9";"72";"28801"
"134";"79";"55";"9";"72";"28802"
"15";"2";"13";"9";"72";"28805"
"1";"0";"1";"9";"72";"28807"
"13";"3";"10";"9";"72";"28808"
"4";"1";"3";"9";"72";"28811"
"27";"14";"13";"9";"72";"28815"
"2";"0";"2";"9";"72";"28816"
"8";"2";"6";"9";"72";"28820"
"267";"197";"70";"9";"72";"28821"
"7";"2";"5";"9";"72";"28823"
"56";"28";"28";"9";"72";"28825"
"1";"1";"0";"9";"72";"28828"
"30";"11";"19";"9";"72";"28829"
"14";"3";"11";"9";"72";"28830"
"9";"0";"9";"9";"72";"28831"
"24";"13";"11";"9";"72";"28832"
"5";"2";"3";"9";"72";"28833"
"3";"0";"3";"9";"72";"28834"
"9";"2";"7";"9";"72";"28835"
"3";"0";"3";"9";"72";"28837"
"11";"6";"5";"9";"72";"28839"
"34";"22";"12";"9";"72";"28840"
"3";"2";"1";"9";"72";"28841"
"2";"1";"1";"9";"72";"28843"
"5";"1";"4";"9";"72";"28844"
"2";"1";"1";"9";"72";"28845"
"1";"1";"0";"9";"72";"28846"
"6";"1";"5";"9";"72";"28847"
"11";"2";"9";"9";"72";"28848"
"15";"5";"10";"9";"72";"28849"
"2";"1";"1";"9";"72";"28851"
"23";"5";"18";"9";"72";"28852"
"13";"9";"4";"9";"72";"28853"
"2";"2";"0";"9";"72";"28855"
"22";"9";"13";"9";"72";"28856"
"6";"1";"5";"9";"72";"28857"
"1";"0";"1";"9";"72";"28858"
"2";"2";"0";"9";"72";"28859"
"35";"23";"12";"9";"72";"28861"
"11";"3";"8";"9";"72";"28870"
"1";"1";"0";"9";"72";"28871"
"19";"5";"14";"9";"72";"28873"
"34";"8";"26";"9";"72";"28875"
"13";"6";"7";"9";"72";"28876"
"1";"0";"1";"9";"72";"28877"
"13";"1";"12";"9";"72";"28881"
"8";"1";"7";"9";"72";"28882"
"4";"1";"3";"9";"72";"28884"
"10";"2";"8";"9";"72";"28889"
"16";"3";"13";"9";"72";"28891"
"7";"2";"5";"9";"72";"28892"
"4";"1";"3";"9";"72";"28893"
"1";"0";"1";"9";"72";"28894"
"8";"3";"5";"9";"72";"28895"
"5";"4";"1";"9";"72";"28897"
"1";"1";"0";"9";"72";"28904"
"1";"0";"1";"9";"72";"28906"
"2";"1";"1";"9";"72";"28907"
"2";"0";"2";"9";"72";"28909"
"5";"2";"3";"9";"72";"28910"
"2";"0";"2";"9";"72";"28914"
"6";"4";"2";"9";"72";"28915"
"1";"0";"1";"9";"72";"28916"
"4";"0";"4";"9";"72";"28917"
"2";"2";"0";"9";"72";"28918"
"1";"1";"0";"9";"72";"28919"
"1";"1";"0";"9";"72";"28922"
"2";"0";"2";"9";"72";"28923"
"9";"2";"7";"9";"72";"28924"
"3";"1";"2";"9";"72";"28925"
"8";"1";"7";"9";"72";"28926"
"11";"9";"2";"9";"72";"28928"
"10";"1";"9";"9";"72";"28929"
"2";"2";"0";"9";"72";"28931"
"6";"3";"3";"9";"72";"28932"
"4";"1";"3";"9";"72";"28935"
"8";"3";"5";"9";"72";"28936"
"1";"1";"0";"9";"72";"28940"
"6";"2";"4";"9";"72";"28941"
"4";"3";"1";"9";"72";"28942"
"9";"1";"8";"9";"72";"28943"
"20";"5";"15";"9";"72";"28944"
"5";"1";"4";"9";"72";"28945"
"1";"0";"1";"9";"72";"28947"
"7";"1";"6";"9";"72";"28948"
"1";"1";"0";"9";"72";"28949"
"13";"2";"11";"9";"72";"28950"
"943";"794";"149";"9";"72";"28951"
"5";"1";"4";"9";"72";"28954"
"10";"2";"8";"9";"72";"28955"
"13";"8";"5";"9";"72";"28956"
"6";"1";"5";"9";"72";"28958"
"8";"5";"3";"9";"72";"28959"
"8";"4";"4";"9";"72";"28960"
"7";"3";"4";"9";"72";"28962"
"2";"1";"1";"9";"72";"28966"
"9";"1";"8";"9";"72";"28971"
"10";"3";"7";"9";"72";"28973"
"25";"17";"8";"9";"72";"28974"
"5";"0";"5";"9";"72";"28976"
"27";"10";"17";"9";"72";"28977"
"2";"0";"2";"9";"72";"28979"
"1";"1";"0";"9";"72";"28982"
"5";"0";"5";"9";"72";"28985"
"18";"3";"15";"9";"72";"28988"
"7";"0";"7";"9";"72";"28989"
"57";"42";"15";"9";"72";"28990"
"10";"4";"6";"9";"72";"28991"
"9";"2";"7";"9";"72";"28992"
"4";"1";"3";"9";"72";"28994"
"44";"26";"18";"9";"72";"28995"
"1";"1";"0";"9";"72";"28999"
"11";"2";"9";"9";"72";"29001"
"18";"11";"7";"9";"72";"29002"
"124";"24";"100";"9";"72";"29003"
"12";"4";"8";"9";"72";"29004"
"3";"0";"3";"9";"72";"29008"
"11";"1";"10";"9";"72";"29009"
"5";"1";"4";"9";"72";"29011"
"2";"1";"1";"9";"72";"29012"
"4";"1";"3";"9";"72";"29013"
"4";"1";"3";"9";"72";"29014"
"2";"2";"0";"9";"72";"29015"
"2";"2";"0";"9";"72";"29017"
"4";"1";"3";"9";"72";"29018"
"2";"1";"1";"9";"72";"29019"
"1";"1";"0";"9";"72";"29022"
"5";"1";"4";"9";"72";"29024"
"1";"1";"0";"9";"72";"29025"
"1";"0";"1";"9";"72";"29028"
"5";"2";"3";"9";"72";"29029"
"4";"1";"3";"9";"72";"29030"
"7";"2";"5";"9";"72";"29031"
"7";"0";"7";"9";"72";"29032"
"5";"1";"4";"9";"72";"29036"
"21";"6";"15";"9";"72";"29037"
"2";"0";"2";"9";"72";"29038"
"7";"0";"7";"9";"72";"29039"
"12";"4";"8";"9";"72";"29041"
"9";"2";"7";"9";"72";"29043"
"12";"5";"7";"9";"72";"29044"
"2";"2";"0";"9";"72";"29045"
"14";"3";"11";"9";"72";"29046"
"8";"1";"7";"9";"72";"29047"
"5";"3";"2";"9";"72";"29048"
"5";"3";"2";"9";"72";"29050"
"4";"1";"3";"9";"72";"29053"
"1";"1";"0";"9";"72";"29054"
"3";"3";"0";"9";"72";"29055"
"21";"3";"18";"9";"72";"29056"
"1";"0";"1";"9";"72";"29059"
"11";"3";"8";"9";"72";"29061"
"10";"5";"5";"9";"72";"29062"
"27";"9";"18";"9";"72";"29063"
"5";"2";"3";"9";"72";"29071"
"10";"1";"9";"9";"72";"29073"
"11";"1";"10";"9";"72";"29075"
"2";"2";"0";"9";"72";"29076"
"16";"3";"13";"9";"72";"29078"
"2";"1";"1";"9";"72";"29084"
"38";"22";"16";"9";"72";"29087"
"2";"1";"1";"9";"72";"29088"
"19";"12";"7";"9";"72";"29089"
"3";"0";"3";"9";"72";"29090"
"6";"3";"3";"9";"72";"29091"
"1";"1";"0";"9";"72";"29097"
"2";"0";"2";"9";"72";"29099"
"27";"2";"25";"9";"72";"29102"
"6";"1";"5";"9";"72";"29104"
"26";"10";"16";"9";"72";"29105"
"3";"0";"3";"9";"72";"29110"
"130";"79";"51";"9";"72";"29112"
"6";"2";"4";"9";"72";"29113"
"4";"0";"4";"9";"72";"29114"
"4";"0";"4";"9";"72";"29115"
"2";"1";"1";"9";"72";"29116"
"10";"4";"6";"9";"72";"29117"
"1";"1";"0";"9";"72";"29118"
"9";"5";"4";"9";"72";"29119"
"172";"148";"24";"9";"72";"29123"
"12";"3";"9";"9";"72";"29127"
"1";"1";"0";"9";"72";"29129"
"1";"1";"0";"9";"72";"29136"
"1";"1";"0";"9";"72";"29138"
"8";"1";"7";"9";"72";"29139"
"12";"5";"7";"9";"72";"29140"
"6";"2";"4";"9";"72";"29141"
"7";"2";"5";"9";"72";"29142"
"4";"0";"4";"9";"72";"29144"
"7";"0";"7";"9";"72";"29145"
"8";"2";"6";"9";"72";"29146"
"10";"7";"3";"9";"72";"29147"
"24";"17";"7";"9";"72";"29148"
"14";"3";"11";"9";"72";"29149"
"6";"2";"4";"9";"72";"29151"
"1";"0";"1";"9";"72";"29152"
"3";"1";"2";"9";"72";"29156"
"12";"4";"8";"9";"72";"29157"
"27";"8";"19";"9";"72";"29163"
"6";"1";"5";"9";"72";"29166"
"12";"2";"10";"9";"72";"29167"
"8";"1";"7";"9";"72";"29168"
"24";"3";"21";"9";"72";"29170"
"7";"0";"7";"9";"72";"29171"
"8";"1";"7";"9";"72";"29172"
"2";"0";"2";"9";"72";"29173"
"32";"8";"24";"9";"72";"29175"
"8";"6";"2";"9";"72";"29176"
"2";"0";"2";"9";"72";"29177"
"19";"1";"18";"9";"72";"29178"
"1";"1";"0";"9";"72";"29179"
"18";"13";"5";"9";"72";"29180"
"14";"2";"12";"9";"72";"29181"
"5";"3";"2";"9";"72";"29184"
"16";"10";"6";"9";"72";"29188"
"2";"0";"2";"9";"72";"29189"
"24";"3";"21";"9";"72";"29193"
"31";"5";"26";"9";"72";"29199"
"5";"5";"0";"9";"72";"29200"
"5";"1";"4";"9";"72";"29201"
"275";"178";"97";"9";"72";"29205"
"15";"1";"14";"9";"72";"29209"
"2";"0";"2";"9";"72";"29213"
"7";"2";"5";"9";"72";"29214"
"14";"8";"6";"9";"72";"29221"
"9";"4";"5";"9";"72";"29222"
"14";"8";"6";"9";"72";"29223"
"6";"1";"5";"9";"72";"29224"
"11";"2";"9";"9";"72";"29226"
"4";"0";"4";"9";"72";"29228"
"6";"2";"4";"9";"72";"29233"
"8";"3";"5";"9";"72";"29234"
"3";"1";"2";"9";"72";"29235"
"2";"0";"2";"9";"72";"29236"
"1";"1";"0";"9";"72";"29239"
"5";"2";"3";"9";"72";"29240"
"2";"1";"1";"9";"72";"29242"
"34";"8";"26";"9";"72";"29245"
"22";"3";"19";"9";"72";"29246"
"3";"1";"2";"9";"72";"29247"
"20";"4";"16";"9";"72";"29249"
"5";"0";"5";"9";"72";"29250"
"3";"1";"2";"9";"72";"29251"
"13";"4";"9";"9";"72";"29254"
"5";"2";"3";"9";"72";"29255"
"5";"1";"4";"9";"72";"29256"
"2";"1";"1";"9";"72";"29260"
"5";"1";"4";"9";"72";"29261"
"8";"2";"6";"9";"72";"29262"
"28";"19";"9";"9";"72";"29265"
"1";"1";"0";"9";"72";"29266"
"5";"5";"0";"9";"72";"29267"
"14";"7";"7";"9";"72";"29268"
"8";"2";"6";"9";"72";"29269"
"2";"1";"1";"9";"72";"29270"
"560";"426";"134";"9";"72";"29271"
"13";"9";"4";"9";"72";"29272"
"8";"2";"6";"9";"72";"29273"
"7";"3";"4";"9";"72";"29275"
"1";"0";"1";"9";"72";"29277"
"3";"0";"3";"9";"72";"29278"
"4";"1";"3";"9";"72";"29279"
"626";"442";"184";"9";"72";"29284"
"5";"2";"3";"9";"72";"29287"
"15";"7";"8";"9";"72";"29288"
"2";"1";"1";"9";"72";"29289"
"5";"3";"2";"9";"72";"29290"
"2";"0";"2";"9";"72";"29293"
"4";"2";"2";"9";"72";"29295"
"3";"1";"2";"9";"72";"29298"
"2";"0";"2";"9";"72";"29299"
"18";"5";"13";"9";"72";"29301"
"2";"1";"1";"9";"72";"29306"
"1";"1";"0";"9";"72";"29307"
"7";"1";"6";"9";"72";"29312"
"1";"1";"0";"9";"72";"29313"
"1";"1";"0";"9";"72";"29314"
"4";"1";"3";"9";"72";"29315"
"10";"4";"6";"9";"72";"29317"
"7";"2";"5";"9";"72";"29320"
"4";"1";"3";"9";"72";"29321"
"2";"1";"1";"9";"72";"29322"
"8";"2";"6";"9";"72";"29325"
"1";"1";"0";"9";"72";"29326"
"17";"11";"6";"9";"72";"29328"
"114";"73";"41";"9";"72";"29329"
"15";"2";"13";"9";"72";"29330"
"7";"1";"6";"9";"72";"29332"
"55";"7";"48";"9";"72";"29333"
"2";"0";"2";"9";"72";"29334"
"6";"2";"4";"9";"72";"29337"
"4";"1";"3";"9";"72";"29338"
"5";"1";"4";"9";"72";"29339"
"1";"1";"0";"9";"72";"29341"
"10";"2";"8";"9";"72";"29342"
"8";"2";"6";"9";"72";"29345"
"6";"4";"2";"9";"72";"29347"
"6";"2";"4";"9";"72";"29348"
"1";"1";"0";"9";"72";"29351"
"1";"0";"1";"9";"72";"29352"
"6";"4";"2";"9";"72";"29353"
"1";"1";"0";"9";"72";"29358"
"3";"1";"2";"9";"72";"29360"
"4";"1";"3";"9";"72";"29361"
"1";"0";"1";"9";"72";"29362"
"9";"3";"6";"9";"72";"29363"
"30";"10";"20";"9";"72";"29367"
"6";"1";"5";"9";"72";"29372"
"4";"0";"4";"9";"72";"29373"
"1";"1";"0";"9";"72";"29374"
"6";"0";"6";"9";"72";"29375"
"1";"1";"0";"9";"72";"29376"
"5";"1";"4";"9";"72";"29377"
"56";"31";"25";"9";"72";"29379"
"12";"3";"9";"9";"72";"29380"
"7";"4";"3";"9";"72";"29381"
"11";"0";"11";"9";"72";"29382"
"16";"4";"12";"9";"72";"29384"
"26";"14";"12";"9";"72";"29387"
"1";"0";"1";"9";"72";"29388"
"1";"0";"1";"9";"72";"29389"
"7";"1";"6";"9";"72";"29390"
"91";"69";"22";"9";"72";"29392"
"2";"0";"2";"9";"72";"29393"
"5";"2";"3";"9";"72";"29394"
"7";"2";"5";"9";"72";"29398"
"45";"25";"20";"9";"72";"29400"
"11";"5";"6";"9";"72";"29401"
"5";"3";"2";"9";"72";"29402"
"2";"1";"1";"9";"72";"29403"
"23";"12";"11";"9";"72";"29406"
"8";"1";"7";"9";"72";"29407"
"17";"1";"16";"9";"72";"29408"
"1";"1";"0";"9";"72";"29411"
"10";"3";"7";"9";"72";"29415"
"10";"2";"8";"9";"72";"29417"
"87";"28";"59";"9";"72";"29419"
"12";"2";"10";"9";"72";"29421"
"3";"0";"3";"9";"72";"29423"
"9";"0";"9";"9";"72";"29427"
"5";"2";"3";"9";"72";"29428"
"3";"0";"3";"9";"72";"29429"
"5";"2";"3";"9";"72";"29430"
"134";"109";"25";"9";"72";"29432"
"14";"1";"13";"9";"72";"29434"
"10";"1";"9";"9";"72";"29435"
"5";"1";"4";"9";"72";"29436"
"1";"1";"0";"9";"72";"29438"
"8";"2";"6";"9";"72";"29440"
"2";"1";"1";"9";"72";"29441"
"2";"1";"1";"9";"72";"29444"
"3";"1";"2";"9";"72";"29445"
"2";"1";"1";"9";"72";"29446"
"8";"2";"6";"9";"72";"29447"
"2";"2";"0";"9";"72";"29449"
"3";"0";"3";"9";"72";"29451"
"3";"0";"3";"9";"72";"29457"
"9";"6";"3";"9";"72";"29458"
"1";"1";"0";"9";"72";"29459"
"9";"1";"8";"9";"72";"29460"
"2";"0";"2";"9";"72";"29461"
"11";"8";"3";"9";"72";"29462"
"15";"9";"6";"9";"72";"29463"
"1";"0";"1";"9";"72";"29464"
"9";"2";"7";"9";"72";"29465"
"6";"3";"3";"9";"72";"29467"
"1";"1";"0";"9";"72";"29469"
"2";"0";"2";"9";"72";"29470"
"5";"2";"3";"9";"72";"29473"
"3";"1";"2";"9";"72";"29474"
"21";"6";"15";"9";"72";"29475"
"3";"1";"2";"9";"72";"29476"
"1";"0";"1";"9";"72";"29481"
"2";"1";"1";"9";"72";"29482"
"2";"0";"2";"9";"72";"29484"
"1";"1";"0";"9";"72";"29485"
"1";"0";"1";"9";"72";"29487"
"5";"0";"5";"9";"72";"29489"
"1";"1";"0";"9";"72";"29490"
"1";"0";"1";"9";"72";"29493"
"5";"2";"3";"9";"72";"29494"
"2";"2";"0";"9";"72";"29496"
"2";"0";"2";"9";"72";"29498"
"5";"2";"3";"9";"72";"29499"
"3";"0";"3";"9";"72";"29501"
"6";"3";"3";"9";"72";"29502"
"1";"1";"0";"9";"72";"29504"
"9";"0";"9";"9";"72";"29505"
"8";"2";"6";"9";"72";"29508"
"1";"1";"0";"9";"72";"29509"
"104";"64";"40";"9";"72";"29510"
"3";"1";"2";"9";"72";"29512"
"2";"0";"2";"9";"72";"29514"
"45";"17";"28";"9";"72";"29515"
"11";"4";"7";"9";"72";"29516"
"10";"5";"5";"9";"72";"29517"
"3";"1";"2";"9";"72";"29518"
"4";"1";"3";"9";"72";"29520"
"691";"543";"148";"9";"72";"29521"
"2";"1";"1";"9";"72";"29522"
"6";"2";"4";"9";"72";"29524"
"11";"5";"6";"9";"72";"29527"
"5";"2";"3";"9";"72";"29531"
"10";"3";"7";"9";"72";"29534"
"23";"7";"16";"9";"72";"29535"
"4";"1";"3";"9";"72";"29536"
"6";"2";"4";"9";"72";"29537"
"2";"1";"1";"9";"72";"29542"
"3";"1";"2";"9";"72";"29543"
"19";"1";"18";"9";"72";"29545"
"8";"3";"5";"9";"72";"29548"
"10";"6";"4";"9";"72";"29549"
"1";"1";"0";"9";"72";"29550"
"4";"2";"2";"9";"72";"29551"
"3";"1";"2";"9";"72";"29553"
"1";"0";"1";"9";"72";"29557"
"3";"0";"3";"9";"72";"29561"
"62";"39";"23";"9";"72";"29562"
"7";"4";"3";"9";"72";"29564"
"7";"4";"3";"9";"72";"29569"
"4";"3";"1";"9";"72";"29576"
"3";"2";"1";"9";"72";"29578"
"2";"1";"1";"9";"72";"29579"
"6";"3";"3";"9";"72";"29580"
"10";"3";"7";"9";"72";"29581"
"8";"2";"6";"9";"72";"29584"
"1";"1";"0";"9";"72";"29585"
"6";"1";"5";"9";"72";"29586"
"25";"7";"18";"9";"72";"29587"
"5";"3";"2";"9";"72";"29588"
"2";"0";"2";"9";"72";"29592"
"6";"0";"6";"9";"72";"29593"
"4";"2";"2";"9";"72";"29595"
"12";"4";"8";"9";"72";"29596"
"1";"1";"0";"9";"72";"29601"
"14";"9";"5";"9";"72";"29602"
"4";"2";"2";"9";"72";"29605"
"9";"1";"8";"9";"72";"29606"
"2";"1";"1";"9";"72";"29609"
"7";"2";"5";"9";"72";"29612"
"26";"7";"19";"9";"72";"29615"
"7";"3";"4";"9";"72";"29616"
"27";"14";"13";"9";"72";"29617"
"2";"0";"2";"9";"72";"29618"
"6";"2";"4";"9";"72";"29619"
"4";"1";"3";"9";"72";"29621"
"1";"1";"0";"9";"72";"29622"
"1";"1";"0";"9";"72";"29625"
"1";"1";"0";"9";"72";"29626"
"11";"2";"9";"9";"72";"29627"
"1";"0";"1";"9";"72";"29630"
"2";"1";"1";"9";"72";"29632"
"2";"0";"2";"9";"72";"29633"
"3";"0";"3";"9";"72";"29634"
"1";"1";"0";"9";"72";"29638"
"1";"1";"0";"9";"72";"29643"
"13";"10";"3";"9";"72";"29644"
"5";"1";"4";"9";"72";"29649"
"2";"1";"1";"9";"72";"29654"
"14";"9";"5";"9";"72";"29655"
"178";"109";"69";"9";"72";"29656"
"30";"10";"20";"9";"72";"29660"
"28";"6";"22";"9";"72";"29661"
"14";"1";"13";"9";"72";"29662"
"1";"0";"1";"9";"72";"29665"
"19";"4";"15";"9";"72";"29666"
"1";"0";"1";"9";"72";"29667"
"7";"3";"4";"9";"72";"29668"
"4";"1";"3";"9";"72";"29669"
"3";"1";"2";"9";"72";"29670"
"1";"0";"1";"9";"72";"29676"
"5";"2";"3";"9";"72";"29677"
"1";"1";"0";"9";"72";"29678"
"4";"0";"4";"9";"72";"29680"
"3";"0";"3";"9";"72";"29682"
"4";"2";"2";"9";"72";"29683"
"3";"1";"2";"9";"72";"29684"
"1";"1";"0";"9";"72";"29685"
"7";"2";"5";"9";"72";"29686"
"18";"10";"8";"9";"72";"29689"
"16";"6";"10";"9";"72";"29690"
"6";"2";"4";"9";"72";"29692"
"3";"1";"2";"9";"72";"29694"
"9";"2";"7";"9";"72";"29695"
"1";"1";"0";"9";"72";"29696"
"15";"2";"13";"9";"72";"29697"
"72";"15";"57";"9";"72";"29699"
"4";"0";"4";"9";"72";"29700"
"3";"0";"3";"9";"72";"29702"
"1";"1";"0";"9";"72";"29704"
"4";"1";"3";"9";"72";"29705"
"4";"1";"3";"9";"72";"29707"
"2";"2";"0";"9";"72";"29711"
"31";"2";"29";"9";"72";"29712"
"4";"2";"2";"9";"72";"29720"
"3";"1";"2";"9";"72";"29722"
"19";"14";"5";"9";"72";"29723"
"1";"0";"1";"9";"72";"29725"
"32";"6";"26";"9";"72";"29727"
"6";"2";"4";"9";"72";"29731"
"1";"0";"1";"9";"72";"29735"
"31";"22";"9";"9";"72";"29736"
"2";"1";"1";"9";"72";"29737"
"12";"6";"6";"9";"72";"29738"
"20";"8";"12";"9";"72";"29739"
"2";"0";"2";"9";"72";"29740"
"29";"25";"4";"9";"72";"29741"
"5";"2";"3";"9";"72";"29742"
"2";"2";"0";"9";"72";"29743"
"7";"3";"4";"9";"72";"29745"
"12";"3";"9";"9";"72";"29747"
"8";"5";"3";"9";"72";"29748"
"3";"0";"3";"9";"72";"29749"
"2";"1";"1";"9";"72";"29750"
"5";"1";"4";"9";"72";"29751"
"10";"1";"9";"9";"72";"29752"
"1";"1";"0";"9";"72";"29753"
"2";"0";"2";"9";"72";"29754"
"9";"1";"8";"9";"72";"29755"
"1";"1";"0";"9";"72";"29756"
"2";"1";"1";"9";"72";"29757"
"2";"0";"2";"9";"72";"29758"
"2";"1";"1";"9";"72";"29759"
"2";"1";"1";"9";"72";"29763"
"8";"4";"4";"9";"72";"29765"
"6";"1";"5";"9";"72";"29766"
"1";"0";"1";"9";"72";"29768"
"2";"0";"2";"9";"72";"29769"
"2";"1";"1";"9";"72";"29771"
"2";"0";"2";"9";"72";"29772"
"13";"3";"10";"9";"72";"29773"
"8";"2";"6";"9";"72";"29774"
"10";"3";"7";"9";"72";"29778"
"7";"4";"3";"9";"72";"29780"
"10";"1";"9";"9";"72";"29781"
"6";"1";"5";"9";"72";"29782"
"4";"1";"3";"9";"72";"29783"
"36";"18";"18";"9";"72";"29784"
"5";"1";"4";"9";"72";"29786"
"4";"2";"2";"9";"72";"29788"
"12";"3";"9";"9";"72";"29790"
"2";"0";"2";"9";"72";"29791"
"7";"3";"4";"9";"72";"29792"
"91";"22";"69";"9";"72";"29793"
"32";"14";"18";"9";"72";"29794"
"9";"1";"8";"9";"72";"29795"
"1";"0";"1";"9";"72";"29796"
"4";"2";"2";"9";"72";"29800"
"2";"0";"2";"9";"72";"29804"
"7";"2";"5";"9";"72";"29805"
"2";"1";"1";"9";"72";"29806"
"2";"0";"2";"9";"72";"29808"
"166";"105";"61";"9";"72";"29809"
"1";"1";"0";"9";"72";"29810"
"3";"1";"2";"9";"72";"29811"
"2";"1";"1";"9";"72";"29812"
"4";"1";"3";"9";"72";"29814"
"2";"0";"2";"9";"72";"29815"
"1";"0";"1";"9";"72";"29817"
"4";"4";"0";"9";"72";"29819"
"4";"0";"4";"9";"72";"29822"
"6";"3";"3";"9";"72";"29823"
"4";"3";"1";"9";"72";"29825"
"13";"3";"10";"9";"72";"29826"
"4";"0";"4";"9";"72";"29827"
"2";"0";"2";"9";"72";"29829"
"2";"1";"1";"9";"72";"29830"
"5";"0";"5";"9";"72";"29835"
"2";"0";"2";"9";"72";"29836"
"1";"1";"0";"9";"72";"29838"
"6";"0";"6";"9";"72";"29840"
"1";"0";"1";"9";"72";"29841"
"1";"0";"1";"9";"72";"29842"
"1";"1";"0";"9";"72";"29844"
"1";"0";"1";"9";"72";"29848"
"2";"0";"2";"9";"72";"29851"
"11";"2";"9";"9";"72";"29853"
"1";"1";"0";"9";"72";"29854"
"1";"1";"0";"9";"72";"29855"
"5";"1";"4";"9";"72";"29856"
"5";"0";"5";"9";"72";"29859"
"3";"0";"3";"9";"72";"29861"
"2";"1";"1";"9";"72";"29862"
"1";"0";"1";"9";"72";"29863"
"63";"40";"23";"9";"72";"29864"
"1";"1";"0";"9";"72";"29865"
"10";"5";"5";"9";"72";"29866"
"1";"1";"0";"9";"72";"29868"
"3";"3";"0";"9";"72";"29869"
"2";"0";"2";"9";"72";"29871"
"8";"1";"7";"9";"72";"29874"
"1";"0";"1";"9";"72";"29875"
"9";"3";"6";"9";"72";"29876"
"5";"0";"5";"9";"72";"29877"
"6";"2";"4";"9";"72";"29879"
"1";"1";"0";"9";"72";"29880"
"5";"2";"3";"9";"72";"29881"
"1";"1";"0";"9";"72";"29883"
"1";"1";"0";"9";"72";"29884"
"2";"1";"1";"9";"72";"29886"
"6";"1";"5";"9";"72";"29887"
"8";"4";"4";"9";"72";"29890"
"4";"0";"4";"9";"72";"29892"
"23";"10";"13";"9";"72";"29893"
"6";"2";"4";"9";"72";"29895"
"4";"2";"2";"9";"72";"29896"
"34";"12";"22";"9";"72";"29898"
"3";"1";"2";"9";"72";"29900"
"20";"7";"13";"9";"72";"29903"
"3";"1";"2";"9";"72";"29904"
"3";"0";"3";"9";"72";"29905"
"1";"0";"1";"9";"72";"29906"
"2";"0";"2";"9";"72";"29907"
"6";"0";"6";"9";"72";"29908"
"3";"0";"3";"9";"72";"29909"
"20";"8";"12";"9";"72";"29910"
"7";"2";"5";"9";"72";"29912"
"64";"31";"33";"9";"72";"29913"
"1";"1";"0";"9";"72";"29914"
"8";"2";"6";"9";"72";"29915"
"3";"0";"3";"9";"72";"29916"
"4";"1";"3";"9";"72";"29917"
"1";"0";"1";"9";"72";"29918"
"166";"122";"44";"9";"72";"29919"
"25";"17";"8";"9";"72";"29921"
"1";"0";"1";"9";"72";"29922"
"4";"1";"3";"9";"72";"29923"
"2";"0";"2";"9";"72";"29925"
"1";"1";"0";"9";"72";"29927"
"6";"3";"3";"9";"72";"29930"
"2";"0";"2";"9";"72";"29931"
"16";"3";"13";"9";"72";"29932"
"4";"1";"3";"9";"72";"29935"
"6";"1";"5";"9";"72";"29936"
"8";"2";"6";"9";"72";"29940"
"6";"2";"4";"9";"72";"29943"
"1";"1";"0";"9";"72";"29944"
"2";"2";"0";"9";"72";"29945"
"3";"0";"3";"9";"72";"29946"
"6";"1";"5";"9";"72";"29947"
"5";"1";"4";"9";"72";"29948"
"2";"0";"2";"9";"72";"29951"
"2";"0";"2";"9";"72";"29953"
"7";"1";"6";"9";"72";"29954"
"2";"0";"2";"9";"72";"29955"
"1";"0";"1";"9";"72";"29956"
"4";"1";"3";"9";"72";"29957"
"1";"1";"0";"9";"72";"29958"
"3";"3";"0";"9";"72";"29961"
"1";"0";"1";"9";"72";"29962"
"6";"2";"4";"9";"72";"29963"
"1";"0";"1";"9";"72";"29964"
"5";"1";"4";"9";"72";"29965"
"1";"1";"0";"9";"72";"29967"
"3";"0";"3";"9";"72";"29968"
"6";"0";"6";"9";"72";"29969"
"17";"10";"7";"9";"72";"29970"
"33";"8";"25";"9";"72";"29971"
"23";"16";"7";"9";"72";"29972"
"16";"3";"13";"9";"72";"29973"
"2";"0";"2";"9";"72";"29975"
"3";"0";"3";"9";"72";"29976"
"6";"3";"3";"9";"72";"29979"
"2";"1";"1";"9";"72";"29980"
"5";"2";"3";"9";"72";"29982"
"1";"1";"0";"9";"72";"29984"
"5";"2";"3";"9";"72";"29985"
"4";"0";"4";"9";"72";"29986"
"16";"9";"7";"9";"72";"29987"
"2";"0";"2";"9";"72";"29988"
"35";"5";"30";"9";"72";"29989"
"2";"0";"2";"9";"72";"29990"
"7";"0";"7";"9";"72";"29994"
"6";"4";"2";"9";"72";"29998"
"2";"2";"0";"9";"72";"30003"
"5";"1";"4";"9";"72";"30005"
"6";"0";"6";"9";"72";"30008"
"1";"1";"0";"9";"72";"30009"
"3";"0";"3";"9";"72";"30010"
"12";"4";"8";"9";"72";"30011"
"1";"1";"0";"9";"72";"30014"
"4";"2";"2";"9";"72";"30015"
"2";"0";"2";"9";"72";"30016"
"5";"2";"3";"9";"72";"30019"
"6";"0";"6";"9";"72";"30020"
"4";"0";"4";"9";"72";"30021"
"2";"0";"2";"9";"72";"30022"
"5";"1";"4";"9";"72";"30024"
"12";"2";"10";"9";"72";"30025"
"1";"0";"1";"9";"72";"30026"
"6";"1";"5";"9";"72";"30030"
"6";"2";"4";"9";"72";"30032"
"8";"2";"6";"9";"72";"30034"
"7";"3";"4";"9";"72";"30038"
"1";"1";"0";"9";"72";"30041"
"8";"2";"6";"9";"72";"30042"
"17";"4";"13";"9";"72";"30043"
"2";"0";"2";"9";"72";"30045"
"6";"1";"5";"9";"72";"30047"
"2";"0";"2";"9";"72";"30048"
"1";"0";"1";"9";"72";"30051"
"2";"0";"2";"9";"72";"30052"
"7";"1";"6";"9";"72";"30059"
"9";"5";"4";"9";"72";"30060"
"5";"0";"5";"9";"72";"30065"
"12";"4";"8";"9";"72";"30066"
"4";"1";"3";"9";"72";"30068"
"14";"3";"11";"9";"72";"30070"
"3";"1";"2";"9";"72";"30073"
"4";"0";"4";"9";"72";"30076"
"2";"1";"1";"9";"72";"30078"
"8";"2";"6";"9";"72";"30079"
"31";"17";"14";"9";"72";"30084"
"5";"1";"4";"9";"72";"30085"
"4";"1";"3";"9";"72";"30087"
"7";"0";"7";"9";"72";"30090"
"8";"3";"5";"9";"72";"30091"
"3";"0";"3";"9";"72";"30092"
"20";"7";"13";"9";"72";"30094"
"23";"15";"8";"9";"72";"30097"
"14";"9";"5";"9";"72";"30098"
"4";"1";"3";"9";"72";"30100"
"2";"2";"0";"9";"72";"30101"
"7";"2";"5";"9";"72";"30102"
"3";"0";"3";"9";"72";"30103"
"3";"1";"2";"9";"72";"30105"
"9";"2";"7";"9";"72";"30106"
"3";"0";"3";"9";"72";"30109"
"18";"2";"16";"9";"72";"30110"
"2";"0";"2";"9";"72";"30112"
"4";"2";"2";"9";"72";"30113"
"5";"3";"2";"9";"72";"30115"
"11";"3";"8";"9";"72";"30118"
"1";"0";"1";"9";"72";"30121"
"2";"2";"0";"9";"72";"30123"
"11";"4";"7";"9";"72";"30126"
"6";"1";"5";"9";"72";"30131"
"5";"1";"4";"9";"72";"30132"
"8";"2";"6";"9";"72";"30133"
"1";"1";"0";"9";"72";"30134"
"13";"5";"8";"9";"72";"30138"
"3";"1";"2";"9";"72";"30139"
"3";"1";"2";"9";"72";"30140"
"5";"1";"4";"9";"72";"30141"
"6";"1";"5";"9";"72";"30143"
"5";"0";"5";"9";"72";"30145"
"2";"2";"0";"9";"72";"30146"
"14";"6";"8";"9";"72";"30147"
"2";"0";"2";"9";"72";"30148"
"1";"0";"1";"9";"72";"30151"
"6";"1";"5";"9";"72";"30152"
"62";"37";"25";"9";"72";"30157"
"27";"5";"22";"9";"72";"30158"
"2";"0";"2";"9";"72";"30159"
"1811";"1534";"277";"9";"72";"30160"
"1";"1";"0";"9";"72";"30162"
"3";"3";"0";"9";"72";"30165"
"26";"12";"14";"9";"72";"30166"
"4";"1";"3";"9";"72";"30167"
"8";"0";"8";"9";"72";"30169"
"3";"0";"3";"9";"72";"30170"
"4";"0";"4";"9";"72";"30173"
"4";"0";"4";"9";"72";"30176"
"1";"1";"0";"9";"72";"30177"
"6";"1";"5";"9";"72";"30178"
"2";"0";"2";"9";"72";"30181"
"14";"9";"5";"9";"72";"30182"
"1";"0";"1";"9";"72";"30183"
"4";"1";"3";"9";"72";"30184"
"30";"4";"26";"9";"72";"30192"
"17";"7";"10";"9";"72";"30194"
"1";"0";"1";"9";"72";"30195"
"5";"1";"4";"9";"72";"30197"
"9";"1";"8";"9";"72";"30198"
"10";"5";"5";"9";"72";"30201"
"27";"19";"8";"9";"72";"30202"
"7";"2";"5";"9";"72";"30203"
"1";"1";"0";"9";"72";"30204"
"4";"3";"1";"9";"72";"30207"
"3";"0";"3";"9";"72";"30209"
"4";"1";"3";"9";"72";"30219"
"4";"2";"2";"9";"72";"30221"
"2";"0";"2";"9";"72";"30222"
"6";"2";"4";"9";"72";"30228"
"1";"1";"0";"9";"72";"30230"
"4";"1";"3";"9";"72";"30232"
"2";"0";"2";"9";"72";"30234"
"1";"1";"0";"9";"72";"30236"
"4";"1";"3";"9";"72";"30239"
"2";"0";"2";"9";"72";"30240"
"5";"2";"3";"9";"72";"30241"
"5";"3";"2";"9";"72";"30242"
"2";"1";"1";"9";"72";"30245"
"15";"3";"12";"9";"72";"30251"
"7";"1";"6";"9";"72";"30252"
"39";"29";"10";"9";"72";"30253"
"3";"1";"2";"9";"72";"30254"
"12";"4";"8";"9";"72";"30255"
"2";"1";"1";"9";"72";"30256"
"1";"1";"0";"9";"72";"30257"
"25";"13";"12";"9";"72";"30258"
"24";"4";"20";"9";"72";"30259"
"1";"0";"1";"9";"72";"30262"
"7";"2";"5";"9";"72";"30267"
"5";"1";"4";"9";"72";"30268"
"5";"1";"4";"9";"72";"30269"
"5";"1";"4";"9";"72";"30272"
"6";"1";"5";"9";"72";"30276"
"5";"0";"5";"9";"72";"30279"
"2";"1";"1";"9";"72";"30282"
"2";"1";"1";"9";"72";"30283"
"3";"2";"1";"9";"72";"30286"
"13";"4";"9";"9";"72";"30292"
"2";"1";"1";"9";"72";"30293"
"6";"1";"5";"9";"72";"30295"
"6";"3";"3";"9";"72";"30300"
"9";"0";"9";"9";"72";"30301"
"7";"0";"7";"9";"72";"30303"
"2";"1";"1";"9";"72";"30305"
"2";"0";"2";"9";"72";"30309"
"26";"13";"13";"9";"72";"30311"
"1";"1";"0";"9";"72";"30313"
"4";"1";"3";"9";"72";"30314"
"17";"7";"10";"9";"72";"30317"
"22";"5";"17";"9";"72";"30318"
"1";"1";"0";"9";"72";"30319"
"5";"0";"5";"9";"72";"30320"
"9";"4";"5";"9";"72";"30321"
"1";"0";"1";"9";"72";"30323"
"1";"1";"0";"9";"72";"30325"
"6";"0";"6";"9";"72";"30326"
"3";"1";"2";"9";"72";"30329"
"5";"1";"4";"9";"72";"30330"
"4";"2";"2";"9";"72";"30331"
"522";"409";"113";"9";"72";"30332"
"2";"0";"2";"9";"72";"30333"
"1";"1";"0";"9";"72";"30334"
"4";"1";"3";"9";"72";"30336"
"11";"4";"7";"9";"72";"30337"
"1";"0";"1";"9";"72";"30338"
"1";"1";"0";"9";"72";"30341"
"2";"1";"1";"9";"72";"30342"
"1";"0";"1";"9";"72";"30347"
"9";"5";"4";"9";"72";"30348"
"1";"0";"1";"9";"72";"30349"
"3";"0";"3";"9";"72";"30351"
"2";"0";"2";"9";"72";"30353"
"15";"6";"9";"9";"72";"30354"
"3";"1";"2";"9";"72";"30355"
"14";"4";"10";"9";"72";"30357"
"2";"2";"0";"9";"72";"30360"
"3";"0";"3";"9";"72";"30361"
"10";"6";"4";"9";"72";"30363"
"2";"0";"2";"9";"72";"30365"
"6";"3";"3";"9";"72";"30369"
"7";"3";"4";"9";"72";"30370"
"1";"1";"0";"9";"72";"30374"
"2";"0";"2";"9";"72";"30375"
"3";"0";"3";"9";"72";"30376"
"3";"3";"0";"9";"72";"30377"
"4";"2";"2";"9";"72";"30378"
"3";"1";"2";"9";"72";"30383"
"340";"192";"148";"9";"72";"30384"
"2";"1";"1";"9";"72";"30386"
"11";"3";"8";"9";"72";"30388"
"1";"0";"1";"9";"72";"30390"
"679";"568";"111";"9";"72";"30392"
"7";"2";"5";"9";"72";"30393"
"14";"3";"11";"9";"72";"30395"
"2";"0";"2";"9";"72";"30398"
"74";"63";"11";"9";"72";"30399"
"748";"538";"210";"9";"72";"30400"
"2";"0";"2";"9";"72";"30401"
"10";"8";"2";"9";"72";"30409"
"5";"2";"3";"9";"72";"30411"
"4";"0";"4";"9";"72";"30412"
"2";"2";"0";"9";"72";"30414"
"57";"20";"37";"9";"72";"30418"
"15";"1";"14";"9";"72";"30421"
"6";"2";"4";"9";"72";"30423"
"1";"1";"0";"9";"72";"30424"
"4";"1";"3";"9";"72";"30427"
"4";"1";"3";"9";"72";"30430"
"3";"2";"1";"9";"72";"30431"
"4";"4";"0";"9";"72";"30432"
"11";"1";"10";"9";"72";"30434"
"1";"1";"0";"9";"72";"30436"
"2";"0";"2";"9";"72";"30438"
"1";"1";"0";"9";"72";"30447"
"7";"2";"5";"9";"72";"30449"
"1";"1";"0";"9";"72";"30450"
"272";"207";"65";"9";"72";"30451"
"1";"0";"1";"9";"72";"30456"
"4";"2";"2";"9";"72";"30457"
"5";"0";"5";"9";"72";"30458"
"1";"1";"0";"9";"72";"30461"
"7";"2";"5";"9";"72";"30463"
"2";"1";"1";"9";"72";"30464"
"3";"0";"3";"9";"72";"30465"
"2";"1";"1";"9";"72";"30466"
"5";"4";"1";"9";"72";"30467"
"2";"1";"1";"9";"72";"30468"
"4";"1";"3";"9";"72";"30473"
"5";"1";"4";"9";"72";"30478"
"7";"1";"6";"9";"72";"30480"
"4";"1";"3";"9";"72";"30482"
"2";"0";"2";"9";"72";"30487"
"4";"1";"3";"9";"72";"30488"
"21";"1";"20";"9";"72";"30489"
"2";"0";"2";"9";"72";"30490"
"2";"2";"0";"9";"72";"30495"
"7";"1";"6";"9";"72";"30497"
"2";"0";"2";"9";"72";"30498"
"5";"3";"2";"9";"72";"30499"
"1";"0";"1";"9";"72";"30500"
"1";"0";"1";"9";"72";"30505"
"18";"12";"6";"9";"72";"30507"
"13";"6";"7";"9";"72";"30508"
"128";"75";"53";"9";"72";"30509"
"10";"2";"8";"9";"72";"30510"
"5";"0";"5";"9";"72";"30514"
"2";"0";"2";"9";"72";"30515"
"2";"0";"2";"9";"72";"30519"
"1";"1";"0";"9";"72";"30523"
"12";"4";"8";"9";"72";"30524"
"33";"15";"18";"9";"72";"30527"
"3";"1";"2";"9";"72";"30529"
"18";"8";"10";"9";"72";"30531"
"1";"0";"1";"9";"72";"30533"
"8";"2";"6";"9";"72";"30534"
"1";"0";"1";"9";"72";"30535"
"8";"3";"5";"9";"72";"30536"
"8";"2";"6";"9";"72";"30539"
"2";"0";"2";"9";"72";"30540"
"7";"2";"5";"9";"72";"30543"
"16";"10";"6";"9";"72";"30545"
"2";"0";"2";"9";"72";"30546"
"222";"191";"31";"9";"72";"30548"
"11";"3";"8";"9";"72";"30549"
"7";"0";"7";"9";"72";"30550"
"1";"1";"0";"9";"72";"30554"
"8";"0";"8";"9";"72";"30558"
"9";"3";"6";"9";"72";"30560"
"1";"1";"0";"9";"72";"30561"
"2";"0";"2";"9";"72";"30563"
"3";"0";"3";"9";"72";"30567"
"2";"2";"0";"9";"72";"30568"
"1";"1";"0";"9";"72";"30571"
"2";"0";"2";"9";"72";"30576"
"2";"0";"2";"9";"72";"30577"
"14";"5";"9";"9";"72";"30579"
"16";"11";"5";"9";"72";"30580"
"1";"0";"1";"9";"72";"30582"
"5";"2";"3";"9";"72";"30584"
"2";"0";"2";"9";"72";"30586"
"2";"0";"2";"9";"72";"30587"
"1";"1";"0";"9";"72";"30588"
"3";"1";"2";"9";"72";"30592"
"28";"4";"24";"9";"72";"30594"
"2";"1";"1";"9";"72";"30596"
"10";"3";"7";"9";"72";"30598"
"47";"32";"15";"9";"72";"30599"
"2";"1";"1";"9";"72";"30600"
"1";"1";"0";"9";"72";"30601"
"2";"1";"1";"9";"72";"30602"
"8";"1";"7";"9";"72";"30603"
"42";"11";"31";"9";"72";"30604"
"2";"0";"2";"9";"72";"30605"
"1";"1";"0";"9";"72";"30606"
"3";"1";"2";"9";"72";"30609"
"11";"4";"7";"9";"72";"30610"
"2";"0";"2";"9";"72";"30611"
"1";"1";"0";"9";"72";"30613"
"9";"3";"6";"9";"72";"30614"
"3";"1";"2";"9";"72";"30615"
"2";"1";"1";"9";"72";"30617"
"13";"1";"12";"9";"72";"30623"
"48";"18";"30";"9";"72";"30625"
"9";"2";"7";"9";"72";"30626"
"1";"0";"1";"9";"72";"30630"
"11";"1";"10";"9";"72";"30633"
"6";"3";"3";"9";"72";"30635"
"5";"2";"3";"9";"72";"30636"
"1";"0";"1";"9";"72";"30637"
"1";"0";"1";"9";"72";"30638"
"8";"3";"5";"9";"72";"30639"
"2";"1";"1";"9";"72";"30640"
"7";"1";"6";"9";"72";"30641"
"4";"2";"2";"9";"72";"30642"
"1";"1";"0";"9";"72";"30643"
"1";"1";"0";"9";"72";"30645"
"212";"154";"58";"9";"72";"30647"
"6";"1";"5";"9";"72";"30649"
"1";"1";"0";"9";"72";"30652"
"12";"3";"9";"9";"72";"30656"
"1";"1";"0";"9";"72";"30658"
"42";"26";"16";"9";"72";"30659"
"186";"128";"58";"9";"72";"30660"
"9";"2";"7";"9";"72";"30661"
"1";"1";"0";"9";"72";"30662"
"1";"0";"1";"9";"72";"30666"
"2";"2";"0";"9";"72";"30667"
"4";"1";"3";"9";"72";"30668"
"5";"2";"3";"9";"72";"30669"
"2";"2";"0";"9";"72";"30671"
"8";"4";"4";"9";"72";"30672"
"4";"1";"3";"9";"72";"30673"
"10";"2";"8";"9";"72";"30674"
"2";"1";"1";"9";"72";"30675"
"5";"1";"4";"9";"72";"30676"
"2";"0";"2";"9";"72";"30682"
"13";"3";"10";"9";"72";"30683"
"7";"1";"6";"9";"72";"30685"
"7";"2";"5";"9";"72";"30687"
"2";"0";"2";"9";"72";"30688"
"4";"1";"3";"9";"72";"30691"
"15";"2";"13";"9";"72";"30692"
"4";"2";"2";"9";"72";"30693"
"1";"1";"0";"9";"72";"30694"
"17";"6";"11";"9";"72";"30695"
"1";"0";"1";"9";"72";"30698"
"2";"1";"1";"9";"72";"30699"
"2";"1";"1";"9";"72";"30700"
"19";"13";"6";"9";"72";"30702"
"9";"4";"5";"9";"72";"30703"
"2";"0";"2";"9";"72";"30705"
"5";"1";"4";"9";"72";"30708"
"7";"2";"5";"9";"72";"30709"
"2";"1";"1";"9";"72";"30710"
"20";"12";"8";"9";"72";"30713"
"6";"2";"4";"9";"72";"30714"
"7";"3";"4";"9";"72";"30715"
"3";"0";"3";"9";"72";"30718"
"1";"1";"0";"9";"72";"30723"
"6";"2";"4";"9";"72";"30725"
"1";"1";"0";"9";"72";"30726"
"10";"5";"5";"9";"72";"30729"
"15";"9";"6";"9";"72";"30730"
"4";"0";"4";"9";"72";"30733"
"21";"3";"18";"9";"72";"30734"
"1";"1";"0";"9";"72";"30735"
"1";"1";"0";"9";"72";"30737"
"2";"0";"2";"9";"72";"30739"
"2";"0";"2";"9";"72";"30740"
"1";"0";"1";"9";"72";"30741"
"1";"0";"1";"9";"72";"30742"
"2";"2";"0";"9";"72";"30743"
"3";"1";"2";"9";"72";"30744"
"5";"4";"1";"9";"72";"30749"
"5";"1";"4";"9";"72";"30752"
"10";"4";"6";"9";"72";"30753"
"2";"1";"1";"9";"72";"30755"
"4";"1";"3";"9";"72";"30756"
"2";"1";"1";"9";"72";"30758"
"1";"1";"0";"9";"72";"30759"
"3";"2";"1";"9";"72";"30761"
"4";"1";"3";"9";"72";"30762"
"4";"1";"3";"9";"72";"30764"
"6";"1";"5";"9";"72";"30765"
"217";"150";"67";"9";"72";"30767"
"4";"1";"3";"9";"72";"30769"
"5";"2";"3";"9";"72";"30771"
"1554";"1113";"441";"9";"72";"30772"
"262";"203";"59";"9";"72";"30773"
"7";"7";"0";"9";"72";"30776"
"14";"4";"10";"9";"72";"30777"
"14";"7";"7";"9";"72";"30779"
"8";"8";"0";"9";"72";"30780"
"9";"1";"8";"9";"72";"30783"
"2";"0";"2";"9";"72";"30786"
"11";"1";"10";"9";"72";"30787"
"1";"1";"0";"9";"72";"30788"
"2";"1";"1";"9";"72";"30790"
"17";"11";"6";"9";"72";"30792"
"9";"2";"7";"9";"72";"30794"
"45";"38";"7";"9";"72";"30795"
"24";"13";"11";"9";"72";"30796"
"92";"66";"26";"9";"72";"30798"
"1";"0";"1";"9";"72";"30803"
"6";"1";"5";"9";"72";"30805"
"1";"0";"1";"9";"72";"30806"
"12";"1";"11";"9";"72";"30807"
"1";"1";"0";"9";"72";"30809"
"8";"3";"5";"9";"72";"30810"
"9";"2";"7";"9";"72";"30812"
"2";"1";"1";"9";"72";"30815"
"3";"1";"2";"9";"72";"30816"
"3";"0";"3";"9";"72";"30818"
"4";"1";"3";"9";"72";"30821"
"52";"32";"20";"9";"72";"30823"
"6";"2";"4";"9";"72";"30825"
"1";"0";"1";"9";"72";"30827"
"9";"5";"4";"9";"72";"30829"
"2";"0";"2";"9";"72";"30830"
"37";"26";"11";"9";"72";"30831"
"2";"1";"1";"9";"72";"30832"
"5";"2";"3";"9";"72";"30834"
"14";"10";"4";"9";"72";"30835"
"1";"0";"1";"9";"72";"30836"
"12";"2";"10";"9";"72";"30839"
"4";"1";"3";"9";"72";"30840"
"1";"0";"1";"9";"72";"30843"
"5";"0";"5";"9";"72";"30844"
"7";"2";"5";"9";"72";"30846"
"3";"0";"3";"9";"72";"30847"
"1";"0";"1";"9";"72";"30849"
"38";"31";"7";"9";"72";"30850"
"2";"1";"1";"9";"72";"30851"
"1";"0";"1";"9";"72";"30852"
"13";"5";"8";"9";"72";"30853"
"14";"3";"11";"9";"72";"30856"
"8";"1";"7";"9";"72";"30858"
"6";"2";"4";"9";"72";"30859"
"1";"1";"0";"9";"72";"30862"
"73";"36";"37";"9";"72";"30865"
"3";"3";"0";"9";"72";"30869"
"1";"1";"0";"9";"72";"30870"
"1";"0";"1";"9";"72";"30871"
"4";"1";"3";"9";"72";"30872"
"4";"0";"4";"9";"72";"30873"
"17";"12";"5";"9";"72";"30874"
"4";"1";"3";"9";"72";"30875"
"1";"0";"1";"9";"72";"30879"
"2";"0";"2";"9";"72";"30880"
"23";"9";"14";"9";"72";"30882"
"3";"1";"2";"9";"72";"30883"
"8";"2";"6";"9";"72";"30884"
"3";"1";"2";"9";"72";"30886"
"1";"1";"0";"9";"72";"30887"
"2";"1";"1";"9";"72";"30889"
"52";"14";"38";"9";"72";"30890"
"4";"1";"3";"9";"72";"30891"
"2";"1";"1";"9";"72";"30893"
"2";"0";"2";"9";"72";"30894"
"3";"1";"2";"9";"72";"30895"
"19";"7";"12";"9";"72";"30896"
"3";"2";"1";"9";"72";"30897"
"18";"18";"0";"9";"72";"30898"
"8";"2";"6";"9";"72";"30906"
"1";"0";"1";"9";"72";"30908"
"2";"1";"1";"9";"72";"30910"
"3";"0";"3";"9";"72";"30911"
"1";"0";"1";"9";"72";"30912"
"10";"1";"9";"9";"72";"30913"
"2";"1";"1";"9";"72";"30915"
"1";"1";"0";"9";"72";"30918"
"1";"1";"0";"9";"72";"30919"
"4";"1";"3";"9";"72";"30920"
"2";"0";"2";"9";"72";"30921"
"2";"0";"2";"9";"72";"30922"
"1";"0";"1";"9";"72";"30925"
"2";"0";"2";"9";"72";"30927"
"4";"0";"4";"9";"72";"30929"
"3";"0";"3";"9";"72";"30932"
"1";"1";"0";"9";"72";"30934"
"1";"1";"0";"9";"72";"30936"
"1";"0";"1";"9";"72";"30937"
"19";"6";"13";"9";"72";"30939"
"23";"3";"20";"9";"72";"30941"
"4";"0";"4";"9";"72";"30943"
"11";"2";"9";"9";"72";"30945"
"5";"3";"2";"9";"72";"30946"
"1";"0";"1";"9";"72";"30948"
"2";"2";"0";"9";"72";"30950"
"4";"1";"3";"9";"72";"30951"
"2";"1";"1";"9";"72";"30952"
"1";"0";"1";"9";"72";"30954"
"6";"2";"4";"9";"72";"30955"
"7";"6";"1";"9";"72";"30957"
"7";"2";"5";"9";"72";"30959"
"1";"0";"1";"9";"72";"30960"
"15";"4";"11";"9";"72";"30961"
"6";"4";"2";"9";"72";"30962"
"3";"1";"2";"9";"72";"30964"
"2";"1";"1";"9";"72";"30967"
"3";"1";"2";"9";"72";"30969"
"6";"0";"6";"9";"72";"30970"
"4";"0";"4";"9";"72";"30971"
"1";"1";"0";"9";"72";"30973"
"4";"0";"4";"9";"72";"30976"
"2";"0";"2";"9";"72";"30977"
"1";"0";"1";"9";"72";"30979"
"11";"6";"5";"9";"72";"30980"
"6";"0";"6";"9";"72";"30981"
"15";"1";"14";"9";"72";"30982"
"6";"0";"6";"9";"72";"30983"
"5";"0";"5";"9";"72";"30986"
"11";"2";"9";"9";"72";"30987"
"15";"10";"5";"9";"72";"30988"
"6";"2";"4";"9";"72";"30989"
"1";"1";"0";"9";"72";"30993"
"8";"2";"6";"9";"72";"30994"
"6";"0";"6";"9";"72";"30999"
"2";"1";"1";"9";"72";"31001"
"5";"0";"5";"9";"72";"31003"
"5";"0";"5";"9";"72";"31005"
"3";"0";"3";"9";"72";"31006"
"1";"0";"1";"9";"72";"31009"
"2";"0";"2";"9";"72";"31010"
"1";"0";"1";"9";"72";"31013"
"14";"3";"11";"9";"72";"31014"
"6";"1";"5";"9";"72";"31016"
"19";"8";"11";"9";"72";"31017"
"5";"2";"3";"9";"72";"31018"
"2";"0";"2";"9";"72";"31019"
"7";"1";"6";"9";"72";"31020"
"7";"2";"5";"9";"72";"31022"
"2";"1";"1";"9";"72";"31023"
"3";"0";"3";"9";"72";"31025"
"46";"26";"20";"9";"72";"31026"
"2";"1";"1";"9";"72";"31027"
"4";"2";"2";"9";"72";"31028"
"10";"1";"9";"9";"72";"31031"
"2";"1";"1";"9";"72";"31033"
"3";"1";"2";"9";"72";"31036"
"6";"3";"3";"9";"72";"31037"
"5";"1";"4";"9";"72";"31039"
"1";"1";"0";"9";"72";"31042"
"5";"1";"4";"9";"72";"31046"
"3";"0";"3";"9";"72";"31047"
"6";"1";"5";"9";"72";"31050"
"1";"1";"0";"9";"72";"31052"
"22";"1";"21";"9";"72";"31053"
"10";"4";"6";"9";"72";"31056"
"3";"0";"3";"9";"72";"31057"
"2";"1";"1";"9";"72";"31058"
"3";"1";"2";"9";"72";"31059"
"6";"2";"4";"9";"72";"31061"
"15";"1";"14";"9";"72";"31062"
"2";"0";"2";"9";"72";"31063"
"6";"2";"4";"9";"72";"31064"
"3";"2";"1";"9";"72";"31065"
"2";"1";"1";"9";"72";"31066"
"9";"3";"6";"9";"72";"31069"
"3";"0";"3";"9";"72";"31070"
"5";"3";"2";"9";"72";"31071"
"21";"4";"17";"9";"72";"31075"
"5";"1";"4";"9";"72";"31076"
"55";"20";"35";"9";"72";"31081"
"3";"0";"3";"9";"72";"31083"
"2";"1";"1";"9";"72";"31084"
"2";"1";"1";"9";"72";"31085"
"6";"3";"3";"9";"72";"31087"
"6";"2";"4";"9";"72";"31093"
"1";"0";"1";"9";"72";"31094"
"1";"1";"0";"9";"72";"31097"
"5";"1";"4";"9";"72";"31098"
"7";"3";"4";"9";"72";"31099"
"4";"1";"3";"9";"72";"31101"
"6";"2";"4";"9";"72";"31103"
"13";"10";"3";"9";"72";"31104"
"1";"1";"0";"9";"72";"31105"
"4";"1";"3";"9";"72";"31107"
"10";"5";"5";"9";"72";"31108"
"12";"4";"8";"9";"72";"31110"
"27";"20";"7";"9";"72";"31113"
"7";"1";"6";"9";"72";"31115"
"25";"16";"9";"9";"72";"31116"
"1";"0";"1";"9";"72";"31118"
"1";"1";"0";"9";"72";"31120"
"12";"3";"9";"9";"72";"31121"
"1";"0";"1";"9";"72";"31124"
"2";"1";"1";"9";"72";"31125"
"1";"0";"1";"9";"72";"31126"
"1";"0";"1";"9";"72";"31128"
"7";"0";"7";"9";"72";"31130"
"1";"1";"0";"9";"72";"31132"
"2";"1";"1";"9";"72";"31133"
"1";"0";"1";"9";"72";"31137"
"143";"104";"39";"9";"72";"31138"
"1";"1";"0";"9";"72";"31140"
"3";"1";"2";"9";"72";"31144"
"1";"0";"1";"9";"72";"31146"
"1";"1";"0";"9";"72";"31147"
"11";"1";"10";"9";"72";"31148"
"11";"2";"9";"9";"72";"31149"
"4";"1";"3";"9";"72";"31151"
"6";"1";"5";"9";"72";"31154"
"2";"1";"1";"9";"72";"31160"
"5";"1";"4";"9";"72";"31161"
"5";"1";"4";"9";"72";"31165"
"4";"2";"2";"9";"72";"31167"
"6";"1";"5";"9";"72";"31169"
"4";"1";"3";"9";"72";"31170"
"3";"1";"2";"9";"72";"31171"
"1";"0";"1";"9";"72";"31174"
"6";"0";"6";"9";"72";"31178"
"10";"2";"8";"9";"72";"31182"
"2";"1";"1";"9";"72";"31183"
"4";"1";"3";"9";"72";"31184"
"8";"1";"7";"9";"72";"31186"
"2";"0";"2";"9";"72";"31188"
"15";"2";"13";"9";"72";"31189"
"2";"0";"2";"9";"72";"31194"
"17";"3";"14";"9";"72";"31195"
"7";"0";"7";"9";"72";"31197"
"2";"0";"2";"9";"72";"31199"
"3";"0";"3";"9";"72";"31202"
"5";"3";"2";"9";"72";"31205"
"5";"0";"5";"9";"72";"31206"
"7";"0";"7";"9";"72";"31210"
"7";"5";"2";"9";"72";"31213"
"3";"0";"3";"9";"72";"31214"
"10";"0";"10";"9";"72";"31216"
"8";"2";"6";"9";"72";"31217"
"1";"1";"0";"9";"72";"31219"
"2";"1";"1";"9";"72";"31220"
"4";"0";"4";"9";"72";"31221"
"1";"1";"0";"9";"72";"31223"
"4";"2";"2";"9";"72";"31228"
"3";"3";"0";"9";"72";"31229"
"21";"4";"17";"9";"72";"31230"
"5";"2";"3";"9";"72";"31233"
"7";"3";"4";"9";"72";"31234"
"6";"2";"4";"9";"72";"31236"
"6";"3";"3";"9";"72";"31238"
"4";"0";"4";"9";"72";"31239"
"2";"1";"1";"9";"72";"31240"
"5";"2";"3";"9";"72";"31241"
"43";"9";"34";"9";"72";"31243"
"1";"0";"1";"9";"72";"31245"
"11";"2";"9";"9";"72";"31246"
"1";"1";"0";"9";"72";"31249"
"4";"3";"1";"9";"72";"31250"
"7";"4";"3";"9";"72";"31251"
"5";"4";"1";"9";"72";"31253"
"1";"0";"1";"9";"72";"31254"
"3";"1";"2";"9";"72";"31255"
"6";"5";"1";"9";"72";"31256"
"1";"0";"1";"9";"72";"31258"
"4";"1";"3";"9";"72";"31259"
"1";"1";"0";"9";"72";"31260"
"2";"2";"0";"9";"72";"31261"
"3";"0";"3";"9";"72";"31262"
"16";"4";"12";"9";"72";"31263"
"498";"421";"77";"9";"72";"31264"
"4";"2";"2";"9";"72";"31267"
"1";"0";"1";"9";"72";"31269"
"2";"1";"1";"9";"72";"31271"
"3";"1";"2";"9";"72";"31272"
"7";"1";"6";"9";"72";"31273"
"2";"1";"1";"9";"72";"31274"
"5";"0";"5";"9";"72";"31283"
"9";"3";"6";"9";"72";"31284"
"2";"2";"0";"9";"72";"31285"
"2";"0";"2";"9";"72";"31286"
"5";"0";"5";"9";"72";"31288"
"15";"6";"9";"9";"72";"31290"
"7";"3";"4";"9";"72";"31291"
"5";"0";"5";"9";"72";"31293"
"2";"0";"2";"9";"72";"31294"
"10";"5";"5";"9";"72";"31295"
"26";"4";"22";"9";"72";"31296"
"1";"0";"1";"9";"72";"31297"
"1";"1";"0";"9";"72";"31298"
"3";"2";"1";"9";"72";"31299"
"5";"0";"5";"9";"72";"31301"
"10";"3";"7";"9";"72";"31303"
"3";"1";"2";"9";"72";"31304"
"1";"1";"0";"9";"72";"31305"
"19";"4";"15";"9";"72";"31307"
"3";"1";"2";"9";"72";"31309"
"1";"1";"0";"9";"72";"31310"
"7";"2";"5";"9";"72";"31311"
"6";"1";"5";"9";"72";"31315"
"22";"7";"15";"9";"72";"31316"
"1";"1";"0";"9";"72";"31317"
"132";"94";"38";"9";"72";"31318"
"6";"1";"5";"9";"72";"31322"
"1";"1";"0";"9";"72";"31325"
"1";"0";"1";"9";"72";"31326"
"3";"0";"3";"9";"72";"31327"
"141";"99";"42";"9";"72";"31328"
"2";"1";"1";"9";"72";"31331"
"2";"0";"2";"9";"72";"31332"
"69";"49";"20";"9";"72";"31335"
"1";"1";"0";"9";"72";"31339"
"1";"0";"1";"9";"72";"31340"
"7";"2";"5";"9";"72";"31341"
"4";"0";"4";"9";"72";"31343"
"1";"1";"0";"9";"72";"31344"
"4";"1";"3";"9";"72";"31345"
"2";"0";"2";"9";"72";"31346"
"2";"0";"2";"9";"72";"31347"
"2";"1";"1";"9";"72";"31348"
"17";"3";"14";"9";"72";"31350"
"16";"3";"13";"9";"72";"31352"
"5";"2";"3";"9";"72";"31354"
"7";"0";"7";"9";"72";"31355"
"2";"0";"2";"9";"72";"31356"
"2";"1";"1";"9";"72";"31357"
"2";"1";"1";"9";"72";"31359"
"3";"0";"3";"9";"72";"31364"
"1";"1";"0";"9";"72";"31365"
"8";"2";"6";"9";"72";"31366"
"1";"1";"0";"9";"72";"31368"
"4";"1";"3";"9";"72";"31370"
"6";"1";"5";"9";"72";"31371"
"2";"0";"2";"9";"72";"31372"
"2";"0";"2";"9";"72";"31378"
"2";"1";"1";"9";"72";"31379"
"16";"7";"9";"9";"72";"31381"
"2";"1";"1";"9";"72";"31384"
"2";"1";"1";"9";"72";"31385"
"3";"0";"3";"9";"72";"31387"
"1";"1";"0";"9";"72";"31389"
"2";"1";"1";"9";"72";"31390"
"6";"0";"6";"9";"72";"31391"
"5";"2";"3";"9";"72";"31393"
"9";"4";"5";"9";"72";"31395"
"8";"0";"8";"9";"72";"31398"
"9";"3";"6";"9";"72";"31400"
"1";"1";"0";"9";"72";"31401"
"8";"5";"3";"9";"72";"31402"
"5";"0";"5";"9";"72";"31403"
"1";"0";"1";"9";"72";"31404"
"2";"1";"1";"9";"72";"31405"
"2";"1";"1";"9";"72";"31406"
"2";"2";"0";"9";"72";"31407"
"21";"7";"14";"9";"72";"31408"
"4";"0";"4";"9";"72";"31410"
"1";"1";"0";"9";"72";"31411"
"1";"1";"0";"9";"72";"31412"
"1";"0";"1";"9";"72";"31413"
"1";"0";"1";"9";"72";"31414"
"4";"1";"3";"9";"72";"31415"
"4";"2";"2";"9";"72";"31419"
"12";"2";"10";"9";"72";"31422"
"3";"1";"2";"9";"72";"31424"
"35";"16";"19";"9";"72";"31426"
"1";"1";"0";"9";"72";"31428"
"3";"1";"2";"9";"72";"31431"
"3";"0";"3";"9";"72";"31432"
"6";"2";"4";"9";"72";"31433"
"2";"1";"1";"9";"72";"31435"
"9";"0";"9";"9";"72";"31441"
"3";"1";"2";"9";"72";"31442"
"5";"1";"4";"9";"72";"31444"
"4";"0";"4";"9";"72";"31445"
"5";"1";"4";"9";"72";"31447"
"2";"1";"1";"9";"72";"31450"
"2";"1";"1";"9";"72";"31454"
"118";"52";"66";"9";"72";"31456"
"12";"10";"2";"9";"72";"31457"
"30";"5";"25";"9";"72";"31458"
"37";"5";"32";"9";"72";"31459"
"3";"2";"1";"9";"72";"31460"
"3";"1";"2";"9";"72";"31461"
"11";"1";"10";"9";"72";"31462"
"10";"3";"7";"9";"72";"31463"
"3";"0";"3";"9";"72";"31465"
"51";"22";"29";"9";"72";"31466"
"7";"1";"6";"9";"72";"31468"
"3";"0";"3";"9";"72";"31470"
"2";"1";"1";"9";"72";"31472"
"4";"0";"4";"9";"72";"31474"
"6";"3";"3";"9";"72";"31475"
"1";"0";"1";"9";"72";"31476"
"7";"1";"6";"9";"72";"31477"
"3";"1";"2";"9";"72";"31479"
"1";"0";"1";"9";"72";"31480"
"4";"1";"3";"9";"72";"31481"
"6";"2";"4";"9";"72";"31489"
"23";"6";"17";"9";"72";"31493"
"1";"1";"0";"9";"72";"31496"
"4";"2";"2";"9";"72";"31501"
"2";"1";"1";"9";"72";"31503"
"2";"0";"2";"9";"72";"31506"
"2";"0";"2";"9";"72";"31509"
"17";"6";"11";"9";"72";"31513"
"8";"5";"3";"9";"72";"31514"
"16";"4";"12";"9";"72";"31515"
"3";"2";"1";"9";"72";"31516"
"3";"1";"2";"9";"72";"31517"
"5";"2";"3";"9";"72";"31518"
"6";"6";"0";"9";"72";"31519"
"1";"1";"0";"9";"72";"31521"
"21";"11";"10";"9";"72";"31522"
"5";"0";"5";"9";"72";"31523"
"5";"0";"5";"9";"72";"31526"
"2";"0";"2";"9";"72";"31528"
"3";"1";"2";"9";"72";"31531"
"3";"3";"0";"9";"72";"31534"
"2";"1";"1";"9";"72";"31536"
"2";"0";"2";"9";"72";"31538"
"4";"4";"0";"9";"72";"31540"
"1";"1";"0";"9";"72";"31541"
"3";"0";"3";"9";"72";"31542"
"2";"0";"2";"9";"72";"31544"
"1";"0";"1";"9";"72";"31545"
"1";"1";"0";"9";"72";"31549"
"4";"0";"4";"9";"72";"31551"
"2";"1";"1";"9";"72";"31552"
"2";"1";"1";"9";"72";"31554"
"2";"0";"2";"9";"72";"31555"
"1325";"1039";"286";"9";"72";"31557"
"269";"204";"65";"9";"72";"31561"
"5";"1";"4";"9";"72";"31562"
"2";"1";"1";"9";"72";"31563"
"9";"6";"3";"9";"72";"31568"
"3";"2";"1";"9";"72";"31569"
"3";"0";"3";"9";"72";"31571"
"8";"3";"5";"9";"72";"31572"
"3";"0";"3";"9";"72";"31573"
"32";"12";"20";"9";"72";"31574"
"6";"1";"5";"9";"72";"31577"
"14";"3";"11";"9";"72";"31585"
"1";"0";"1";"9";"72";"31586"
"8";"2";"6";"9";"72";"31588"
"6";"3";"3";"9";"72";"31589"
"3";"1";"2";"9";"72";"31592"
"4";"1";"3";"9";"72";"31599"
"707";"552";"155";"9";"72";"31600"
"5";"0";"5";"9";"72";"31601"
"5";"1";"4";"9";"72";"31604"
"4";"1";"3";"9";"72";"31605"
"3";"1";"2";"9";"72";"31613"
"13";"2";"11";"9";"72";"31614"
"2";"0";"2";"9";"72";"31616"
"6";"2";"4";"9";"72";"31617"
"5";"2";"3";"9";"72";"31618"
"3";"0";"3";"9";"72";"31620"
"9";"0";"9";"9";"72";"31622"
"1";"0";"1";"9";"72";"31623"
"3";"1";"2";"9";"72";"31624"
"3";"1";"2";"9";"72";"31633"
"9";"2";"7";"9";"72";"31634"
"2";"1";"1";"9";"72";"31638"
"2";"1";"1";"9";"72";"31639"
"3";"0";"3";"9";"72";"31644"
"3";"0";"3";"9";"72";"31646"
"2";"1";"1";"9";"72";"31648"
"1";"1";"0";"9";"72";"31649"
"4";"0";"4";"9";"72";"31650"
"2";"2";"0";"9";"72";"31651"
"7";"1";"6";"9";"72";"31654"
"1";"0";"1";"9";"72";"31659"
"5";"1";"4";"9";"72";"31662"
"9";"3";"6";"9";"72";"31663"
"4";"0";"4";"9";"72";"31664"
"2";"1";"1";"9";"72";"31665"
"2";"1";"1";"9";"72";"31669"
"1";"1";"0";"9";"72";"31670"
"10";"1";"9";"9";"72";"31672"
"2";"0";"2";"9";"72";"31673"
"8";"4";"4";"9";"72";"31674"
"1";"1";"0";"9";"72";"31676"
"7";"3";"4";"9";"72";"31677"
"14";"5";"9";"9";"72";"31678"
"2";"0";"2";"9";"72";"31680"
"1";"0";"1";"9";"72";"31681"
"3";"1";"2";"9";"72";"31682"
"1";"0";"1";"9";"72";"31683"
"2";"1";"1";"9";"72";"31685"
"6";"6";"0";"9";"72";"31686"
"1";"0";"1";"9";"72";"31688"
"14";"2";"12";"9";"72";"31690"
"3";"0";"3";"9";"72";"31692"
"1";"1";"0";"9";"72";"31694"
"13";"5";"8";"9";"72";"31697"
"1";"0";"1";"9";"72";"31699"
"2";"0";"2";"9";"72";"31702"
"1";"1";"0";"9";"72";"31703"
"5";"1";"4";"9";"72";"31704"
"4";"0";"4";"9";"72";"31708"
"4";"4";"0";"9";"72";"31709"
"1";"1";"0";"9";"72";"31712"
"5";"2";"3";"9";"72";"31713"
"29";"1";"28";"9";"72";"31717"
"13";"4";"9";"9";"72";"31718"
"1";"1";"0";"9";"72";"31719"
"1";"0";"1";"9";"72";"31720"
"5";"0";"5";"9";"72";"31722"
"4";"0";"4";"9";"72";"31723"
"6";"3";"3";"9";"72";"31726"
"8";"3";"5";"9";"72";"31727"
"7";"1";"6";"9";"72";"31728"
"4";"0";"4";"9";"72";"31731"
"3";"0";"3";"9";"72";"31733"
"2";"1";"1";"9";"72";"31734"
"26";"5";"21";"9";"72";"31736"
"14";"8";"6";"9";"72";"31737"
"33";"16";"17";"9";"72";"31739"
"4";"2";"2";"9";"72";"31742"
"5";"2";"3";"9";"72";"31744"
"2";"1";"1";"9";"72";"31750"
"9";"1";"8";"9";"72";"31752"
"1";"0";"1";"9";"72";"31755"
"2";"1";"1";"9";"72";"31756"
"21";"10";"11";"9";"72";"31757"
"3";"3";"0";"9";"72";"31759"
"13";"2";"11";"9";"72";"31762"
"2";"1";"1";"9";"72";"31767"
"4";"0";"4";"9";"72";"31769"
"5";"0";"5";"9";"72";"31772"
"37";"2";"35";"9";"72";"31774"
"4";"2";"2";"9";"72";"31776"
"11";"2";"9";"9";"72";"31780"
"6";"1";"5";"9";"72";"31782"
"6";"2";"4";"9";"72";"31783"
"2";"1";"1";"9";"72";"31785"
"5";"1";"4";"9";"72";"31788"
"2";"0";"2";"9";"72";"31790"
"5";"1";"4";"9";"72";"31791"
"3";"2";"1";"9";"72";"31792"
"7";"2";"5";"9";"72";"31793"
"5";"2";"3";"9";"72";"31798"
"7";"2";"5";"9";"72";"31801"
"10";"4";"6";"9";"72";"31804"
"19";"7";"12";"9";"72";"31809"
"6";"3";"3";"9";"72";"31811"
"5";"1";"4";"9";"72";"31817"
"6";"1";"5";"9";"72";"31818"
"42";"2";"40";"9";"72";"31820"
"4";"0";"4";"9";"72";"31822"
"9";"4";"5";"9";"72";"31824"
"4";"1";"3";"9";"72";"31826"
"5";"2";"3";"9";"72";"31827"
"1";"1";"0";"9";"72";"31828"
"6";"2";"4";"9";"72";"31829"
"23";"5";"18";"9";"72";"31831"
"2";"2";"0";"9";"72";"31838"
"33";"6";"27";"9";"72";"31841"
"3";"1";"2";"9";"72";"31843"
"1";"1";"0";"9";"72";"31844"
"7";"2";"5";"9";"72";"31852"
"6";"1";"5";"9";"72";"31853"
"2";"0";"2";"9";"72";"31854"
"4";"0";"4";"9";"72";"31855"
"4";"1";"3";"9";"72";"31859"
"1";"0";"1";"9";"72";"31860"
"4";"1";"3";"9";"72";"31862"
"5";"1";"4";"9";"72";"31864"
"4";"2";"2";"9";"72";"31867"
"1";"0";"1";"9";"72";"31868"
"5";"3";"2";"9";"72";"31876"
"1";"1";"0";"9";"72";"31878"
"1";"1";"0";"9";"72";"31880"
"5";"3";"2";"9";"72";"31881"
"2";"0";"2";"9";"72";"31882"
"6";"2";"4";"9";"72";"31883"
"2";"1";"1";"9";"72";"31886"
"1";"1";"0";"9";"72";"31888"
"9";"2";"7";"9";"72";"31889"
"9";"4";"5";"9";"72";"31890"
"4";"0";"4";"9";"72";"31893"
"6";"2";"4";"9";"72";"31895"
"1";"0";"1";"9";"72";"31896"
"1";"1";"0";"9";"72";"31900"
"10";"3";"7";"9";"72";"31901"
"2";"1";"1";"9";"72";"31902"
"1";"1";"0";"9";"72";"31903"
"1";"1";"0";"9";"72";"31905"
"12";"1";"11";"9";"72";"31907"
"4";"3";"1";"9";"72";"31910"
"2";"1";"1";"9";"72";"31912"
"2";"0";"2";"9";"72";"31913"
"7";"3";"4";"9";"72";"31916"
"1";"1";"0";"9";"72";"31917"
"10";"3";"7";"9";"72";"31918"
"9";"3";"6";"9";"72";"31920"
"2";"0";"2";"9";"72";"31921"
"7";"3";"4";"9";"72";"31923"
"1";"0";"1";"9";"72";"31924"
"1";"1";"0";"9";"72";"31927"
"10";"1";"9";"9";"72";"31929"
"1";"1";"0";"9";"72";"31930"
"8";"2";"6";"9";"72";"31933"
"1";"0";"1";"9";"72";"31936"
"30";"11";"19";"9";"72";"31941"
"1";"0";"1";"9";"72";"31942"
"4";"1";"3";"9";"72";"31943"
"8";"1";"7";"9";"72";"31945"
"5";"2";"3";"9";"72";"31946"
"8";"1";"7";"9";"72";"31948"
"8";"2";"6";"9";"72";"31949"
"16";"3";"13";"9";"72";"31950"
"4";"2";"2";"9";"72";"31951"
"1";"1";"0";"9";"72";"31953"
"2";"0";"2";"9";"72";"31954"
"4";"1";"3";"9";"72";"31955"
"6";"1";"5";"9";"72";"31960"
"2";"1";"1";"9";"72";"31961"
"3";"1";"2";"9";"72";"31962"
"2";"0";"2";"9";"72";"31963"
"7";"3";"4";"9";"72";"31964"
"2";"0";"2";"9";"72";"31968"
"2";"1";"1";"9";"72";"31970"
"60";"14";"46";"9";"72";"31971"
"3";"0";"3";"9";"72";"31976"
"12";"5";"7";"9";"72";"31979"
"6";"1";"5";"9";"72";"31981"
"1";"0";"1";"9";"72";"31983"
"14";"7";"7";"9";"72";"31985"
"45";"10";"35";"9";"72";"31987"
"1";"1";"0";"9";"72";"31991"
"41";"28";"13";"9";"72";"31992"
"9";"6";"3";"9";"72";"31995"
"82";"6";"76";"9";"72";"31996"
"21";"7";"14";"9";"72";"31997"
"1";"0";"1";"9";"72";"31999"
"4";"1";"3";"9";"72";"32001"
"4";"0";"4";"9";"72";"32002"
"3";"1";"2";"9";"72";"32003"
"10";"1";"9";"9";"72";"32004"
"3";"1";"2";"9";"72";"32008"
"2";"0";"2";"9";"72";"32009"
"3";"0";"3";"9";"72";"32012"
"29";"8";"21";"9";"72";"32013"
"2";"1";"1";"9";"72";"32016"
"1";"1";"0";"9";"72";"32018"
"14";"10";"4";"9";"72";"32019"
"67";"10";"57";"9";"72";"32021"
"3";"0";"3";"9";"72";"32022"
"4";"0";"4";"9";"72";"32024"
"9";"7";"2";"9";"72";"32026"
"3";"0";"3";"9";"72";"32027"
"7";"2";"5";"9";"72";"32028"
"5";"3";"2";"9";"72";"32033"
"1";"1";"0";"9";"72";"32036"
"3";"0";"3";"9";"72";"32041"
"119";"68";"51";"9";"72";"32045"
"151";"97";"54";"9";"72";"32046"
"9";"7";"2";"9";"72";"32047"
"2";"2";"0";"9";"72";"32048"
"263";"206";"57";"9";"72";"32049"
"15";"6";"9";"9";"72";"32054"
"46";"30";"16";"9";"72";"32058"
"3";"1";"2";"9";"72";"32062"
"6";"2";"4";"9";"72";"32065"
"7";"3";"4";"9";"72";"32066"
"1";"1";"0";"9";"72";"32067"
"47";"29";"18";"9";"72";"32068"
"3";"0";"3";"9";"72";"32069"
"8";"1";"7";"9";"72";"32071"
"2";"1";"1";"9";"72";"32073"
"6";"2";"4";"9";"72";"32075"
"3";"0";"3";"9";"72";"32076"
"8";"1";"7";"9";"72";"32077"
"1";"1";"0";"9";"72";"32078"
"11";"5";"6";"9";"72";"32079"
"3";"0";"3";"9";"72";"32080"
"4";"2";"2";"9";"72";"32084"
"1";"0";"1";"9";"72";"32085"
"7";"2";"5";"9";"72";"32087"
"11";"2";"9";"9";"72";"32093"
"8";"1";"7";"9";"72";"32095"
"19";"5";"14";"9";"72";"32097"
"1";"1";"0";"9";"72";"32101"
"6";"1";"5";"9";"72";"32102"
"2";"0";"2";"9";"72";"32103"
"1";"1";"0";"9";"72";"32107"
"1";"0";"1";"9";"72";"32109"
"2";"2";"0";"9";"72";"32112"
"6";"1";"5";"9";"72";"32113"
"57";"22";"35";"9";"72";"32114"
"6";"0";"6";"9";"72";"32115"
"5";"0";"5";"9";"72";"32116"
"2";"1";"1";"9";"72";"32117"
"12";"5";"7";"9";"72";"32119"
"16";"7";"9";"9";"72";"32120"
"7";"4";"3";"9";"72";"32121"
"2";"1";"1";"9";"72";"32122"
"21";"11";"10";"9";"72";"32123"
"1";"1";"0";"9";"72";"32124"
"2";"1";"1";"9";"72";"32130"
"3";"1";"2";"9";"72";"32131"
"1";"1";"0";"9";"72";"32132"
"9";"3";"6";"9";"72";"32135"
"3";"1";"2";"9";"72";"32139"
"3";"0";"3";"9";"72";"32140"
"2";"0";"2";"9";"72";"32143"
"1";"0";"1";"9";"72";"32145"
"3";"0";"3";"9";"72";"32147"
"1";"1";"0";"9";"72";"32148"
"1";"0";"1";"9";"72";"32149"
"7";"1";"6";"9";"72";"32150"
"12";"4";"8";"9";"72";"32151"
"3";"0";"3";"9";"72";"32154"
"1";"1";"0";"9";"72";"32157"
"1";"1";"0";"9";"72";"32158"
"4";"2";"2";"9";"72";"32159"
"7";"3";"4";"9";"72";"32160"
"5";"2";"3";"9";"72";"32161"
"1";"1";"0";"9";"72";"32166"
"22";"3";"19";"9";"72";"32168"
"7";"3";"4";"9";"72";"32170"
"41";"34";"7";"9";"72";"32172"
"1";"1";"0";"9";"72";"32173"
"12";"9";"3";"9";"72";"32174"
"7";"1";"6";"9";"72";"32175"
"3";"1";"2";"9";"72";"32176"
"8";"0";"8";"9";"72";"32177"
"9";"8";"1";"9";"72";"32178"
"4";"2";"2";"9";"72";"32179"
"4";"0";"4";"9";"72";"32180"
"6";"2";"4";"9";"72";"32181"
"2";"0";"2";"9";"72";"32183"
"5";"2";"3";"9";"72";"32184"
"9";"5";"4";"9";"72";"32187"
"1";"0";"1";"9";"72";"32190"
"2";"0";"2";"9";"72";"32191"
"1";"1";"0";"9";"72";"32192"
"13";"11";"2";"9";"72";"32193"
"1";"1";"0";"9";"72";"32194"
"1";"1";"0";"9";"72";"32196"
"4";"1";"3";"9";"72";"32197"
"2";"2";"0";"9";"72";"32198"
"6";"3";"3";"9";"72";"32202"
"7";"4";"3";"9";"72";"32207"
"10";"1";"9";"9";"72";"32210"
"18";"10";"8";"9";"72";"32214"
"5";"3";"2";"9";"72";"32215"
"4";"1";"3";"9";"72";"32220"
"1";"1";"0";"9";"72";"32222"
"2";"1";"1";"9";"72";"32223"
"2";"2";"0";"9";"72";"32225"
"2";"2";"0";"9";"72";"32226"
"1";"0";"1";"9";"72";"32227"
"5";"1";"4";"9";"72";"32228"
"2";"1";"1";"9";"72";"32229"
"2";"1";"1";"9";"72";"32230"
"10";"4";"6";"9";"72";"32232"
"2";"0";"2";"9";"72";"32233"
"1";"1";"0";"9";"72";"32234"
"2";"0";"2";"9";"72";"32236"
"2";"1";"1";"9";"72";"32237"
"41";"27";"14";"9";"72";"32239"
"75";"22";"53";"9";"72";"32243"
"3";"1";"2";"9";"72";"32252"
"6";"1";"5";"9";"72";"32257"
"6";"3";"3";"9";"72";"32259"
"2";"1";"1";"9";"72";"32262"
"20";"2";"18";"9";"72";"32263"
"2";"1";"1";"9";"72";"32264"
"16";"4";"12";"9";"72";"32266"
"2";"1";"1";"9";"72";"32267"
"4";"0";"4";"9";"72";"32268"
"11";"6";"5";"9";"72";"32269"
"3";"0";"3";"9";"72";"32270"
"2";"1";"1";"9";"72";"32272"
"1";"1";"0";"9";"72";"32273"
"21";"7";"14";"9";"72";"32274"
"3";"1";"2";"9";"72";"32275"
"7";"2";"5";"9";"72";"32278"
"4";"0";"4";"9";"72";"32281"
"1";"0";"1";"9";"72";"32282"
"7";"4";"3";"9";"72";"32284"
"8";"1";"7";"9";"72";"32286"
"6";"2";"4";"9";"72";"32288"
"189";"119";"70";"9";"72";"32290"
"4";"1";"3";"9";"72";"32291"
"1";"1";"0";"9";"72";"32294"
"3";"1";"2";"9";"72";"32299"
"4";"1";"3";"9";"72";"32301"
"4";"0";"4";"9";"72";"32307"
"3";"1";"2";"9";"72";"32308"
"2";"1";"1";"9";"72";"32309"
"9";"3";"6";"9";"72";"32311"
"4";"0";"4";"9";"72";"32313"
"2";"0";"2";"9";"72";"32314"
"1";"1";"0";"9";"72";"32315"
"6";"3";"3";"9";"72";"32317"
"6";"0";"6";"9";"72";"32319"
"9";"2";"7";"9";"72";"32320"
"4";"1";"3";"9";"72";"32322"
"5";"1";"4";"9";"72";"32323"
"2";"0";"2";"9";"72";"32330"
"3";"1";"2";"9";"72";"32333"
"17";"3";"14";"9";"72";"32336"
"1";"0";"1";"9";"72";"32338"
"2";"1";"1";"9";"72";"32339"
"5";"1";"4";"9";"72";"32341"
"125";"42";"83";"9";"72";"32343"
"6";"2";"4";"9";"72";"32344"
"12";"0";"12";"9";"72";"32347"
"3";"1";"2";"9";"72";"32348"
"1";"0";"1";"9";"72";"32349"
"9";"4";"5";"9";"72";"32350"
"29";"26";"3";"9";"72";"32351"
"1";"1";"0";"9";"72";"32352"
"21";"12";"9";"9";"72";"32353"
"79";"10";"69";"9";"72";"32355"
"25";"13";"12";"9";"72";"32356"
"17";"12";"5";"9";"72";"32358"
"2";"1";"1";"9";"72";"32359"
"6";"3";"3";"9";"72";"32360"
"2";"1";"1";"9";"72";"32361"
"1";"1";"0";"9";"72";"32363"
"5";"5";"0";"9";"72";"32364"
"7";"3";"4";"9";"72";"32366"
"6";"6";"0";"9";"72";"32368"
"12";"11";"1";"9";"72";"32370"
"5";"2";"3";"9";"72";"32372"
"3";"3";"0";"9";"72";"32373"
"5";"0";"5";"9";"72";"32374"
"1";"0";"1";"9";"72";"32375"
"4";"0";"4";"9";"72";"32376"
"1";"1";"0";"9";"72";"32379"
"4";"4";"0";"9";"72";"32383"
"15";"5";"10";"9";"72";"32384"
"14";"9";"5";"9";"72";"32385"
"2";"2";"0";"9";"72";"32386"
"5";"2";"3";"9";"72";"32388"
"1";"1";"0";"9";"72";"32389"
"3";"3";"0";"9";"72";"32390"
"2";"0";"2";"9";"72";"32393"
"4";"2";"2";"9";"72";"32394"
"1";"1";"0";"9";"72";"32396"
"12";"2";"10";"9";"72";"32397"
"2";"1";"1";"9";"72";"32400"
"6";"2";"4";"9";"72";"32401"
"1";"1";"0";"9";"72";"32402"
"1";"0";"1";"9";"72";"32406"
"4";"1";"3";"9";"72";"32407"
"24";"10";"14";"9";"72";"32411"
"42";"17";"25";"9";"72";"32412"
"7";"2";"5";"9";"72";"32413"
"3";"0";"3";"9";"72";"32414"
"27";"13";"14";"9";"72";"32416"
"4";"1";"3";"9";"72";"32420"
"5";"2";"3";"9";"72";"32421"
"2";"1";"1";"9";"72";"32422"
"13";"3";"10";"9";"72";"32423"
"13";"1";"12";"9";"72";"32424"
"2";"2";"0";"9";"72";"32425"
"2";"1";"1";"9";"72";"32426"
"66";"47";"19";"9";"72";"32430"
"1";"1";"0";"9";"72";"32432"
"24";"6";"18";"9";"72";"32433"
"3";"0";"3";"9";"72";"32434"
"2";"0";"2";"9";"72";"32439"
"2";"2";"0";"9";"72";"32443"
"2";"0";"2";"9";"72";"32444"
"1";"1";"0";"9";"72";"32446"
"4";"2";"2";"9";"72";"32448"
"9";"1";"8";"9";"72";"32450"
"1";"0";"1";"9";"72";"32451"
"7";"3";"4";"9";"72";"32452"
"1";"1";"0";"9";"72";"32455"
"4";"2";"2";"9";"72";"32462"
"5";"1";"4";"9";"72";"32464"
"1";"1";"0";"9";"72";"32468"
"2";"0";"2";"9";"72";"32471"
"4";"1";"3";"9";"72";"32474"
"3";"0";"3";"9";"72";"32475"
"2";"0";"2";"9";"72";"32477"
"145";"122";"23";"9";"72";"32478"
"25";"12";"13";"9";"72";"32479"
"5";"3";"2";"9";"72";"32480"
"5";"5";"0";"9";"72";"32481"
"4";"2";"2";"9";"72";"32483"
"3";"0";"3";"9";"72";"32484"
"2";"1";"1";"9";"72";"32488"
"628";"535";"93";"9";"72";"32489"
"5";"0";"5";"9";"72";"32490"
"2";"0";"2";"9";"72";"32492"
"29";"16";"13";"9";"72";"32494"
"38";"28";"10";"9";"72";"32495"
"2";"1";"1";"9";"72";"32496"
"11";"5";"6";"9";"72";"32497"
"3";"1";"2";"9";"72";"32499"
"1";"1";"0";"9";"72";"32500"
"1";"1";"0";"9";"72";"32504"
"25";"8";"17";"9";"72";"32510"
"4";"1";"3";"9";"72";"32513"
"6";"1";"5";"9";"72";"32514"
"11";"1";"10";"9";"72";"32515"
"27";"3";"24";"9";"72";"32517"
"3";"1";"2";"9";"72";"32518"
"2";"1";"1";"9";"72";"32519"
"4";"0";"4";"9";"72";"32520"
"3";"1";"2";"9";"72";"32522"
"1";"0";"1";"9";"72";"32525"
"2";"1";"1";"9";"72";"32526"
"8";"1";"7";"9";"72";"32528"
"11";"3";"8";"9";"72";"32529"
"1";"0";"1";"9";"72";"32531"
"10";"1";"9";"9";"72";"32532"
"11";"3";"8";"9";"72";"32538"
"3";"0";"3";"9";"72";"32539"
"8";"4";"4";"9";"72";"32541"
"3";"1";"2";"9";"72";"32542"
"6";"0";"6";"9";"72";"32543"
"3";"3";"0";"9";"72";"32545"
"1";"0";"1";"9";"72";"32546"
"6";"2";"4";"9";"72";"32548"
"1";"0";"1";"9";"72";"32550"
"1";"1";"0";"9";"72";"32552"
"23";"14";"9";"9";"72";"32554"
"7";"2";"5";"9";"72";"32555"
"4";"0";"4";"9";"72";"32556"
"1";"0";"1";"9";"72";"32557"
"20";"5";"15";"9";"72";"32562"
"2";"1";"1";"9";"72";"32566"
"1";"1";"0";"9";"72";"32567"
"1";"1";"0";"9";"72";"32568"
"2";"1";"1";"9";"72";"32569"
"3";"3";"0";"9";"72";"32571"
"1";"0";"1";"9";"72";"32572"
"7";"7";"0";"9";"72";"32573"
"4";"4";"0";"9";"72";"32574"
"4";"2";"2";"9";"72";"32576"
"1";"0";"1";"9";"72";"32578"
"6";"2";"4";"9";"72";"32580"
"6";"0";"6";"9";"72";"32581"
"1";"0";"1";"9";"72";"32582"
"11";"4";"7";"9";"72";"32583"
"4";"1";"3";"9";"72";"32584"
"169";"115";"54";"9";"72";"32586"
"2";"0";"2";"9";"72";"32587"
"2";"0";"2";"9";"72";"32590"
"2";"2";"0";"9";"72";"32591"
"8";"1";"7";"9";"72";"32592"
"1";"0";"1";"9";"72";"32594"
"23";"4";"19";"9";"72";"32595"
"1";"1";"0";"9";"72";"32596"
"3";"3";"0";"9";"72";"32598"
"1";"1";"0";"9";"72";"32600"
"1";"0";"1";"9";"72";"32601"
"17";"5";"12";"9";"72";"32602"
"9";"2";"7";"9";"72";"32603"
"4";"1";"3";"9";"72";"32604"
"5";"2";"3";"9";"72";"32605"
"5";"2";"3";"9";"72";"32607"
"1";"0";"1";"9";"72";"32608"
"3";"0";"3";"9";"72";"32610"
"9";"1";"8";"9";"72";"32611"
"12";"7";"5";"9";"72";"32612"
"4";"2";"2";"9";"72";"32614"
"6";"1";"5";"9";"72";"32615"
"1";"0";"1";"9";"72";"32619"
"5";"0";"5";"9";"72";"32620"
"4";"1";"3";"9";"72";"32623"
"2";"0";"2";"9";"72";"32625"
"2";"1";"1";"9";"72";"32628"
"1";"1";"0";"9";"72";"32633"
"3";"0";"3";"9";"72";"32635"
"8";"2";"6";"9";"72";"32637"
"3";"0";"3";"9";"72";"32638"
"15";"6";"9";"9";"72";"32642"
"1";"0";"1";"9";"72";"32645"
"3";"0";"3";"9";"72";"32646"
"14";"6";"8";"9";"72";"32650"
"8";"1";"7";"9";"72";"32651"
"10";"7";"3";"9";"72";"32653"
"4";"1";"3";"9";"72";"32655"
"228";"199";"29";"9";"72";"32659"
"18";"2";"16";"9";"72";"32660"
"2";"0";"2";"9";"72";"32662"
"21";"13";"8";"9";"72";"32664"
"2";"1";"1";"9";"72";"32665"
"5";"1";"4";"9";"72";"32668"
"5";"1";"4";"9";"72";"32669"
"1";"0";"1";"9";"72";"32673"
"2";"1";"1";"9";"72";"32674"
"22";"8";"14";"9";"72";"32678"
"3";"0";"3";"9";"72";"32680"
"22";"14";"8";"9";"72";"32684"
"9";"2";"7";"9";"72";"32685"
"8";"2";"6";"9";"72";"32687"
"1";"1";"0";"9";"72";"32688"
"21";"6";"15";"9";"72";"32689"
"1";"0";"1";"9";"72";"32691"
"1";"1";"0";"9";"72";"32692"
"4";"1";"3";"9";"72";"32696"
"2";"1";"1";"9";"72";"32698"
"34";"18";"16";"9";"72";"32699"
"21";"1";"20";"9";"72";"32701"
"3";"1";"2";"9";"72";"32703"
"3";"1";"2";"9";"72";"32704"
"2";"2";"0";"9";"72";"32707"
"1";"1";"0";"9";"72";"32708"
"6";"2";"4";"9";"72";"32709"
"4";"1";"3";"9";"72";"32710"
"8";"2";"6";"9";"72";"32712"
"2";"1";"1";"9";"72";"32713"
"63";"13";"50";"9";"72";"32714"
"1";"1";"0";"9";"72";"32716"
"7";"1";"6";"9";"72";"32717"
"2";"1";"1";"9";"72";"32718"
"1";"0";"1";"9";"72";"32720"
"6";"2";"4";"9";"72";"32721"
"2";"0";"2";"9";"72";"32724"
"1";"1";"0";"9";"72";"32725"
"5";"5";"0";"9";"72";"32727"
"1";"1";"0";"9";"72";"32728"
"1";"1";"0";"9";"72";"32729"
"5";"4";"1";"9";"72";"32732"
"1";"1";"0";"9";"72";"32733"
"2";"2";"0";"9";"72";"32736"
"10";"4";"6";"9";"72";"32739"
"3";"0";"3";"9";"72";"32740"
"8";"4";"4";"9";"72";"32741"
"1";"1";"0";"9";"72";"32742"
"1";"1";"0";"9";"72";"32744"
"2";"1";"1";"9";"72";"32748"
"2";"1";"1";"9";"72";"32749"
"2";"2";"0";"9";"72";"32750"
"3";"0";"3";"9";"72";"32751"
"11";"3";"8";"9";"72";"32753"
"2";"2";"0";"9";"72";"32754"
"5";"0";"5";"9";"72";"32755"
"2";"0";"2";"9";"72";"32756"
"4";"0";"4";"9";"72";"32758"
"6";"2";"4";"9";"72";"32759"
"4";"2";"2";"9";"72";"32760"
"5";"1";"4";"9";"72";"32761"
"6";"3";"3";"9";"72";"32765"
"7";"3";"4";"9";"72";"32767"
"6";"3";"3";"9";"72";"32768"
"2";"0";"2";"9";"72";"32770"
"2";"1";"1";"9";"72";"32771"
"2";"0";"2";"9";"72";"32772"
"2";"2";"0";"9";"72";"32773"
"21";"5";"16";"9";"72";"32777"
"3";"0";"3";"9";"72";"32779"
"1";"0";"1";"9";"72";"32780"
"3";"1";"2";"9";"72";"32782"
"6";"4";"2";"9";"72";"32783"
"3";"0";"3";"9";"72";"32784"
"6";"2";"4";"9";"72";"32786"
"4";"1";"3";"9";"72";"32788"
"2";"1";"1";"9";"72";"32789"
"15";"3";"12";"9";"72";"32793"
"7";"1";"6";"9";"72";"32794"
"1";"1";"0";"9";"72";"32796"
"18";"6";"12";"9";"72";"32797"
"29";"10";"19";"9";"72";"32798"
"2";"1";"1";"9";"72";"32799"
"2";"1";"1";"9";"72";"32800"
"7";"1";"6";"9";"72";"32804"
"15";"3";"12";"9";"72";"32807"
"2";"0";"2";"9";"72";"32808"
"2";"1";"1";"9";"72";"32813"
"51";"29";"22";"9";"72";"32815"
"2";"0";"2";"9";"72";"32816"
"2";"1";"1";"9";"72";"32823"
"1";"1";"0";"9";"72";"32831"
"1";"1";"0";"9";"72";"32833"
"66";"47";"19";"9";"72";"32834"
"4";"2";"2";"9";"72";"32835"
"4";"1";"3";"9";"72";"32836"
"2";"1";"1";"9";"72";"32839"
"1";"1";"0";"9";"72";"32840"
"3";"1";"2";"9";"72";"32842"
"11";"3";"8";"9";"72";"32845"
"3";"1";"2";"9";"72";"32846"
"4";"1";"3";"9";"72";"32847"
"6";"1";"5";"9";"72";"32848"
"3";"2";"1";"9";"72";"32855"
"1";"0";"1";"9";"72";"32857"
"4";"1";"3";"9";"72";"32858"
"1";"1";"0";"9";"72";"32859"
"8";"3";"5";"9";"72";"32860"
"36";"6";"30";"9";"72";"32861"
"4";"2";"2";"9";"72";"32862"
"2";"1";"1";"9";"72";"32863"
"3";"0";"3";"9";"72";"32867"
"4";"3";"1";"9";"72";"32868"
"3";"1";"2";"9";"72";"32870"
"4";"2";"2";"9";"72";"32871"
"5";"0";"5";"9";"72";"32872"
"3";"0";"3";"9";"72";"32876"
"7";"1";"6";"9";"72";"32879"
"1";"1";"0";"9";"72";"32880"
"47";"15";"32";"9";"72";"32882"
"14";"6";"8";"9";"72";"32883"
"7";"0";"7";"9";"72";"32884"
"1";"1";"0";"9";"72";"32885"
"9";"4";"5";"9";"72";"32887"
"1";"1";"0";"9";"72";"32890"
"16";"4";"12";"9";"72";"32893"
"12";"2";"10";"9";"72";"32895"
"5";"1";"4";"9";"72";"32898"
"2";"0";"2";"9";"72";"32899"
"1";"1";"0";"9";"72";"32901"
"7";"4";"3";"9";"72";"32903"
"19";"11";"8";"9";"72";"32904"
"6";"2";"4";"9";"72";"32905"
"3";"3";"0";"9";"72";"32908"
"2";"0";"2";"9";"72";"32911"
"4";"0";"4";"9";"72";"32913"
"1";"0";"1";"9";"72";"32914"
"1";"1";"0";"9";"72";"32921"
"2";"1";"1";"9";"72";"32923"
"2";"1";"1";"9";"72";"32926"
"4";"1";"3";"9";"72";"32927"
"9";"3";"6";"9";"72";"32928"
"6";"0";"6";"9";"72";"32929"
"4";"0";"4";"9";"72";"32931"
"24";"21";"3";"9";"72";"32936"
"6";"2";"4";"9";"72";"32937"
"8";"1";"7";"9";"72";"32938"
"4";"2";"2";"9";"72";"32939"
"1";"1";"0";"9";"72";"32945"
"4";"1";"3";"9";"72";"32946"
"1";"1";"0";"9";"72";"32948"
"1";"1";"0";"9";"72";"32949"
"3";"1";"2";"9";"72";"32951"
"1";"0";"1";"9";"72";"32952"
"5";"1";"4";"9";"72";"32954"
"7";"3";"4";"9";"72";"32956"
"4";"0";"4";"9";"72";"32957"
"5";"0";"5";"9";"72";"32958"
"7";"1";"6";"9";"72";"32959"
"6";"3";"3";"9";"72";"32961"
"6";"0";"6";"9";"72";"32962"
"3";"0";"3";"9";"72";"32964"
"1";"0";"1";"9";"72";"32966"
"9";"3";"6";"9";"72";"32967"
"8";"2";"6";"9";"72";"32968"
"4";"2";"2";"9";"72";"32969"
"10";"1";"9";"9";"72";"32970"
"12";"3";"9";"9";"72";"32972"
"4";"1";"3";"9";"72";"32973"
"6";"0";"6";"9";"72";"32974"
"3";"1";"2";"9";"72";"32975"
"4";"1";"3";"9";"72";"32976"
"11";"1";"10";"9";"72";"32978"
"2";"0";"2";"9";"72";"32980"
"3";"1";"2";"9";"72";"32983"
"1";"1";"0";"9";"72";"32986"
"4";"1";"3";"9";"72";"32989"
"4";"1";"3";"9";"72";"32991"
"8";"0";"8";"9";"72";"32993"
"34";"19";"15";"9";"72";"32994"
"3";"1";"2";"9";"72";"32996"
"3";"2";"1";"9";"72";"32997"
"7";"1";"6";"9";"72";"33002"
"37";"30";"7";"9";"72";"33003"
"5";"2";"3";"9";"72";"33004"
"3";"1";"2";"9";"72";"33008"
"7";"1";"6";"9";"72";"33010"
"5";"3";"2";"9";"72";"33011"
"9";"1";"8";"9";"72";"33019"
"11";"1";"10";"9";"72";"33021"
"3";"1";"2";"9";"72";"33022"
"1";"1";"0";"9";"72";"33023"
"3";"1";"2";"9";"72";"33028"
"2";"1";"1";"9";"72";"33030"
"3";"0";"3";"9";"72";"33032"
"7";"1";"6";"9";"72";"33033"
"21";"9";"12";"9";"72";"33037"
"10";"1";"9";"9";"72";"33038"
"2";"0";"2";"9";"72";"33042"
"6";"1";"5";"9";"72";"33043"
"3";"3";"0";"9";"72";"33053"
"3";"0";"3";"9";"72";"33058"
"1";"1";"0";"9";"72";"33060"
"2";"2";"0";"9";"72";"33061"
"7";"1";"6";"9";"72";"33062"
"2";"1";"1";"9";"72";"33070"
"3";"1";"2";"9";"72";"33072"
"2";"0";"2";"9";"72";"33075"
"2";"1";"1";"9";"72";"33076"
"56";"7";"49";"9";"72";"33078"
"72";"52";"20";"9";"72";"33079"
"1";"0";"1";"9";"72";"33081"
"1";"0";"1";"9";"72";"33086"
"45";"13";"32";"9";"72";"33087"
"19";"11";"8";"9";"72";"33088"
"6";"2";"4";"9";"72";"33089"
"3";"1";"2";"9";"72";"33090"
"6";"1";"5";"9";"72";"33091"
"42";"31";"11";"9";"72";"33095"
"12";"5";"7";"9";"72";"33100"
"4";"1";"3";"9";"72";"33101"
"4";"2";"2";"9";"72";"33102"
"1";"0";"1";"9";"72";"33103"
"10";"2";"8";"9";"72";"33109"
"4";"1";"3";"9";"72";"33110"
"5";"2";"3";"9";"72";"33111"
"4";"2";"2";"9";"72";"33112"
"1";"1";"0";"9";"72";"33114"
"14";"5";"9";"9";"72";"33115"
"5";"1";"4";"9";"72";"33116"
"33";"15";"18";"9";"72";"33117"
"12";"4";"8";"9";"72";"33118"
"6";"3";"3";"9";"72";"33121"
"5";"2";"3";"9";"72";"33124"
"2";"0";"2";"9";"72";"33125"
"4";"1";"3";"9";"72";"33128"
"1";"0";"1";"9";"72";"33129"
"9";"6";"3";"9";"72";"33133"
"7";"3";"4";"9";"72";"33134"
"3";"0";"3";"9";"72";"33137"
"16";"1";"15";"9";"72";"33139"
"2";"1";"1";"9";"72";"33141"
"2";"0";"2";"9";"72";"33142"
"8";"1";"7";"9";"72";"33144"
"5";"0";"5";"9";"72";"33146"
"16";"9";"7";"9";"72";"33147"
"6";"2";"4";"9";"72";"33149"
"9";"2";"7";"9";"72";"33150"
"38";"15";"23";"9";"72";"33153"
"1";"1";"0";"9";"72";"33154"
"12";"3";"9";"9";"72";"33155"
"107";"64";"43";"9";"72";"33156"
"7";"2";"5";"9";"72";"33157"
"4";"1";"3";"9";"72";"33160"
"5";"2";"3";"9";"72";"33161"
"9";"5";"4";"9";"72";"33162"
"6";"2";"4";"9";"72";"33165"
"11";"2";"9";"9";"72";"33166"
"2";"0";"2";"9";"72";"33167"
"2";"1";"1";"9";"72";"33168"
"4";"1";"3";"9";"72";"33169"
"2";"1";"1";"9";"72";"33170"
"15";"5";"10";"9";"72";"33173"
"1";"1";"0";"9";"72";"33177"
"42";"8";"34";"9";"72";"33178"
"5";"0";"5";"9";"72";"33181"
"33";"11";"22";"9";"72";"33183"
"2";"2";"0";"9";"72";"33184"
"7";"2";"5";"9";"72";"33186"
"3";"0";"3";"9";"72";"33187"
"11";"4";"7";"9";"72";"33188"
"1";"1";"0";"9";"72";"33189"
"1";"1";"0";"9";"72";"33191"
"1";"0";"1";"9";"72";"33194"
"18";"9";"9";"9";"72";"33195"
"3";"1";"2";"9";"72";"33198"
"1";"0";"1";"9";"72";"33199"
"46";"14";"32";"9";"72";"33206"
"2";"0";"2";"9";"72";"33207"
"3";"0";"3";"9";"72";"33209"
"1";"1";"0";"9";"72";"33212"
"3";"1";"2";"9";"72";"33214"
"10";"0";"10";"9";"72";"33218"
"7";"1";"6";"9";"72";"33219"
"9";"7";"2";"9";"72";"33221"
"11";"0";"11";"9";"72";"33222"
"10";"2";"8";"9";"72";"33223"
"7";"3";"4";"9";"72";"33224"
"6";"2";"4";"9";"72";"33225"
"219";"143";"76";"9";"72";"33226"
"2";"0";"2";"9";"72";"33228"
"10";"2";"8";"9";"72";"33232"
"7";"2";"5";"9";"72";"33233"
"19";"4";"15";"9";"72";"33235"
"3";"1";"2";"9";"72";"33236"
"8";"1";"7";"9";"72";"33237"
"49";"20";"29";"9";"72";"33239"
"1";"1";"0";"9";"72";"33242"
"6";"1";"5";"9";"72";"33246"
"1";"0";"1";"9";"72";"33248"
"17";"7";"10";"9";"72";"33252"
"36";"22";"14";"9";"72";"33254"
"1";"1";"0";"9";"72";"33257"
"3";"3";"0";"9";"72";"33259"
"3";"0";"3";"9";"72";"33260"
"3";"0";"3";"9";"72";"33264"
"1";"0";"1";"9";"72";"33270"
"4";"0";"4";"9";"72";"33278"
"2";"2";"0";"9";"72";"33279"
"2";"0";"2";"9";"72";"33280"
"6";"2";"4";"9";"72";"33283"
"1";"0";"1";"9";"72";"33284"
"13";"5";"8";"9";"72";"33285"
"3";"1";"2";"9";"72";"33286"
"1";"1";"0";"9";"72";"33289"
"4";"0";"4";"9";"72";"33290"
"2";"0";"2";"9";"72";"33292"
"2";"0";"2";"9";"72";"33293"
"5";"2";"3";"9";"72";"33297"
"2";"1";"1";"9";"72";"33298"
"16";"2";"14";"9";"72";"33299"
"6";"2";"4";"9";"72";"33302"
"2";"1";"1";"9";"72";"33304"
"23";"11";"12";"9";"72";"33306"
"3";"1";"2";"9";"72";"33308"
"8";"2";"6";"9";"72";"33309"
"3";"2";"1";"9";"72";"33311"
"18";"4";"14";"9";"72";"33313"
"3";"1";"2";"9";"72";"33316"
"2";"0";"2";"9";"72";"33319"
"1";"1";"0";"9";"72";"33320"
"2";"1";"1";"9";"72";"33327"
"10";"2";"8";"9";"72";"33328"
"4";"1";"3";"9";"72";"33330"
"7";"1";"6";"9";"72";"33334"
"1";"0";"1";"9";"72";"33336"
"4";"1";"3";"9";"72";"33337"
"4";"0";"4";"9";"72";"33339"
"4";"1";"3";"9";"72";"33340"
"2";"1";"1";"9";"72";"33342"
"1";"1";"0";"9";"72";"33343"
"28";"4";"24";"9";"72";"33344"
"3";"1";"2";"9";"72";"33346"
"2";"0";"2";"9";"72";"33348"
"3";"0";"3";"9";"72";"33350"
"20";"13";"7";"9";"72";"33351"
"3";"3";"0";"9";"72";"33355"
"2";"1";"1";"9";"72";"33359"
"1";"1";"0";"9";"72";"33364"
"7";"3";"4";"9";"72";"33365"
"1";"1";"0";"9";"72";"33367"
"1";"1";"0";"9";"72";"33368"
"7";"1";"6";"9";"72";"33369"
"3";"1";"2";"9";"72";"33370"
"1";"1";"0";"9";"72";"33376"
"2";"2";"0";"9";"72";"33377"
"3";"0";"3";"9";"72";"33378"
"3";"1";"2";"9";"72";"33381"
"1";"1";"0";"9";"72";"33382"
"1";"1";"0";"9";"72";"33384"
"3";"0";"3";"9";"72";"33385"
"8";"4";"4";"9";"72";"33388"
"2";"0";"2";"9";"72";"33389"
"1";"0";"1";"9";"72";"33390"
"2";"0";"2";"9";"72";"33395"
"1";"0";"1";"9";"72";"33397"
"1";"1";"0";"9";"72";"33399"
"4";"4";"0";"9";"72";"33400"
"1";"1";"0";"9";"72";"33402"
"1";"1";"0";"9";"72";"33406"
"9";"7";"2";"9";"72";"33410"
"1";"0";"1";"9";"72";"33411"
"8";"5";"3";"9";"72";"33412"
"2";"1";"1";"9";"72";"33418"
"12";"1";"11";"9";"72";"33420"
"14";"3";"11";"9";"72";"33421"
"2";"1";"1";"9";"72";"33423"
"1";"1";"0";"9";"72";"33429"
"1";"1";"0";"9";"72";"33430"
"10";"1";"9";"9";"72";"33432"
"7";"1";"6";"9";"72";"33436"
"3";"1";"2";"9";"72";"33437"
"1";"1";"0";"9";"72";"33441"
"2";"2";"0";"9";"72";"33443"
"3";"3";"0";"9";"72";"33449"
"2";"2";"0";"9";"72";"33450"
"1";"1";"0";"9";"72";"33451"
"1";"1";"0";"9";"72";"33455"
"1";"1";"0";"9";"72";"33458"
"1";"1";"0";"9";"72";"33460"
"1";"1";"0";"9";"72";"33462"
"1";"1";"0";"9";"72";"33464"
"10";"5";"5";"9";"72";"33467"
"1";"1";"0";"9";"72";"33469"
"1";"1";"0";"9";"72";"33472"
"3";"0";"3";"9";"72";"33474"
"5";"2";"3";"9";"72";"33478"
"1";"0";"1";"9";"72";"33479"
"6";"4";"2";"9";"72";"33481"
"15";"14";"1";"9";"72";"33482"
"1";"0";"1";"9";"72";"33483"
"1";"0";"1";"9";"72";"33484"
"4";"2";"2";"9";"72";"33485"
"2";"0";"2";"9";"72";"33486"
"12";"3";"9";"9";"72";"33487"
"5";"1";"4";"9";"72";"33489"
"4";"0";"4";"9";"72";"33490"
"1";"0";"1";"9";"72";"33491"
"8";"2";"6";"9";"72";"33495"
"1";"1";"0";"9";"72";"33496"
"6";"1";"5";"9";"72";"33497"
"3";"1";"2";"9";"72";"33499"
"17";"3";"14";"9";"72";"33500"
"141";"100";"41";"9";"72";"33501"
"3";"1";"2";"9";"72";"33502"
"2";"0";"2";"9";"72";"33504"
"3";"0";"3";"9";"72";"33506"
"4";"0";"4";"9";"72";"33508"
"6";"2";"4";"9";"72";"33509"
"5";"2";"3";"9";"72";"33510"
"1";"1";"0";"9";"72";"33511"
"2";"2";"0";"9";"72";"33512"
"1";"1";"0";"9";"72";"33513"
"2";"1";"1";"9";"72";"33519"
"3";"3";"0";"9";"72";"33521"
"10";"6";"4";"9";"72";"33522"
"6";"2";"4";"9";"72";"33523"
"2";"1";"1";"9";"72";"33526"
"6";"3";"3";"9";"72";"33527"
"4";"1";"3";"9";"72";"33528"
"1";"1";"0";"9";"72";"33530"
"8";"0";"8";"9";"72";"33531"
"2";"1";"1";"9";"72";"33532"
"15";"8";"7";"9";"72";"33533"
"2";"1";"1";"9";"72";"33535"
"1";"1";"0";"9";"72";"33536"
"13";"7";"6";"9";"72";"33537"
"2";"0";"2";"9";"72";"33539"
"5";"1";"4";"9";"72";"33540"
"24";"7";"17";"9";"72";"33542"
"5";"1";"4";"9";"72";"33543"
"7";"1";"6";"9";"72";"33544"
"9";"7";"2";"9";"72";"33545"
"5";"0";"5";"9";"72";"33546"
"55";"39";"16";"9";"72";"33547"
"10";"3";"7";"9";"72";"33549"
"1";"1";"0";"9";"72";"33550"
"3";"1";"2";"9";"72";"33552"
"2";"0";"2";"9";"72";"33553"
"8";"2";"6";"9";"72";"33554"
"2";"2";"0";"9";"72";"33557"
"1";"1";"0";"9";"72";"33558"
"2";"0";"2";"9";"72";"33562"
"3";"1";"2";"9";"72";"33563"
"8";"3";"5";"9";"72";"33565"
"19";"7";"12";"9";"72";"33566"
"8";"4";"4";"9";"72";"33567"
"1";"1";"0";"9";"72";"33568"
"3";"0";"3";"9";"72";"33569"
"15";"9";"6";"9";"72";"33570"
"6";"3";"3";"9";"72";"33571"
"8";"0";"8";"9";"72";"33576"
"3";"1";"2";"9";"72";"33577"
"10";"5";"5";"9";"72";"33578"
"7";"3";"4";"9";"72";"33581"
"1";"0";"1";"9";"72";"33582"
"3";"2";"1";"9";"72";"33583"
"1";"1";"0";"9";"72";"33586"
"7";"1";"6";"9";"72";"33587"
"8";"1";"7";"9";"72";"33588"
"24";"11";"13";"9";"72";"33589"
"8";"3";"5";"9";"72";"33590"
"2";"1";"1";"9";"72";"33595"
"4";"1";"3";"9";"72";"33596"
"66";"41";"25";"9";"72";"33598"
"1";"1";"0";"9";"72";"33600"
"7";"4";"3";"9";"72";"33603"
"6";"1";"5";"9";"72";"33604"
"2";"2";"0";"9";"72";"33605"
"4";"1";"3";"9";"72";"33607"
"1";"0";"1";"9";"72";"33608"
"9";"1";"8";"9";"72";"33609"
"23";"3";"20";"9";"72";"33611"
"1";"1";"0";"9";"72";"33613"
"6";"1";"5";"9";"72";"33614"
"11";"0";"11";"9";"72";"33615"
"5";"1";"4";"9";"72";"33616"
"2";"0";"2";"9";"72";"33617"
"10";"1";"9";"9";"72";"33618"
"2";"0";"2";"9";"72";"33620"
"8";"2";"6";"9";"72";"33624"
"1";"1";"0";"9";"72";"33625"
"3";"2";"1";"9";"72";"33626"
"1";"1";"0";"9";"72";"33628"
"5";"1";"4";"9";"72";"33629"
"1";"0";"1";"9";"72";"33630"
"3";"2";"1";"9";"72";"33634"
"4";"2";"2";"9";"72";"33635"
"5";"1";"4";"9";"72";"33637"
"1";"1";"0";"9";"72";"33638"
"8";"3";"5";"9";"72";"33639"
"4";"0";"4";"9";"72";"33640"
"2";"0";"2";"9";"72";"33641"
"3";"1";"2";"9";"72";"33642"
"2";"0";"2";"9";"72";"33645"
"5";"1";"4";"9";"72";"33646"
"5";"1";"4";"9";"72";"33647"
"5";"1";"4";"9";"72";"33649"
"2";"2";"0";"9";"72";"33650"
"8";"2";"6";"9";"72";"33652"
"1";"1";"0";"9";"72";"33653"
"42";"30";"12";"9";"72";"33655"
"7";"1";"6";"9";"72";"33657"
"1";"0";"1";"9";"72";"33659"
"3";"1";"2";"9";"72";"33660"
"3";"1";"2";"9";"72";"33663"
"5";"2";"3";"9";"72";"33664"
"4";"1";"3";"9";"72";"33665"
"4";"1";"3";"9";"72";"33668"
"5";"1";"4";"9";"72";"33671"
"6";"1";"5";"9";"72";"33672"
"2";"0";"2";"9";"72";"33674"
"10";"3";"7";"9";"72";"33675"
"1";"1";"0";"9";"72";"33676"
"4";"2";"2";"9";"72";"33680"
"2";"1";"1";"9";"72";"33681"
"1";"1";"0";"9";"72";"33682"
"2";"1";"1";"9";"72";"33686"
"2";"1";"1";"9";"72";"33687"
"2";"1";"1";"9";"72";"33690"
"1";"1";"0";"9";"72";"33692"
"2";"2";"0";"9";"72";"33693"
"5";"0";"5";"9";"72";"33697"
"7";"2";"5";"9";"72";"33701"
"8";"4";"4";"9";"72";"33702"
"2";"1";"1";"9";"72";"33705"
"5";"1";"4";"9";"72";"33712"
"2";"1";"1";"9";"72";"33716"
"19";"16";"3";"9";"72";"33717"
"4";"1";"3";"9";"72";"33718"
"4";"1";"3";"9";"72";"33720"
"1";"1";"0";"9";"72";"33721"
"2";"1";"1";"9";"72";"33723"
"1";"0";"1";"9";"72";"33724"
"4";"1";"3";"9";"72";"33725"
"2";"0";"2";"9";"72";"33726"
"5";"3";"2";"9";"72";"33727"
"2";"0";"2";"9";"72";"33728"
"7";"2";"5";"9";"72";"33729"
"9";"2";"7";"9";"72";"33731"
"2";"1";"1";"9";"72";"33734"
"84";"58";"26";"9";"72";"33738"
"2";"1";"1";"9";"72";"33739"
"65";"49";"16";"9";"72";"33743"
"1";"1";"0";"9";"72";"33744"
"6";"2";"4";"9";"72";"33745"
"2";"1";"1";"9";"72";"33746"
"1";"0";"1";"9";"72";"33748"
"2";"1";"1";"9";"72";"33749"
"5";"1";"4";"9";"72";"33750"
"3";"0";"3";"9";"72";"33752"
"2";"1";"1";"9";"72";"33753"
"2";"1";"1";"9";"72";"33754"
"2";"1";"1";"9";"72";"33756"
"4";"2";"2";"9";"72";"33759"
"6";"1";"5";"9";"72";"33760"
"19";"4";"15";"9";"72";"33762"
"100";"31";"69";"9";"72";"33763"
"26";"5";"21";"9";"72";"33766"
"14";"0";"14";"9";"72";"33771"
"1";"1";"0";"9";"72";"33772"
"8";"2";"6";"9";"72";"33774"
"5";"3";"2";"9";"72";"33775"
"5";"3";"2";"9";"72";"33776"
"16";"5";"11";"9";"72";"33778"
"1";"0";"1";"9";"72";"33781"
"3";"1";"2";"9";"72";"33784"
"10";"10";"0";"9";"72";"33790"
"12";"1";"11";"9";"72";"33791"
"8";"6";"2";"9";"72";"33794"
"4";"4";"0";"9";"72";"33797"
"2";"2";"0";"9";"72";"33801"
"5";"2";"3";"9";"72";"33802"
"1";"1";"0";"9";"72";"33806"
"1";"1";"0";"9";"72";"33807"
"1";"1";"0";"9";"72";"33808"
"8";"3";"5";"9";"72";"33810"
"5";"1";"4";"9";"72";"33812"
"11";"3";"8";"9";"72";"33815"
"3";"1";"2";"9";"72";"33823"
"2";"1";"1";"9";"72";"33827"
"3";"3";"0";"9";"72";"33830"
"5";"0";"5";"9";"72";"33832"
"9";"6";"3";"9";"72";"33836"
"1";"1";"0";"9";"72";"33839"
"3";"0";"3";"9";"72";"33844"
"9";"0";"9";"9";"72";"33846"
"3";"0";"3";"9";"72";"33848"
"2";"0";"2";"9";"72";"33849"
"7";"3";"4";"9";"72";"33856"
"3";"0";"3";"9";"72";"33859"
"6";"2";"4";"9";"72";"33863"
"113";"78";"35";"9";"72";"33865"
"1";"1";"0";"9";"72";"33867"
"1";"0";"1";"9";"72";"33876"
"5";"2";"3";"9";"72";"33877"
"4";"0";"4";"9";"72";"33878"
"6";"0";"6";"9";"72";"33881"
"13";"5";"8";"9";"72";"33883"
"9";"7";"2";"9";"72";"33885"
"17";"2";"15";"9";"72";"33887"
"15";"10";"5";"9";"72";"33888"
"8";"2";"6";"9";"72";"33889"
"3";"0";"3";"9";"72";"33890"
"13";"4";"9";"9";"72";"33892"
"20";"4";"16";"9";"72";"33894"
"4";"1";"3";"9";"72";"33895"
"4";"0";"4";"9";"72";"33896"
"2";"1";"1";"9";"72";"33898"
"11";"0";"11";"9";"72";"33900"
"7";"3";"4";"9";"72";"33901"
"3";"1";"2";"9";"72";"33904"
"3";"1";"2";"9";"72";"33907"
"4";"2";"2";"9";"72";"33910"
"1";"1";"0";"9";"72";"33911"
"11";"3";"8";"9";"72";"33912"
"48";"9";"39";"9";"72";"33914"
"2";"1";"1";"9";"72";"33915"
"11";"3";"8";"9";"72";"33921"
"11";"9";"2";"9";"72";"33923"
"18";"12";"6";"9";"72";"33925"
"2";"0";"2";"9";"72";"33927"
"3";"1";"2";"9";"72";"33932"
"1";"1";"0";"9";"72";"33934"
"1";"1";"0";"9";"72";"33936"
"4";"0";"4";"9";"72";"33937"
"5";"1";"4";"9";"72";"33939"
"3";"3";"0";"9";"72";"33941"
"1";"1";"0";"9";"72";"33945"
"4";"2";"2";"9";"72";"33946"
"5";"1";"4";"9";"72";"33948"
"12";"2";"10";"9";"72";"33950"
"3";"1";"2";"9";"72";"33955"
"1";"1";"0";"9";"72";"33958"
"1";"1";"0";"9";"72";"33959"
"1";"0";"1";"9";"72";"33961"
"2";"0";"2";"9";"72";"33962"
"6";"2";"4";"9";"72";"33963"
"5";"3";"2";"9";"72";"33964"
"2";"0";"2";"9";"72";"33968"
"2";"1";"1";"9";"72";"33972"
"1";"0";"1";"9";"72";"33973"
"2";"2";"0";"9";"72";"33974"
"82";"59";"23";"9";"72";"33980"
"28";"15";"13";"9";"72";"33982"
"1";"1";"0";"9";"72";"33985"
"3";"1";"2";"9";"72";"33986"
"12";"2";"10";"9";"72";"33987"
"3";"1";"2";"9";"72";"33990"
"16";"0";"16";"9";"72";"33991"
"2";"0";"2";"9";"72";"33992"
"4";"2";"2";"9";"72";"33993"
"1";"1";"0";"9";"72";"33995"
"1";"1";"0";"9";"72";"34000"
"51";"32";"19";"9";"72";"34001"
"8";"2";"6";"9";"72";"34003"
"9";"3";"6";"9";"72";"34005"
"3";"1";"2";"9";"72";"34006"
"5";"0";"5";"9";"72";"34007"
"3";"1";"2";"9";"72";"34008"
"10";"3";"7";"9";"72";"34009"
"9";"0";"9";"9";"72";"34011"
"1";"1";"0";"9";"72";"34012"
"7";"1";"6";"9";"72";"34013"
"2";"0";"2";"9";"72";"34018"
"2";"0";"2";"9";"72";"34021"
"2";"0";"2";"9";"72";"34022"
"4";"1";"3";"9";"72";"34023"
"3";"1";"2";"9";"72";"34024"
"3";"2";"1";"9";"72";"34025"
"13";"7";"6";"9";"72";"34027"
"2";"0";"2";"9";"72";"34032"
"1";"0";"1";"9";"72";"34035"
"12";"7";"5";"9";"72";"34036"
"1";"1";"0";"9";"72";"34038"
"1";"1";"0";"9";"72";"34042"
"19";"6";"13";"9";"72";"34046"
"1";"1";"0";"9";"72";"34047"
"9";"4";"5";"9";"72";"34050"
"1";"0";"1";"9";"72";"34051"
"4";"1";"3";"9";"72";"34053"
"1";"1";"0";"9";"72";"34055"
"1";"1";"0";"9";"72";"34061"
"2";"0";"2";"9";"72";"34062"
"8";"2";"6";"9";"72";"34063"
"3";"1";"2";"9";"72";"34071"
"5";"2";"3";"9";"72";"34072"
"9";"3";"6";"9";"72";"34073"
"22";"6";"16";"9";"72";"34077"
"4";"1";"3";"9";"72";"34079"
"7";"7";"0";"9";"72";"34080"
"1";"1";"0";"9";"72";"34081"
"7";"7";"0";"9";"72";"34084"
"5";"2";"3";"9";"72";"34085"
"2";"0";"2";"9";"72";"34086"
"5";"2";"3";"9";"72";"34093"
"5";"0";"5";"9";"72";"34095"
"7";"2";"5";"9";"72";"34098"
"1";"0";"1";"9";"72";"34102"
"1";"1";"0";"9";"72";"34104"
"11";"3";"8";"9";"72";"34109"
"16";"6";"10";"9";"72";"34111"
"4";"2";"2";"9";"72";"34114"
"3";"1";"2";"9";"72";"34115"
"1";"1";"0";"9";"72";"34118"
"1";"0";"1";"9";"72";"34121"
"3";"1";"2";"9";"72";"34125"
"3";"0";"3";"9";"72";"34126"
"77";"48";"29";"9";"72";"34129"
"9";"1";"8";"9";"72";"34130"
"7";"2";"5";"9";"72";"34133"
"5";"1";"4";"9";"72";"34137"
"1";"0";"1";"9";"72";"34139"
"5";"2";"3";"9";"72";"34142"
"8";"2";"6";"9";"72";"34144"
"1";"1";"0";"9";"72";"34147"
"1";"1";"0";"9";"72";"34150"
"1";"0";"1";"9";"72";"34151"
"1";"0";"1";"9";"72";"34168"
"4";"0";"4";"9";"72";"34169"
"2";"1";"1";"9";"72";"34170"
"4";"1";"3";"9";"72";"34172"
"2";"0";"2";"9";"72";"34173"
"7";"2";"5";"9";"72";"34175"
"1";"1";"0";"9";"72";"34179"
"1";"0";"1";"9";"72";"34180"
"2";"1";"1";"9";"72";"34181"
"3";"0";"3";"9";"72";"34184"
"26";"21";"5";"9";"72";"34185"
"4";"1";"3";"9";"72";"34186"
"5";"2";"3";"9";"72";"34188"
"10";"1";"9";"9";"72";"34195"
"2";"2";"0";"9";"72";"34197"
"1";"0";"1";"9";"72";"34198"
"1";"0";"1";"9";"72";"34200"
"6";"1";"5";"9";"72";"34205"
"17";"13";"4";"9";"72";"34207"
"1";"1";"0";"9";"72";"34210"
"5";"2";"3";"9";"72";"34212"
"3";"1";"2";"9";"72";"34214"
"9";"2";"7";"9";"72";"34218"
"9";"1";"8";"9";"72";"34220"
"5";"1";"4";"9";"72";"34222"
"1";"1";"0";"9";"72";"34225"
"3";"3";"0";"9";"72";"34227"
"1";"1";"0";"9";"72";"34228"
"15";"3";"12";"9";"72";"34231"
"1";"1";"0";"9";"72";"34234"
"2";"1";"1";"9";"72";"34235"
"2";"2";"0";"9";"72";"34238"
"3";"0";"3";"9";"72";"34242"
"1";"0";"1";"9";"72";"34243"
"2";"1";"1";"9";"72";"34245"
"7";"2";"5";"9";"72";"34246"
"3";"0";"3";"9";"72";"34248"
"9";"2";"7";"9";"72";"34249"
"2";"1";"1";"9";"72";"34252"
"1";"1";"0";"9";"72";"34253"
"1";"0";"1";"9";"72";"34254"
"3";"0";"3";"9";"72";"34257"
"1";"1";"0";"9";"72";"34258"
"5";"1";"4";"9";"72";"34259"
"24";"9";"15";"9";"72";"34262"
"1";"1";"0";"9";"72";"34265"
"2";"1";"1";"9";"72";"34266"
"6";"1";"5";"9";"72";"34270"
"1";"0";"1";"9";"72";"34277"
"1";"1";"0";"9";"72";"34279"
"1";"0";"1";"9";"72";"34280"
"6";"0";"6";"9";"72";"34281"
"6";"1";"5";"9";"72";"34282"
"1";"1";"0";"9";"72";"34283"
"1";"1";"0";"9";"72";"34285"
"1";"1";"0";"9";"72";"34287"
"4";"1";"3";"9";"72";"34288"
"18";"7";"11";"9";"72";"34289"
"10";"4";"6";"9";"72";"34291"
"5";"1";"4";"9";"72";"34294"
"1";"0";"1";"9";"72";"34295"
"6";"2";"4";"9";"72";"34296"
"53";"28";"25";"9";"72";"34299"
"7";"2";"5";"9";"72";"34300"
"2";"1";"1";"9";"72";"34301"
"1";"1";"0";"9";"72";"34302"
"2";"0";"2";"9";"72";"34303"
"2";"1";"1";"9";"72";"34304"
"8";"2";"6";"9";"72";"34308"
"1";"1";"0";"9";"72";"34309"
"17";"5";"12";"9";"72";"34310"
"10";"10";"0";"9";"72";"34314"
"4";"1";"3";"9";"72";"34315"
"17";"6";"11";"9";"72";"34319"
"2";"1";"1";"9";"72";"34320"
"1";"1";"0";"9";"72";"34323"
"12";"4";"8";"9";"72";"34325"
"1";"0";"1";"9";"72";"34326"
"4";"1";"3";"9";"72";"34327"
"6";"1";"5";"9";"72";"34329"
"4";"1";"3";"9";"72";"34330"
"6";"2";"4";"9";"72";"34331"
"4";"2";"2";"9";"72";"34335"
"9";"2";"7";"9";"72";"34336"
"3";"1";"2";"9";"72";"34340"
"2";"1";"1";"9";"72";"34344"
"1";"1";"0";"9";"72";"34346"
"2";"1";"1";"9";"72";"34348"
"50";"35";"15";"9";"72";"34349"
"10";"4";"6";"9";"72";"34350"
"1";"0";"1";"9";"72";"34353"
"4";"0";"4";"9";"72";"34356"
"4";"2";"2";"9";"72";"34357"
"5";"0";"5";"9";"72";"34360"
"4";"0";"4";"9";"72";"34364"
"2";"0";"2";"9";"72";"34367"
"1";"1";"0";"9";"72";"34369"
"2";"0";"2";"9";"72";"34370"
"2";"0";"2";"9";"72";"34371"
"1";"1";"0";"9";"72";"34375"
"5";"2";"3";"9";"72";"34377"
"12";"10";"2";"9";"72";"34378"
"5";"3";"2";"9";"72";"34379"
"1";"1";"0";"9";"72";"34380"
"1";"1";"0";"9";"72";"34381"
"5";"1";"4";"9";"72";"34385"
"1";"1";"0";"9";"72";"34386"
"4";"0";"4";"9";"72";"34387"
"32";"8";"24";"9";"72";"34388"
"1";"0";"1";"9";"72";"34389"
"2";"1";"1";"9";"72";"34390"
"1";"0";"1";"9";"72";"34393"
"1";"1";"0";"9";"72";"34394"
"15";"8";"7";"9";"72";"34396"
"2";"1";"1";"9";"72";"34397"
"3";"0";"3";"9";"72";"34399"
"8";"1";"7";"9";"72";"34400"
"1";"1";"0";"9";"72";"34402"
"2";"1";"1";"9";"72";"34403"
"7";"2";"5";"9";"72";"34405"
"2";"2";"0";"9";"72";"34409"
"1";"1";"0";"9";"72";"34410"
"7";"3";"4";"9";"72";"34411"
"2";"0";"2";"9";"72";"34412"
"1";"1";"0";"9";"72";"34413"
"10";"8";"2";"9";"72";"34421"
"2";"0";"2";"9";"72";"34424"
"10";"1";"9";"9";"72";"34425"
"1";"1";"0";"9";"72";"34430"
"1";"1";"0";"9";"72";"34431"
"3";"1";"2";"9";"72";"34436"
"5";"1";"4";"9";"72";"34437"
"5";"0";"5";"9";"72";"34439"
"6";"4";"2";"9";"72";"34440"
"2";"0";"2";"9";"72";"34442"
"7";"1";"6";"9";"72";"34444"
"14";"6";"8";"9";"72";"34445"
"3";"2";"1";"9";"72";"34446"
"2";"1";"1";"9";"72";"34448"
"9";"1";"8";"9";"72";"34449"
"6";"6";"0";"9";"72";"34453"
"8";"1";"7";"9";"72";"34454"
"2";"0";"2";"9";"72";"34458"
"13";"3";"10";"9";"72";"34460"
"14";"8";"6";"9";"72";"34461"
"6";"2";"4";"9";"72";"34462"
"3";"1";"2";"9";"72";"34463"
"3";"1";"2";"9";"72";"34465"
"15";"3";"12";"9";"72";"34467"
"3";"0";"3";"9";"72";"34469"
"4";"1";"3";"9";"72";"34470"
"5";"1";"4";"9";"72";"34471"
"5";"4";"1";"9";"72";"34472"
"1";"1";"0";"9";"72";"34476"
"3";"1";"2";"9";"72";"34477"
"5";"3";"2";"9";"72";"34478"
"6";"0";"6";"9";"72";"34479"
"4";"4";"0";"9";"72";"34484"
"7";"3";"4";"9";"72";"34485"
"23";"6";"17";"9";"72";"34490"
"1";"0";"1";"9";"72";"34492"
"5";"2";"3";"9";"72";"34493"
"3";"0";"3";"9";"72";"34494"
"3";"1";"2";"9";"72";"34495"
"5";"1";"4";"9";"72";"34496"
"5";"1";"4";"9";"72";"34497"
"6";"3";"3";"9";"72";"34499"
"2";"0";"2";"9";"72";"34501"
"1";"0";"1";"9";"72";"34504"
"1";"0";"1";"9";"72";"34506"
"5";"0";"5";"9";"72";"34508"
"2";"0";"2";"9";"72";"34510"
"2";"2";"0";"9";"72";"34514"
"32";"16";"16";"9";"72";"34515"
"4";"0";"4";"9";"72";"34517"
"2";"0";"2";"9";"72";"34518"
"1";"0";"1";"9";"72";"34525"
"4";"1";"3";"9";"72";"34526"
"3";"0";"3";"9";"72";"34529"
"11";"2";"9";"9";"72";"34530"
"7";"0";"7";"9";"72";"34532"
"4";"0";"4";"9";"72";"34538"
"6";"0";"6";"9";"72";"34543"
"4";"1";"3";"9";"72";"34544"
"5";"1";"4";"9";"72";"34546"
"1";"0";"1";"9";"72";"34547"
"3";"1";"2";"9";"72";"34548"
"62";"41";"21";"9";"72";"34549"
"27";"7";"20";"9";"72";"34550"
"10";"4";"6";"9";"72";"34552"
"1";"0";"1";"9";"72";"34553"
"2";"1";"1";"9";"72";"34554"
"3";"0";"3";"9";"72";"34557"
"7";"4";"3";"9";"72";"34558"
"7";"0";"7";"9";"72";"34560"
"22";"5";"17";"9";"72";"34561"
"8";"5";"3";"9";"72";"34563"
"6";"0";"6";"9";"72";"34564"
"6";"2";"4";"9";"72";"34566"
"4";"1";"3";"9";"72";"34567"
"6";"1";"5";"9";"72";"34568"
"2";"1";"1";"9";"72";"34569"
"8";"3";"5";"9";"72";"34570"
"3";"1";"2";"9";"72";"34573"
"7";"3";"4";"9";"72";"34575"
"8";"3";"5";"9";"72";"34579"
"7";"1";"6";"9";"72";"34580"
"5";"0";"5";"9";"72";"34582"
"3";"1";"2";"9";"72";"34584"
"6";"2";"4";"9";"72";"34593"
"148";"117";"31";"9";"72";"34594"
"4";"3";"1";"9";"72";"34596"
"10";"3";"7";"9";"72";"34598"
"8";"2";"6";"9";"72";"34599"
"2";"0";"2";"9";"72";"34602"
"6";"2";"4";"9";"72";"34605"
"12";"5";"7";"9";"72";"34606"
"1";"0";"1";"9";"72";"34609"
"11";"2";"9";"9";"72";"34616"
"4";"0";"4";"9";"72";"34620"
"3";"1";"2";"9";"72";"34621"
"2";"0";"2";"9";"72";"34622"
"3";"0";"3";"9";"72";"34629"
"4";"1";"3";"9";"72";"34630"
"4";"1";"3";"9";"72";"34632"
"3";"0";"3";"9";"72";"34634"
"3";"1";"2";"9";"72";"34636"
"5";"2";"3";"9";"72";"34638"
"2";"1";"1";"9";"72";"34640"
"1";"0";"1";"9";"72";"34641"
"1";"1";"0";"9";"72";"34642"
"7";"1";"6";"9";"72";"34643"
"10";"3";"7";"9";"72";"34645"
"1";"0";"1";"9";"72";"34646"
"4";"1";"3";"9";"72";"34648"
"10";"5";"5";"9";"72";"34650"
"1";"1";"0";"9";"72";"34651"
"4";"1";"3";"9";"72";"34652"
"3";"0";"3";"9";"72";"34653"
"7";"2";"5";"9";"72";"34655"
"49";"19";"30";"9";"72";"34656"
"37";"9";"28";"9";"72";"34659"
"11";"2";"9";"9";"72";"34660"
"6";"3";"3";"9";"72";"34662"
"13";"0";"13";"9";"72";"34663"
"1";"1";"0";"9";"72";"34664"
"6";"1";"5";"9";"72";"34666"
"3";"0";"3";"9";"72";"34673"
"5";"1";"4";"9";"72";"34675"
"5";"2";"3";"9";"72";"34678"
"4";"2";"2";"9";"72";"34681"
"1";"0";"1";"9";"72";"34682"
"2";"1";"1";"9";"72";"34684"
"1391";"1061";"330";"9";"72";"34685"
"10";"2";"8";"9";"72";"34686"
"2";"0";"2";"9";"72";"34689"
"8";"1";"7";"9";"72";"34691"
"3";"0";"3";"9";"72";"34692"
"2";"1";"1";"9";"72";"34693"
"7";"3";"4";"9";"72";"34694"
"3";"0";"3";"9";"72";"34695"
"4";"0";"4";"9";"72";"34696"
"1";"1";"0";"9";"72";"34702"
"7";"1";"6";"9";"72";"34703"
"2";"0";"2";"9";"72";"34710"
"4";"2";"2";"9";"72";"34711"
"2";"1";"1";"9";"72";"34713"
"1";"0";"1";"9";"72";"34714"
"2";"1";"1";"9";"72";"34716"
"2";"0";"2";"9";"72";"34719"
"5";"2";"3";"9";"72";"34721"
"1";"1";"0";"9";"72";"34722"
"6";"1";"5";"9";"72";"34723"
"10";"5";"5";"9";"72";"34724"
"2";"1";"1";"9";"72";"34728"
"1";"1";"0";"9";"72";"34729"
"3";"0";"3";"9";"72";"34730"
"26";"17";"9";"9";"72";"34731"
"6";"2";"4";"9";"72";"34735"
"17";"0";"17";"9";"72";"34738"
"11";"5";"6";"9";"72";"34739"
"1";"0";"1";"9";"72";"34740"
"2";"0";"2";"9";"72";"34744"
"8";"0";"8";"9";"72";"34745"
"26";"9";"17";"9";"72";"34748"
"2";"0";"2";"9";"72";"34749"
"4";"2";"2";"9";"72";"34752"
"1";"0";"1";"9";"72";"34754"
"1";"1";"0";"9";"72";"34755"
"2";"0";"2";"9";"72";"34758"
"2";"1";"1";"9";"72";"34760"
"6";"2";"4";"9";"72";"34763"
"1";"0";"1";"9";"72";"34764"
"56";"28";"28";"9";"72";"34765"
"4";"2";"2";"9";"72";"34766"
"1";"1";"0";"9";"72";"34770"
"5";"1";"4";"9";"72";"34771"
"10";"3";"7";"9";"72";"34772"
"5";"1";"4";"9";"72";"34773"
"3";"3";"0";"9";"72";"34778"
"13";"11";"2";"9";"72";"34779"
"11";"2";"9";"9";"72";"34781"
"2";"1";"1";"9";"72";"34782"
"10";"8";"2";"9";"72";"34783"
"1";"1";"0";"9";"72";"34786"
"2";"1";"1";"9";"72";"34787"
"2";"1";"1";"9";"72";"34789"
"10";"7";"3";"9";"72";"34790"
"4";"3";"1";"9";"72";"34792"
"1";"1";"0";"9";"72";"34795"
"6";"1";"5";"9";"72";"34798"
"5";"2";"3";"9";"72";"34803"
"2";"1";"1";"9";"72";"34805"
"66";"25";"41";"9";"72";"34810"
"4";"0";"4";"9";"72";"34816"
"6";"0";"6";"9";"72";"34817"
"3";"0";"3";"9";"72";"34818"
"4";"0";"4";"9";"72";"34820"
"4";"1";"3";"9";"72";"34821"
"3";"0";"3";"9";"72";"34823"
"18";"15";"3";"9";"72";"34824"
"2";"1";"1";"9";"72";"34829"
"3";"0";"3";"9";"72";"34831"
"15";"6";"9";"9";"72";"34832"
"4";"1";"3";"9";"72";"34837"
"15";"4";"11";"9";"72";"34838"
"1";"1";"0";"9";"72";"34839"
"6";"1";"5";"9";"72";"34841"
"16";"13";"3";"9";"72";"34842"
"4";"0";"4";"9";"72";"34843"
"4";"2";"2";"9";"72";"34844"
"5";"2";"3";"9";"72";"34848"
"2";"2";"0";"9";"72";"34852"
"2";"0";"2";"9";"72";"34854"
"3";"0";"3";"9";"72";"34855"
"1";"0";"1";"9";"72";"34857"
"3";"1";"2";"9";"72";"34858"
"2";"1";"1";"9";"72";"34859"
"4";"1";"3";"9";"72";"34863"
"1";"1";"0";"9";"72";"34868"
"1";"1";"0";"9";"72";"34869"
"5";"1";"4";"9";"72";"34871"
"2";"2";"0";"9";"72";"34873"
"21";"2";"19";"9";"72";"34876"
"5";"1";"4";"9";"72";"34877"
"4";"2";"2";"9";"72";"34878"
"35";"5";"30";"9";"72";"34883"
"1";"1";"0";"9";"72";"34885"
"3";"2";"1";"9";"72";"34888"
"3";"1";"2";"9";"72";"34892"
"22";"10";"12";"9";"72";"34893"
"30";"7";"23";"9";"72";"34894"
"4";"2";"2";"9";"72";"34895"
"1";"0";"1";"9";"72";"34896"
"1";"1";"0";"9";"72";"34903"
"6";"3";"3";"9";"72";"34906"
"5";"0";"5";"9";"72";"34907"
"2";"1";"1";"9";"72";"34909"
"2";"0";"2";"9";"72";"34911"
"5";"2";"3";"9";"72";"34913"
"5";"2";"3";"9";"72";"34914"
"1";"1";"0";"9";"72";"34916"
"3";"0";"3";"9";"72";"34919"
"5";"0";"5";"9";"72";"34920"
"44";"4";"40";"9";"72";"34923"
"4";"2";"2";"9";"72";"34927"
"2";"2";"0";"9";"72";"34930"
"3";"1";"2";"9";"72";"34931"
"16";"10";"6";"9";"72";"34932"
"3";"1";"2";"9";"72";"34933"
"3";"0";"3";"9";"72";"34934"
"2";"0";"2";"9";"72";"34937"
"7";"2";"5";"9";"72";"34939"
"2";"1";"1";"9";"72";"34940"
"2";"1";"1";"9";"72";"34942"
"3";"3";"0";"9";"72";"34943"
"5";"2";"3";"9";"72";"34944"
"9";"4";"5";"9";"72";"34946"
"4";"1";"3";"9";"72";"34947"
"2";"1";"1";"9";"72";"34949"
"2";"1";"1";"9";"72";"34954"
"3";"1";"2";"9";"72";"34955"
"2";"0";"2";"9";"72";"34956"
"90";"49";"41";"9";"72";"34961"
"2";"1";"1";"9";"72";"34964"
"4";"0";"4";"9";"72";"34966"
"10";"1";"9";"9";"72";"34967"
"9";"1";"8";"9";"72";"34968"
"8";"2";"6";"9";"72";"34969"
"1";"1";"0";"9";"72";"34971"
"2";"1";"1";"9";"72";"34972"
"4";"0";"4";"9";"72";"34975"
"6";"1";"5";"9";"72";"34976"
"2";"0";"2";"9";"72";"34978"
"1";"1";"0";"9";"72";"34981"
"2";"0";"2";"9";"72";"34982"
"4";"3";"1";"9";"72";"34985"
"3";"0";"3";"9";"72";"34986"
"3";"0";"3";"9";"72";"34988"
"7";"2";"5";"9";"72";"34989"
"5";"1";"4";"9";"72";"34992"
"2";"1";"1";"9";"72";"34994"
"8";"2";"6";"9";"72";"34996"
"6";"3";"3";"9";"72";"35000"
"8";"3";"5";"9";"72";"35003"
"7";"1";"6";"9";"72";"35004"
"1";"0";"1";"9";"72";"35005"
"1";"1";"0";"9";"72";"35014"
"1";"0";"1";"9";"72";"35015"
"1";"1";"0";"9";"72";"35017"
"3";"3";"0";"9";"72";"35018"
"2";"0";"2";"9";"72";"35019"
"2";"1";"1";"9";"72";"35020"
"5";"1";"4";"9";"72";"35021"
"2";"0";"2";"9";"72";"35022"
"1";"1";"0";"9";"72";"35026"
"6";"2";"4";"9";"72";"35027"
"1";"1";"0";"9";"72";"35032"
"1";"0";"1";"9";"72";"35033"
"3";"2";"1";"9";"72";"35034"
"5";"1";"4";"9";"72";"35036"
"5";"0";"5";"9";"72";"35038"
"138";"74";"64";"9";"72";"35040"
"9";"1";"8";"9";"72";"35041"
"10";"3";"7";"9";"72";"35043"
"7";"1";"6";"9";"72";"35047"
"1";"1";"0";"9";"72";"35050"
"5";"1";"4";"9";"72";"35054"
"4";"2";"2";"9";"72";"35055"
"8";"3";"5";"9";"72";"35057"
"5";"2";"3";"9";"72";"35058"
"12";"9";"3";"9";"72";"35061"
"2";"0";"2";"9";"72";"35062"
"2";"0";"2";"9";"72";"35063"
"2";"0";"2";"9";"72";"35064"
"2";"0";"2";"9";"72";"35066"
"1";"0";"1";"9";"72";"35067"
"3";"1";"2";"9";"72";"35071"
"4";"2";"2";"9";"72";"35074"
"9";"0";"9";"9";"72";"35077"
"435";"328";"107";"9";"72";"35079"
"1";"0";"1";"9";"72";"35080"
"4";"1";"3";"9";"72";"35081"
"5";"1";"4";"9";"72";"35083"
"8";"0";"8";"9";"72";"35085"
"11";"1";"10";"9";"72";"35089"
"4";"2";"2";"9";"72";"35100"
"5";"1";"4";"9";"72";"35101"
"2";"2";"0";"9";"72";"35102"
"1";"1";"0";"9";"72";"35103"
"1";"1";"0";"9";"72";"35105"
"37";"14";"23";"9";"72";"35107"
"2";"0";"2";"9";"72";"35109"
"1";"1";"0";"9";"72";"35110"
"4";"1";"3";"9";"72";"35112"
"2";"1";"1";"9";"72";"35113"
"15";"11";"4";"9";"72";"35116"
"1";"0";"1";"9";"72";"35121"
"3";"1";"2";"9";"72";"35125"
"5";"2";"3";"9";"72";"35126"
"2";"1";"1";"9";"72";"35128"
"4";"0";"4";"9";"72";"35129"
"6";"3";"3";"9";"72";"35131"
"12";"1";"11";"9";"72";"35132"
"1";"1";"0";"9";"72";"35135"
"11";"4";"7";"9";"72";"35136"
"3";"0";"3";"9";"72";"35137"
"6";"2";"4";"9";"72";"35139"
"34";"17";"17";"9";"72";"35145"
"3";"0";"3";"9";"72";"35146"
"2";"0";"2";"9";"72";"35148"
"19";"4";"15";"9";"72";"35152"
"2";"0";"2";"9";"72";"35153"
"5";"2";"3";"9";"72";"35155"
"28";"5";"23";"9";"72";"35160"
"5";"2";"3";"9";"72";"35161"
"5";"2";"3";"9";"72";"35162"
"12";"2";"10";"9";"72";"35164"
"6";"2";"4";"9";"72";"35168"
"1";"1";"0";"9";"72";"35170"
"6";"0";"6";"9";"72";"35176"
"3";"0";"3";"9";"72";"35178"
"5";"1";"4";"9";"72";"35180"
"39";"10";"29";"9";"72";"35181"
"1";"0";"1";"9";"72";"35182"
"8";"1";"7";"9";"72";"35184"
"5";"3";"2";"9";"72";"35189"
"6";"2";"4";"9";"72";"35190"
"3";"0";"3";"9";"72";"35191"
"2";"2";"0";"9";"72";"35195"
"7";"2";"5";"9";"72";"35196"
"5";"2";"3";"9";"72";"35197"
"41";"16";"25";"9";"72";"35199"
"20";"9";"11";"9";"72";"35201"
"5";"1";"4";"9";"72";"35202"
"4";"0";"4";"9";"72";"35206"
"1";"1";"0";"9";"72";"35207"
"4";"0";"4";"9";"72";"35208"
"1";"1";"0";"9";"72";"35209"
"6";"0";"6";"9";"72";"35210"
"10";"6";"4";"9";"72";"35211"
"7";"6";"1";"9";"72";"35212"
"4";"1";"3";"9";"72";"35213"
"6";"4";"2";"9";"72";"35214"
"3";"1";"2";"9";"72";"35215"
"8";"0";"8";"9";"72";"35217"
"8";"3";"5";"9";"72";"35218"
"14";"4";"10";"9";"72";"35220"
"41";"29";"12";"9";"72";"35221"
"6";"0";"6";"9";"72";"35222"
"5";"2";"3";"9";"72";"35227"
"3";"1";"2";"9";"72";"35228"
"5";"1";"4";"9";"72";"35230"
"1";"0";"1";"9";"72";"35231"
"18";"7";"11";"9";"72";"35233"
"4";"2";"2";"9";"72";"35234"
"3";"0";"3";"9";"72";"35236"
"58";"11";"47";"9";"72";"35237"
"8";"3";"5";"9";"72";"35238"
"80";"55";"25";"9";"72";"35241"
"5";"0";"5";"9";"72";"35243"
"4";"1";"3";"9";"72";"35244"
"9";"1";"8";"9";"72";"35245"
"7";"1";"6";"9";"72";"35246"
"8";"3";"5";"9";"72";"35248"
"1";"1";"0";"9";"72";"35250"
"1";"1";"0";"9";"72";"35252"
"1";"1";"0";"9";"72";"35253"
"8";"1";"7";"9";"72";"35254"
"12";"5";"7";"9";"72";"35255"
"6";"1";"5";"9";"72";"35256"
"8";"2";"6";"9";"72";"35259"
"7";"4";"3";"9";"72";"35260"
"6";"0";"6";"9";"72";"35265"
"10";"1";"9";"9";"72";"35270"
"5";"2";"3";"9";"72";"35273"
"3";"0";"3";"9";"72";"35274"
"6";"1";"5";"9";"72";"35275"
"6";"2";"4";"9";"72";"35279"
"2";"0";"2";"9";"72";"35282"
"6";"1";"5";"9";"72";"35284"
"5";"2";"3";"9";"72";"35286"
"8";"2";"6";"9";"72";"35290"
"16";"9";"7";"9";"72";"35291"
"1";"0";"1";"9";"72";"35292"
"3";"3";"0";"9";"72";"35293"
"13";"2";"11";"9";"72";"35296"
"2";"1";"1";"9";"72";"35301"
"14";"0";"14";"9";"72";"35302"
"6";"1";"5";"9";"72";"35303"
"5";"2";"3";"9";"72";"35307"
"217";"205";"12";"9";"72";"35308"
"1";"1";"0";"9";"72";"35309"
"5";"5";"0";"9";"72";"35311"
"6";"3";"3";"9";"72";"35312"
"4";"0";"4";"9";"72";"35314"
"3";"1";"2";"9";"72";"35316"
"4";"2";"2";"9";"72";"35317"
"3";"1";"2";"9";"72";"35320"
"1";"1";"0";"9";"72";"35322"
"5";"2";"3";"9";"72";"35325"
"1";"1";"0";"9";"72";"35326"
"4";"0";"4";"9";"72";"35327"
"1";"1";"0";"9";"72";"35328"
"1";"1";"0";"9";"72";"35332"
"15";"4";"11";"9";"72";"35333"
"6";"1";"5";"9";"72";"35341"
"3";"1";"2";"9";"72";"35342"
"3";"2";"1";"9";"72";"35343"
"2";"1";"1";"9";"72";"35349"
"3";"0";"3";"9";"72";"35351"
"1";"1";"0";"9";"72";"35353"
"6";"1";"5";"9";"72";"35355"
"3";"0";"3";"9";"72";"35356"
"1";"0";"1";"9";"72";"35359"
"7";"1";"6";"9";"72";"35360"
"1";"1";"0";"9";"72";"35361"
"1";"0";"1";"9";"72";"35363"
"10";"1";"9";"9";"72";"35365"
"1";"0";"1";"9";"72";"35366"
"1";"0";"1";"9";"72";"35367"
"2";"0";"2";"9";"72";"35372"
"7";"2";"5";"9";"72";"35374"
"22";"10";"12";"9";"72";"35377"
"1";"0";"1";"9";"72";"35383"
"162";"125";"37";"9";"72";"35387"
"1";"1";"0";"9";"72";"35393"
"11";"2";"9";"9";"72";"35397"
"3";"1";"2";"9";"72";"35398"
"2";"1";"1";"9";"72";"35400"
"1";"1";"0";"9";"72";"35402"
"1";"0";"1";"9";"72";"35406"
"2";"1";"1";"9";"72";"35408"
"11";"2";"9";"9";"72";"35411"
"3";"0";"3";"9";"72";"35412"
"11";"1";"10";"9";"72";"35416"
"3";"1";"2";"9";"72";"35418"
"15";"3";"12";"9";"72";"35419"
"432";"354";"78";"9";"72";"35420"
"5";"2";"3";"9";"72";"35422"
"8";"2";"6";"9";"72";"35423"
"3";"0";"3";"9";"72";"35425"
"3";"2";"1";"9";"72";"35427"
"10";"1";"9";"9";"72";"35428"
"10";"0";"10";"9";"72";"35430"
"8";"1";"7";"9";"72";"35431"
"2";"1";"1";"9";"72";"35433"
"8";"1";"7";"9";"72";"35435"
"16";"2";"14";"9";"72";"35436"
"9";"0";"9";"9";"72";"35437"
"1";"1";"0";"9";"72";"35439"
"14";"8";"6";"9";"72";"35440"
"76";"51";"25";"9";"72";"35443"
"1";"1";"0";"9";"72";"35446"
"2";"2";"0";"9";"72";"35448"
"3";"1";"2";"9";"72";"35450"
"4";"0";"4";"9";"72";"35452"
"135";"88";"47";"9";"72";"35456"
"17";"10";"7";"9";"72";"35457"
"5";"3";"2";"9";"72";"35459"
"5";"0";"5";"9";"72";"35462"
"1";"0";"1";"9";"72";"35463"
"8";"6";"2";"9";"72";"35464"
"17";"5";"12";"9";"72";"35465"
"41";"2";"39";"9";"72";"35469"
"1";"1";"0";"9";"72";"35471"
"18";"6";"12";"9";"72";"35472"
"5";"2";"3";"9";"72";"35473"
"2";"0";"2";"9";"72";"35474"
"5";"0";"5";"9";"72";"35475"
"5";"4";"1";"9";"72";"35476"
"2";"0";"2";"9";"72";"35478"
"2";"2";"0";"9";"72";"35480"
"7";"1";"6";"9";"72";"35484"
"2";"0";"2";"9";"72";"35486"
"6";"1";"5";"9";"72";"35487"
"11";"3";"8";"9";"72";"35488"
"4";"1";"3";"9";"72";"35490"
"9";"3";"6";"9";"72";"35491"
"4";"1";"3";"9";"72";"35495"
"8";"1";"7";"9";"72";"35498"
"9";"1";"8";"9";"72";"35499"
"22";"14";"8";"9";"72";"35500"
"1";"0";"1";"9";"72";"35501"
"1";"0";"1";"9";"72";"35504"
"5";"1";"4";"9";"72";"35506"
"3";"1";"2";"9";"72";"35508"
"1";"1";"0";"9";"72";"35509"
"9";"1";"8";"9";"72";"35510"
"7";"1";"6";"9";"72";"35511"
"7";"1";"6";"9";"72";"35513"
"13";"3";"10";"9";"72";"35516"
"1";"1";"0";"9";"72";"35518"
"4";"2";"2";"9";"72";"35519"
"1";"1";"0";"9";"72";"35521"
"1";"1";"0";"9";"72";"35522"
"6";"1";"5";"9";"72";"35524"
"1";"1";"0";"9";"72";"35526"
"4";"1";"3";"9";"72";"35527"
"1";"1";"0";"9";"72";"35530"
"3";"1";"2";"9";"72";"35531"
"1";"0";"1";"9";"72";"35535"
"3";"1";"2";"9";"72";"35538"
"9";"1";"8";"9";"72";"35539"
"2";"1";"1";"9";"72";"35544"
"1";"1";"0";"9";"72";"35545"
"1";"1";"0";"9";"72";"35546"
"1";"1";"0";"9";"72";"35548"
"2";"2";"0";"9";"72";"35549"
"4";"2";"2";"9";"72";"35555"
"9";"3";"6";"9";"72";"35558"
"2";"0";"2";"9";"72";"35559"
"5";"0";"5";"9";"72";"35562"
"1";"1";"0";"9";"72";"35564"
"1";"1";"0";"9";"72";"35565"
"5";"1";"4";"9";"72";"35567"
"1";"1";"0";"9";"72";"35569"
"1";"1";"0";"9";"72";"35570"
"6";"0";"6";"9";"72";"35572"
"2";"0";"2";"9";"72";"35575"
"2";"1";"1";"9";"72";"35577"
"1";"1";"0";"9";"72";"35578"
"15";"10";"5";"9";"72";"35579"
"1";"1";"0";"9";"72";"35580"
"6";"1";"5";"9";"72";"35582"
"83";"56";"27";"9";"72";"35583"
"2";"2";"0";"9";"72";"35584"
"2";"2";"0";"9";"72";"35590"
"8";"3";"5";"9";"72";"35591"
"6";"4";"2";"9";"72";"35594"
"6";"2";"4";"9";"72";"35595"
"5";"1";"4";"9";"72";"35597"
"9";"6";"3";"9";"72";"35599"
"42";"37";"5";"9";"72";"35600"
"10";"2";"8";"9";"72";"35604"
"20";"4";"16";"9";"72";"35606"
"1";"0";"1";"9";"72";"35607"
"14";"2";"12";"9";"72";"35608"
"1";"1";"0";"9";"72";"35610"
"7";"1";"6";"9";"72";"35617"
"1";"1";"0";"9";"72";"35619"
"7";"1";"6";"9";"72";"35620"
"2";"0";"2";"9";"72";"35623"
"16";"5";"11";"9";"72";"35624"
"6";"0";"6";"9";"72";"35625"
"2";"1";"1";"9";"72";"35626"
"5";"1";"4";"9";"72";"35627"
"3";"0";"3";"9";"72";"35628"
"6";"4";"2";"9";"72";"35630"
"1";"1";"0";"9";"72";"35635"
"15";"3";"12";"9";"72";"35636"
"3";"1";"2";"9";"72";"35639"
"10";"4";"6";"9";"72";"35640"
"3";"0";"3";"9";"72";"35641"
"2";"0";"2";"9";"72";"35644"
"3";"1";"2";"9";"72";"35648"
"5";"1";"4";"9";"72";"35654"
"5";"2";"3";"9";"72";"35657"
"13";"4";"9";"9";"72";"35660"
"1";"1";"0";"9";"72";"35664"
"5";"0";"5";"9";"72";"35666"
"8";"1";"7";"9";"72";"35668"
"6";"1";"5";"9";"72";"35670"
"25";"15";"10";"9";"72";"35672"
"2";"0";"2";"9";"72";"35675"
"20";"9";"11";"9";"72";"35678"
"8";"2";"6";"9";"72";"35679"
"3";"1";"2";"9";"72";"35680"
"2";"1";"1";"9";"72";"35684"
"1";"0";"1";"9";"72";"35687"
"3";"1";"2";"9";"72";"35692"
"2";"0";"2";"9";"72";"35693"
"6";"2";"4";"9";"72";"35694"
"17";"14";"3";"9";"72";"35696"
"1";"1";"0";"9";"72";"35697"
"9";"1";"8";"9";"72";"35700"
"2";"1";"1";"9";"72";"35702"
"1";"1";"0";"9";"72";"35705"
"3";"1";"2";"9";"72";"35706"
"7";"3";"4";"9";"72";"35707"
"2";"0";"2";"9";"72";"35708"
"8";"2";"6";"9";"72";"35712"
"34";"5";"29";"9";"72";"35713"
"16";"11";"5";"9";"72";"35714"
"26";"1";"25";"9";"72";"35717"
"10";"0";"10";"9";"72";"35724"
"1";"0";"1";"9";"72";"35725"
"9";"2";"7";"9";"72";"35726"
"1";"1";"0";"9";"72";"35727"
"12";"9";"3";"9";"72";"35728"
"3";"1";"2";"9";"72";"35729"
"2";"0";"2";"9";"72";"35731"
"2";"0";"2";"9";"72";"35733"
"1";"1";"0";"9";"72";"35736"
"2";"2";"0";"9";"72";"35737"
"3";"0";"3";"9";"72";"35739"
"2";"0";"2";"9";"72";"35740"
"1";"1";"0";"9";"72";"35743"
"9";"1";"8";"9";"72";"35744"
"1";"1";"0";"9";"72";"35746"
"2";"0";"2";"9";"72";"35750"
"2";"0";"2";"9";"72";"35751"
"2";"2";"0";"9";"72";"35754"
"10";"3";"7";"9";"72";"35755"
"2";"0";"2";"9";"72";"35757"
"8";"3";"5";"9";"72";"35760"
"3";"0";"3";"9";"72";"35762"
"12";"4";"8";"9";"72";"35763"
"2";"2";"0";"9";"72";"35764"
"4";"1";"3";"9";"72";"35766"
"3";"0";"3";"9";"72";"35771"
"33";"25";"8";"9";"72";"35772"
"4";"0";"4";"9";"72";"35773"
"2";"0";"2";"9";"72";"35774"
"4";"0";"4";"9";"72";"35776"
"5";"1";"4";"9";"72";"35777"
"2";"1";"1";"9";"72";"35778"
"4";"0";"4";"9";"72";"35780"
"6";"1";"5";"9";"72";"35783"
"5";"0";"5";"9";"72";"35786"
"6";"1";"5";"9";"72";"35787"
"36";"10";"26";"9";"72";"35789"
"3";"0";"3";"9";"72";"35790"
"54";"36";"18";"9";"72";"35791"
"2";"1";"1";"9";"72";"35795"
"9";"2";"7";"9";"72";"35796"
"9";"7";"2";"9";"72";"35797"
"4";"2";"2";"9";"72";"35798"
"10";"0";"10";"9";"72";"35801"
"5";"3";"2";"9";"72";"35802"
"11";"4";"7";"9";"72";"35804"
"4";"0";"4";"9";"72";"35805"
"3";"0";"3";"9";"72";"35806"
"21";"6";"15";"9";"72";"35809"
"6";"1";"5";"9";"72";"35810"
"3";"1";"2";"9";"72";"35812"
"2";"0";"2";"9";"72";"35813"
"8";"1";"7";"9";"72";"35814"
"2";"0";"2";"9";"72";"35815"
"1";"0";"1";"9";"72";"35816"
"3";"0";"3";"9";"72";"35817"
"9";"1";"8";"9";"72";"35818"
"5";"3";"2";"9";"72";"35819"
"17";"1";"16";"9";"72";"35821"
"3";"0";"3";"9";"72";"35825"
"4";"0";"4";"9";"72";"35826"
"8";"1";"7";"9";"72";"35827"
"4";"0";"4";"9";"72";"35830"
"4";"0";"4";"9";"72";"35833"
"20";"9";"11";"9";"72";"35834"
"3";"1";"2";"9";"72";"35836"
"7";"2";"5";"9";"72";"35837"
"6";"1";"5";"9";"72";"35839"
"7";"0";"7";"9";"72";"35845"
"2";"2";"0";"9";"72";"35846"
"3";"0";"3";"9";"72";"35848"
"16";"2";"14";"9";"72";"35850"
"2";"0";"2";"9";"72";"35851"
"2";"1";"1";"9";"72";"35854"
"5";"0";"5";"9";"72";"35857"
"9";"2";"7";"9";"72";"35858"
"5";"2";"3";"9";"72";"35859"
"5";"2";"3";"9";"72";"35862"
"3";"1";"2";"9";"72";"35866"
"3";"3";"0";"9";"72";"35868"
"3";"0";"3";"9";"72";"35872"
"8";"1";"7";"9";"72";"35873"
"26";"6";"20";"9";"72";"35874"
"6";"0";"6";"9";"72";"35875"
"3";"1";"2";"9";"72";"35878"
"2";"0";"2";"9";"72";"35879"
"14";"4";"10";"9";"72";"35880"
"3";"0";"3";"9";"72";"35882"
"1";"1";"0";"9";"72";"35885"
"8";"1";"7";"9";"72";"35886"
"7";"0";"7";"9";"72";"35894"
"2";"0";"2";"9";"72";"35898"
"4";"0";"4";"9";"72";"35901"
"2";"1";"1";"9";"72";"35903"
"1";"1";"0";"9";"72";"35906"
"7";"1";"6";"9";"72";"35907"
"2";"1";"1";"9";"72";"35908"
"3";"1";"2";"9";"72";"35909"
"2";"1";"1";"9";"72";"35910"
"6";"1";"5";"9";"72";"35911"
"15";"5";"10";"9";"72";"35912"
"16";"1";"15";"9";"72";"35914"
"89";"49";"40";"9";"72";"35915"
"9";"5";"4";"9";"72";"35916"
"3";"1";"2";"9";"72";"35918"
"34";"9";"25";"9";"72";"35919"
"6";"1";"5";"9";"72";"35921"
"7";"1";"6";"9";"72";"35922"
"3";"3";"0";"9";"72";"35923"
"7";"2";"5";"9";"72";"35924"
"10";"3";"7";"9";"72";"35925"
"2";"1";"1";"9";"72";"35927"
"5";"1";"4";"9";"72";"35931"
"2";"0";"2";"9";"72";"35935"
"2";"0";"2";"9";"72";"35940"
"4";"1";"3";"9";"72";"35943"
"6";"1";"5";"9";"72";"35944"
"1";"1";"0";"9";"72";"35945"
"4";"2";"2";"9";"72";"35947"
"2";"1";"1";"9";"72";"35949"
"14";"4";"10";"9";"72";"35951"
"4";"1";"3";"9";"72";"35952"
"2";"0";"2";"9";"72";"35953"
"2";"1";"1";"9";"72";"35955"
"1";"0";"1";"9";"72";"35957"
"7";"3";"4";"9";"72";"35959"
"3";"1";"2";"9";"72";"35960"
"8";"4";"4";"9";"72";"35961"
"239";"200";"39";"9";"72";"35962"
"22";"17";"5";"9";"72";"35963"
"2";"0";"2";"9";"72";"35968"
"12";"1";"11";"9";"72";"35969"
"5";"1";"4";"9";"72";"35971"
"5";"2";"3";"9";"72";"35972"
"6";"1";"5";"9";"72";"35976"
"4";"3";"1";"9";"72";"35977"
"2";"0";"2";"9";"72";"35978"
"9";"1";"8";"9";"72";"35979"
"11";"4";"7";"9";"72";"35980"
"4";"0";"4";"9";"72";"35983"
"3";"0";"3";"9";"72";"35984"
"2";"1";"1";"9";"72";"35986"
"1";"1";"0";"9";"72";"35988"
"6";"0";"6";"9";"72";"35989"
"107";"48";"59";"9";"72";"35990"
"7";"0";"7";"9";"72";"35992"
"6";"2";"4";"9";"72";"35994"
"7";"1";"6";"9";"72";"35995"
"5";"5";"0";"9";"72";"35997"
"3";"0";"3";"9";"72";"35999"
"1";"1";"0";"9";"72";"36000"
"4";"0";"4";"9";"72";"36007"
"8";"5";"3";"9";"72";"36008"
"2";"0";"2";"9";"72";"36009"
"3";"1";"2";"9";"72";"36011"
"10";"3";"7";"9";"72";"36013"
"14";"9";"5";"9";"72";"36014"
"15";"5";"10";"9";"72";"36015"
"3";"3";"0";"9";"72";"36018"
"8";"4";"4";"9";"72";"36021"
"4";"1";"3";"9";"72";"36022"
"1";"0";"1";"9";"72";"36023"
"1";"1";"0";"9";"72";"36024"
"5";"2";"3";"9";"72";"36025"
"169";"128";"41";"9";"72";"36026"
"29";"4";"25";"9";"72";"36027"
"3";"1";"2";"9";"72";"36028"
"2";"0";"2";"9";"72";"36030"
"29";"9";"20";"9";"72";"36032"
"5";"1";"4";"9";"72";"36036"
"2";"1";"1";"9";"72";"36037"
"1";"1";"0";"9";"72";"36039"
"1";"1";"0";"9";"72";"36040"
"1";"0";"1";"9";"72";"36043"
"5";"1";"4";"9";"72";"36044"
"9";"3";"6";"9";"72";"36047"
"2";"0";"2";"9";"72";"36051"
"7";"1";"6";"9";"72";"36054"
"7";"1";"6";"9";"72";"36055"
"3";"0";"3";"9";"72";"36057"
"2";"0";"2";"9";"72";"36058"
"5";"1";"4";"9";"72";"36059"
"5";"0";"5";"9";"72";"36065"
"1";"0";"1";"9";"72";"36072"
"28";"21";"7";"9";"72";"36073"
"2";"0";"2";"9";"72";"36074"
"9";"5";"4";"9";"72";"36075"
"8";"1";"7";"9";"72";"36076"
"1";"0";"1";"9";"72";"36079"
"2";"0";"2";"9";"72";"36080"
"9";"7";"2";"9";"72";"36082"
"6";"2";"4";"9";"72";"36083"
"4";"0";"4";"9";"72";"36084"
"6";"1";"5";"9";"72";"36086"
"2";"0";"2";"9";"72";"36087"
"2";"0";"2";"9";"72";"36097"
"143";"107";"36";"9";"72";"36103"
"1";"1";"0";"9";"72";"36104"
"1";"0";"1";"9";"72";"36105"
"3";"1";"2";"9";"72";"36106"
"17";"4";"13";"9";"72";"36108"
"4";"2";"2";"9";"72";"36109"
"6";"0";"6";"9";"72";"36111"
"4";"0";"4";"9";"72";"36112"
"5";"1";"4";"9";"72";"36113"
"20";"6";"14";"9";"72";"36116"
"3";"1";"2";"9";"72";"36122"
"2";"0";"2";"9";"72";"36123"
"4";"4";"0";"9";"72";"36124"
"21";"7";"14";"9";"72";"36125"
"1";"1";"0";"9";"72";"36128"
"3";"1";"2";"9";"72";"36130"
"4";"1";"3";"9";"72";"36131"
"1";"0";"1";"9";"72";"36141"
"1";"1";"0";"9";"72";"36147"
"2";"2";"0";"9";"72";"36151"
"1";"1";"0";"9";"72";"36158"
"115";"60";"55";"9";"72";"36163"
"8";"2";"6";"9";"72";"36164"
"2";"2";"0";"9";"72";"36165"
"6";"1";"5";"9";"72";"36167"
"1";"0";"1";"9";"72";"36170"
"139";"105";"34";"9";"72";"36171"
"4";"1";"3";"9";"72";"36172"
"3";"0";"3";"9";"72";"36173"
"1";"1";"0";"9";"72";"36175"
"8";"3";"5";"9";"72";"36176"
"17";"7";"10";"9";"72";"36177"
"4";"2";"2";"9";"72";"36181"
"3";"0";"3";"9";"72";"36183"
"3";"0";"3";"9";"72";"36185"
"1";"1";"0";"9";"72";"36186"
"7";"1";"6";"9";"72";"36188"
"14";"10";"4";"9";"72";"36191"
"6";"0";"6";"9";"72";"36192"
"66";"33";"33";"9";"72";"36193"
"17";"1";"16";"9";"72";"36195"
"6";"2";"4";"9";"72";"36196"
"4";"1";"3";"9";"72";"36200"
"3";"3";"0";"9";"72";"36208"
"4";"0";"4";"9";"72";"36209"
"2";"1";"1";"9";"72";"36212"
"2";"0";"2";"9";"72";"36213"
"4";"2";"2";"9";"72";"36214"
"1";"1";"0";"9";"72";"36215"
"1";"0";"1";"9";"72";"36218"
"4";"2";"2";"9";"72";"36223"
"8";"2";"6";"9";"72";"36224"
"3";"1";"2";"9";"72";"36225"
"4";"0";"4";"9";"72";"36227"
"7";"1";"6";"9";"72";"36229"
"8";"3";"5";"9";"72";"36230"
"3";"1";"2";"9";"72";"36233"
"2";"0";"2";"9";"72";"36234"
"4";"2";"2";"9";"72";"36235"
"4";"1";"3";"9";"72";"36236"
"13";"2";"11";"9";"72";"36237"
"52";"25";"27";"9";"72";"36238"
"6";"1";"5";"9";"72";"36239"
"2";"0";"2";"9";"72";"36240"
"2";"1";"1";"9";"72";"36241"
"3";"1";"2";"9";"72";"36243"
"9";"8";"1";"9";"72";"36246"
"2";"0";"2";"9";"72";"36247"
"6";"1";"5";"9";"72";"36249"
"5";"1";"4";"9";"72";"36252"
"2";"1";"1";"9";"72";"36253"
"10";"4";"6";"9";"72";"36254"
"2";"1";"1";"9";"72";"36255"
"5";"1";"4";"9";"72";"36259"
"10";"2";"8";"9";"72";"36260"
"1";"1";"0";"9";"72";"36262"
"251";"189";"62";"9";"72";"36265"
"1";"1";"0";"9";"72";"36266"
"16";"4";"12";"9";"72";"36267"
"4";"0";"4";"9";"72";"36268"
"3";"0";"3";"9";"72";"36275"
"6";"1";"5";"9";"72";"36276"
"6";"2";"4";"9";"72";"36279"
"2";"0";"2";"9";"72";"36281"
"29";"23";"6";"9";"72";"36283"
"1";"0";"1";"9";"72";"36285"
"6";"1";"5";"9";"72";"36286"
"11";"2";"9";"9";"72";"36287"
"1";"0";"1";"9";"72";"36288"
"7";"0";"7";"9";"72";"36290"
"8";"1";"7";"9";"72";"36291"
"1";"0";"1";"9";"72";"36292"
"4";"1";"3";"9";"72";"36295"
"4";"0";"4";"9";"72";"36302"
"5";"0";"5";"9";"72";"36305"
"12";"2";"10";"9";"72";"36306"
"10";"1";"9";"9";"72";"36309"
"2";"0";"2";"9";"72";"36311"
"12";"1";"11";"9";"72";"36312"
"2";"0";"2";"9";"72";"36314"
"4";"0";"4";"9";"72";"36317"
"1";"1";"0";"9";"72";"36318"
"6";"1";"5";"9";"72";"36321"
"3";"2";"1";"9";"72";"36323"
"2";"1";"1";"9";"72";"36324"
"12";"1";"11";"9";"72";"36328"
"6";"1";"5";"9";"72";"36330"
"2";"0";"2";"9";"72";"36332"
"4";"4";"0";"9";"72";"36333"
"9";"6";"3";"9";"72";"36336"
"8";"1";"7";"9";"72";"36338"
"5";"0";"5";"9";"72";"36339"
"6";"3";"3";"9";"72";"36341"
"3";"1";"2";"9";"72";"36344"
"45";"22";"23";"9";"72";"36346"
"5";"0";"5";"9";"72";"36349"
"1";"1";"0";"9";"72";"36350"
"1";"1";"0";"9";"72";"36353"
"1";"1";"0";"9";"72";"36354"
"2";"0";"2";"9";"72";"36355"
"5";"2";"3";"9";"72";"36356"
"11";"0";"11";"9";"72";"36357"
"1";"1";"0";"9";"72";"36359"
"4";"0";"4";"9";"72";"36365"
"3";"1";"2";"9";"72";"36371"
"13";"7";"6";"9";"72";"36372"
"2";"1";"1";"9";"72";"36377"
"1";"1";"0";"9";"72";"36380"
"12";"8";"4";"9";"72";"36381"
"6";"2";"4";"9";"72";"36382"
"5";"2";"3";"9";"72";"36383"
"16";"3";"13";"9";"72";"36384"
"2";"1";"1";"9";"72";"36386"
"5";"2";"3";"9";"72";"36389"
"5";"1";"4";"9";"72";"36390"
"24";"5";"19";"9";"72";"36391"
"3";"1";"2";"9";"72";"36392"
"5";"1";"4";"9";"72";"36395"
"5";"0";"5";"9";"72";"36397"
"3";"0";"3";"9";"72";"36399"
"6";"1";"5";"9";"72";"36402"
"5";"1";"4";"9";"72";"36403"
"10";"2";"8";"9";"72";"36404"
"11";"1";"10";"9";"72";"36405"
"4";"1";"3";"9";"72";"36408"
"6";"2";"4";"9";"72";"36411"
"4";"2";"2";"9";"72";"36412"
"30";"19";"11";"9";"72";"36414"
"67";"46";"21";"9";"72";"36415"
"4";"1";"3";"9";"72";"36416"
"4";"2";"2";"9";"72";"36420"
"5";"0";"5";"9";"72";"36421"
"2";"1";"1";"9";"72";"36422"
"8";"1";"7";"9";"72";"36423"
"2";"0";"2";"9";"72";"36424"
"2";"1";"1";"9";"72";"36427"
"4";"2";"2";"9";"72";"36431"
"4";"0";"4";"9";"72";"36434"
"3";"1";"2";"9";"72";"36441"
"2";"0";"2";"9";"72";"36442"
"2";"0";"2";"9";"72";"36445"
"2";"1";"1";"9";"72";"36446"
"6";"2";"4";"9";"72";"36447"
"6";"4";"2";"9";"72";"36450"
"7";"1";"6";"9";"72";"36454"
"16";"2";"14";"9";"72";"36458"
"7";"2";"5";"9";"72";"36459"
"7";"2";"5";"9";"72";"36462"
"1";"1";"0";"9";"72";"36463"
"5";"1";"4";"9";"72";"36465"
"3";"0";"3";"9";"72";"36468"
"2";"2";"0";"9";"72";"36471"
"2";"0";"2";"9";"72";"36472"
"2";"1";"1";"9";"72";"36474"
"6";"1";"5";"9";"72";"36475"
"5";"2";"3";"9";"72";"36478"
"1";"0";"1";"9";"72";"36479"
"4";"1";"3";"9";"72";"36480"
"5";"0";"5";"9";"72";"36482"
"3";"1";"2";"9";"72";"36484"
"1";"1";"0";"9";"72";"36485"
"3";"1";"2";"9";"72";"36487"
"5";"1";"4";"9";"72";"36491"
"2";"2";"0";"9";"72";"36493"
"1";"0";"1";"9";"72";"36494"
"5";"2";"3";"9";"72";"36497"
"4";"0";"4";"9";"72";"36501"
"2";"0";"2";"9";"72";"36502"
"10";"2";"8";"9";"72";"36503"
"11";"2";"9";"9";"72";"36505"
"20";"13";"7";"9";"72";"36506"
"2";"0";"2";"9";"72";"36508"
"2";"0";"2";"9";"72";"36509"
"1";"1";"0";"9";"72";"36510"
"2";"0";"2";"9";"72";"36512"
"3";"0";"3";"9";"72";"36514"
"1";"1";"0";"9";"72";"36515"
"81";"18";"63";"9";"72";"36516"
"2";"0";"2";"9";"72";"36517"
"12";"1";"11";"9";"72";"36527"
"3";"0";"3";"9";"72";"36528"
"4";"0";"4";"9";"72";"36529"
"23";"4";"19";"9";"72";"36531"
"6";"1";"5";"9";"72";"36534"
"7";"2";"5";"9";"72";"36535"
"1";"1";"0";"9";"72";"36537"
"5";"1";"4";"9";"72";"36538"
"5";"1";"4";"9";"72";"36539"
"3";"0";"3";"9";"72";"36542"
"2";"0";"2";"9";"72";"36543"
"5";"1";"4";"9";"72";"36545"
"1";"0";"1";"9";"72";"36547"
"14";"2";"12";"9";"72";"36551"
"11";"2";"9";"9";"72";"36552"
"24";"15";"9";"9";"72";"36554"
"4";"0";"4";"9";"72";"36556"
"4";"1";"3";"9";"72";"36558"
"14";"7";"7";"9";"72";"36561"
"2";"0";"2";"9";"72";"36562"
"17";"1";"16";"9";"72";"36565"
"14";"2";"12";"9";"72";"36567"
"5";"1";"4";"9";"72";"36569"
"6";"2";"4";"9";"72";"36571"
"4";"1";"3";"9";"72";"36573"
"5";"0";"5";"9";"72";"36574"
"8";"3";"5";"9";"72";"36576"
"8";"0";"8";"9";"72";"36577"
"2";"1";"1";"9";"72";"36580"
"2";"1";"1";"9";"72";"36581"
"3";"1";"2";"9";"72";"36582"
"7";"1";"6";"9";"72";"36585"
"3";"1";"2";"9";"72";"36586"
"14";"2";"12";"9";"72";"36587"
"10";"6";"4";"9";"72";"36589"
"1";"0";"1";"9";"72";"36593"
"1";"1";"0";"9";"72";"36594"
"7";"1";"6";"9";"72";"36596"
"4";"1";"3";"9";"72";"36597"
"6";"1";"5";"9";"72";"36599"
"2";"0";"2";"9";"72";"36600"
"24";"16";"8";"9";"72";"36602"
"5";"1";"4";"9";"72";"36604"
"2";"2";"0";"9";"72";"36610"
"6";"2";"4";"9";"72";"36613"
"4";"1";"3";"9";"72";"36614"
"2";"0";"2";"9";"72";"36616"
"7";"0";"7";"9";"72";"36618"
"4";"1";"3";"9";"72";"36623"
"8";"2";"6";"9";"72";"36625"
"16";"2";"14";"9";"72";"36626"
"30";"16";"14";"9";"72";"36630"
"5";"1";"4";"9";"72";"36631"
"9";"2";"7";"9";"72";"36636"
"6";"1";"5";"9";"72";"36640"
"5";"3";"2";"9";"72";"36641"
"12";"1";"11";"9";"72";"36642"
"2";"1";"1";"9";"72";"36643"
"5";"1";"4";"9";"72";"36645"
"4";"1";"3";"9";"72";"36646"
"4";"0";"4";"9";"72";"36647"
"2";"0";"2";"9";"72";"36651"
"5";"1";"4";"9";"72";"36652"
"7";"2";"5";"9";"72";"36653"
"6";"4";"2";"9";"72";"36656"
"2";"1";"1";"9";"72";"36657"
"3";"0";"3";"9";"72";"36658"
"3";"0";"3";"9";"72";"36660"
"1";"1";"0";"9";"72";"36661"
"2";"1";"1";"9";"72";"36663"
"1";"0";"1";"9";"72";"36664"
"3";"0";"3";"9";"72";"36671"
"1";"0";"1";"9";"72";"36672"
"8";"2";"6";"9";"72";"36676"
"4";"1";"3";"9";"72";"36680"
"8";"3";"5";"9";"72";"36684"
"5";"1";"4";"9";"72";"36685"
"1";"0";"1";"9";"72";"36687"
"12";"6";"6";"9";"72";"36691"
"4";"1";"3";"9";"72";"36693"
"2";"2";"0";"9";"72";"36694"
"1";"0";"1";"9";"72";"36696"
"4";"0";"4";"9";"72";"36697"
"13";"5";"8";"9";"72";"36698"
"2";"1";"1";"9";"72";"36700"
"14";"5";"9";"9";"72";"36701"
"3";"1";"2";"9";"72";"36702"
"10";"3";"7";"9";"72";"36703"
"12";"10";"2";"9";"72";"36705"
"3";"1";"2";"9";"72";"36706"
"2";"1";"1";"9";"72";"36708"
"4";"0";"4";"9";"72";"36709"
"2";"2";"0";"9";"72";"36710"
"11";"1";"10";"9";"72";"36721"
"4";"1";"3";"9";"72";"36722"
"3";"2";"1";"9";"72";"36724"
"10";"2";"8";"9";"72";"36725"
"10";"2";"8";"9";"72";"36727"
"3";"1";"2";"9";"72";"36730"
"7";"2";"5";"9";"72";"36731"
"3";"0";"3";"9";"72";"36735"
"2";"0";"2";"9";"72";"36737"
"3";"1";"2";"9";"72";"36738"
"15";"4";"11";"9";"72";"36739"
"1";"0";"1";"9";"72";"36740"
"1";"1";"0";"9";"72";"36741"
"8";"2";"6";"9";"72";"36742"
"14";"3";"11";"9";"72";"36743"
"4";"2";"2";"9";"72";"36745"
"19";"13";"6";"9";"72";"36747"
"6";"2";"4";"9";"72";"36749"
"1";"0";"1";"9";"72";"36751"
"6";"0";"6";"9";"72";"36754"
"1";"1";"0";"9";"72";"36755"
"2";"0";"2";"9";"72";"36758"
"5";"1";"4";"9";"72";"36762"
"11";"3";"8";"9";"72";"36765"
"4";"1";"3";"9";"72";"36767"
"3";"1";"2";"9";"72";"36768"
"3";"0";"3";"9";"72";"36769"
"6";"2";"4";"9";"72";"36772"
"2";"1";"1";"9";"72";"36773"
"2";"0";"2";"9";"72";"36775"
"10";"2";"8";"9";"72";"36776"
"3";"0";"3";"9";"72";"36777"
"17";"16";"1";"9";"72";"36779"
"2";"0";"2";"9";"72";"36780"
"4";"2";"2";"9";"72";"36782"
"2";"0";"2";"9";"72";"36784"
"13";"0";"13";"9";"72";"36785"
"2";"1";"1";"9";"72";"36787"
"1";"0";"1";"9";"72";"36789"
"11";"1";"10";"9";"72";"36790"
"2";"0";"2";"9";"72";"36791"
"13";"2";"11";"9";"72";"36792"
"3";"0";"3";"9";"72";"36793"
"58";"15";"43";"9";"72";"36794"
"4";"1";"3";"9";"72";"36797"
"7";"3";"4";"9";"72";"36798"
"2";"0";"2";"9";"72";"36799"
"1";"0";"1";"9";"72";"36800"
"1";"0";"1";"9";"72";"36801"
"3";"0";"3";"9";"72";"36802"
"8";"2";"6";"9";"72";"36803"
"2";"1";"1";"9";"72";"36804"
"4";"4";"0";"9";"72";"36814"
"6";"2";"4";"9";"72";"36815"
"3";"1";"2";"9";"72";"36819"
"3";"3";"0";"9";"72";"36825"
"3";"0";"3";"9";"72";"36829"
"4";"1";"3";"9";"72";"36830"
"1";"1";"0";"9";"72";"36832"
"1";"1";"0";"9";"72";"36834"
"296";"233";"63";"9";"72";"36835"
"2";"0";"2";"9";"72";"36837"
"9";"2";"7";"9";"72";"36838"
"2";"0";"2";"9";"72";"36839"
"1";"0";"1";"9";"72";"36841"
"8";"0";"8";"9";"72";"36842"
"4";"1";"3";"9";"72";"36844"
"8";"1";"7";"9";"72";"36845"
"6";"2";"4";"9";"72";"36849"
"1";"0";"1";"9";"72";"36851"
"2";"1";"1";"9";"72";"36854"
"1";"1";"0";"9";"72";"36855"
"3";"0";"3";"9";"72";"36859"
"3";"1";"2";"9";"72";"36860"
"2";"0";"2";"9";"72";"36861"
"15";"5";"10";"9";"72";"36862"
"4";"1";"3";"9";"72";"36866"
"4";"1";"3";"9";"72";"36868"
"3";"0";"3";"9";"72";"36871"
"4";"1";"3";"9";"72";"36872"
"6";"1";"5";"9";"72";"36873"
"2";"1";"1";"9";"72";"36874"
"4";"1";"3";"9";"72";"36878"
"1";"1";"0";"9";"72";"36880"
"11";"2";"9";"9";"72";"36883"
"5";"1";"4";"9";"72";"36884"
"4";"2";"2";"9";"72";"36887"
"2";"0";"2";"9";"72";"36890"
"13";"3";"10";"9";"72";"36896"
"3";"0";"3";"9";"72";"36900"
"2";"1";"1";"9";"72";"36907"
"5";"0";"5";"9";"72";"36910"
"4";"4";"0";"9";"72";"36912"
"2";"1";"1";"9";"72";"36913"
"1";"1";"0";"9";"72";"36914"
"7";"2";"5";"9";"72";"36916"
"6";"1";"5";"9";"72";"36917"
"2";"1";"1";"9";"72";"36918"
"11";"2";"9";"9";"72";"36919"
"1";"0";"1";"9";"72";"36920"
"7";"3";"4";"9";"72";"36924"
"8";"1";"7";"9";"72";"36925"
"76";"49";"27";"9";"72";"36926"
"5";"0";"5";"9";"72";"36930"
"9";"1";"8";"9";"72";"36933"
"4";"1";"3";"9";"72";"36934"
"3";"0";"3";"9";"72";"36935"
"2";"1";"1";"9";"72";"36944"
"2";"0";"2";"9";"72";"36946"
"6";"0";"6";"9";"72";"36954"
"1";"1";"0";"9";"72";"36955"
"5";"0";"5";"9";"72";"36957"
"3";"0";"3";"9";"72";"36960"
"5";"1";"4";"9";"72";"36962"
"1";"0";"1";"9";"72";"36967"
"18";"1";"17";"9";"72";"36968"
"1";"0";"1";"9";"72";"36970"
"2";"1";"1";"9";"72";"36971"
"16";"6";"10";"9";"72";"36972"
"2";"0";"2";"9";"72";"36975"
"2";"1";"1";"9";"72";"36976"
"2";"1";"1";"9";"72";"36977"
"18";"5";"13";"9";"72";"36978"
"122";"98";"24";"9";"72";"36982"
"3";"1";"2";"9";"72";"36984"
"1";"1";"0";"9";"72";"36985"
"6";"2";"4";"9";"72";"36986"
"5";"1";"4";"9";"72";"36992"
"1";"1";"0";"9";"72";"36994"
"4";"1";"3";"9";"72";"36996"
"1";"0";"1";"9";"72";"36998"
"9";"3";"6";"9";"72";"37003"
"1";"0";"1";"9";"72";"37006"
"6";"1";"5";"9";"72";"37008"
"3";"0";"3";"9";"72";"37009"
"5";"1";"4";"9";"72";"37013"
"4";"0";"4";"9";"72";"37016"
"4";"4";"0";"9";"72";"37017"
"4";"2";"2";"9";"72";"37019"
"2";"0";"2";"9";"72";"37021"
"10";"2";"8";"9";"72";"37025"
"10";"1";"9";"9";"72";"37026"
"1";"1";"0";"9";"72";"37027"
"1";"1";"0";"9";"72";"37029"
"1";"1";"0";"9";"72";"37031"
"31";"27";"4";"9";"72";"37032"
"1";"1";"0";"9";"72";"37033"
"5";"1";"4";"9";"72";"37034"
"1";"0";"1";"9";"72";"37036"
"15";"1";"14";"9";"72";"37037"
"2";"0";"2";"9";"72";"37043"
"20";"2";"18";"9";"72";"37044"
"11";"0";"11";"9";"72";"37045"
"1";"1";"0";"9";"72";"37048"
"6";"1";"5";"9";"72";"37051"
"11";"6";"5";"9";"72";"37052"
"4";"3";"1";"9";"72";"37053"
"6";"4";"2";"9";"72";"37054"
"10";"1";"9";"9";"72";"37059"
"2";"0";"2";"9";"72";"37061"
"1";"1";"0";"9";"72";"37062"
"1";"1";"0";"9";"72";"37063"
"5";"1";"4";"9";"72";"37065"
"1";"1";"0";"9";"72";"37070"
"5";"4";"1";"9";"72";"37072"
"6";"2";"4";"9";"72";"37074"
"1";"1";"0";"9";"72";"37075"
"1";"1";"0";"9";"72";"37078"
"1";"0";"1";"9";"72";"37079"
"5";"2";"3";"9";"72";"37083"
"7";"5";"2";"9";"72";"37087"
"4";"2";"2";"9";"72";"37088"
"1";"1";"0";"9";"72";"37090"
"6";"3";"3";"9";"72";"37092"
"8";"1";"7";"9";"72";"37094"
"1";"1";"0";"9";"72";"37096"
"14";"3";"11";"9";"72";"37099"
"8";"8";"0";"9";"72";"37100"
"2";"0";"2";"9";"72";"37101"
"3";"0";"3";"9";"72";"37102"
"4";"0";"4";"9";"72";"37105"
"2";"0";"2";"9";"72";"37106"
"4";"2";"2";"9";"72";"37107"
"3";"0";"3";"9";"72";"37108"
"7";"1";"6";"9";"72";"37109"
"2";"0";"2";"9";"72";"37114"
"5";"5";"0";"9";"72";"37115"
"109";"62";"47";"9";"72";"37117"
"5";"1";"4";"9";"72";"37122"
"2";"0";"2";"9";"72";"37123"
"6";"2";"4";"9";"72";"37126"
"1";"0";"1";"9";"72";"37133"
"2";"0";"2";"9";"72";"37134"
"4";"2";"2";"9";"72";"37135"
"5";"1";"4";"9";"72";"37137"
"4";"3";"1";"9";"72";"37140"
"1";"1";"0";"9";"72";"37141"
"3";"0";"3";"9";"72";"37144"
"5";"5";"0";"9";"72";"37149"
"7";"2";"5";"9";"72";"37150"
"4";"0";"4";"9";"72";"37151"
"2";"1";"1";"9";"72";"37153"
"1";"0";"1";"9";"72";"37154"
"4";"2";"2";"9";"72";"37159"
"7";"3";"4";"9";"72";"37160"
"1";"1";"0";"9";"72";"37162"
"2";"1";"1";"9";"72";"37165"
"1";"1";"0";"9";"72";"37166"
"15";"4";"11";"9";"72";"37168"
"4";"0";"4";"9";"72";"37169"
"6";"2";"4";"9";"72";"37171"
"2";"0";"2";"9";"72";"37172"
"8";"7";"1";"9";"72";"37174"
"5";"2";"3";"9";"72";"37175"
"9";"1";"8";"9";"72";"37176"
"11";"6";"5";"9";"72";"37177"
"3";"1";"2";"9";"72";"37183"
"5";"1";"4";"9";"72";"37185"
"11";"6";"5";"9";"72";"37187"
"5";"4";"1";"9";"72";"37188"
"2";"1";"1";"9";"72";"37191"
"8";"3";"5";"9";"72";"37196"
"1";"0";"1";"9";"72";"37197"
"4";"0";"4";"9";"72";"37198"
"1";"1";"0";"9";"72";"37201"
"4";"1";"3";"9";"72";"37205"
"37";"30";"7";"9";"72";"37208"
"1";"1";"0";"9";"72";"37211"
"1";"0";"1";"9";"72";"37212"
"3";"1";"2";"9";"72";"37213"
"6";"2";"4";"9";"72";"37214"
"3";"1";"2";"9";"72";"37217"
"9";"6";"3";"9";"72";"37221"
"1";"1";"0";"9";"72";"37223"
"7";"0";"7";"9";"72";"37224"
"7";"1";"6";"9";"72";"37230"
"2";"1";"1";"9";"72";"37233"
"4";"1";"3";"9";"72";"37234"
"6";"1";"5";"9";"72";"37235"
"5";"2";"3";"9";"72";"37240"
"1";"1";"0";"9";"72";"37241"
"13";"5";"8";"9";"72";"37244"
"6";"2";"4";"9";"72";"37247"
"1";"1";"0";"9";"72";"37252"
"20";"3";"17";"9";"72";"37260"
"8";"3";"5";"9";"72";"37261"
"10";"1";"9";"9";"72";"37263"
"1";"1";"0";"9";"72";"37264"
"9";"1";"8";"9";"72";"37267"
"2";"2";"0";"9";"72";"37269"
"1";"1";"0";"9";"72";"37275"
"3";"1";"2";"9";"72";"37277"
"14";"4";"10";"9";"72";"37278"
"2";"2";"0";"9";"72";"37283"
"4";"1";"3";"9";"72";"37284"
"4";"0";"4";"9";"72";"37291"
"6";"0";"6";"9";"72";"37294"
"1";"1";"0";"9";"72";"37297"
"1";"0";"1";"9";"72";"37298"
"5";"1";"4";"9";"72";"37300"
"4";"0";"4";"9";"72";"37303"
"6";"2";"4";"9";"72";"37305"
"3";"1";"2";"9";"72";"37307"
"3";"0";"3";"9";"72";"37308"
"5";"1";"4";"9";"72";"37309"
"6";"3";"3";"9";"72";"37310"
"2";"0";"2";"9";"72";"37312"
"3";"0";"3";"9";"72";"37313"
"16";"9";"7";"9";"72";"37315"
"2";"0";"2";"9";"72";"37316"
"7";"2";"5";"9";"72";"37318"
"36";"28";"8";"9";"72";"37321"
"6";"0";"6";"9";"72";"37322"
"2";"0";"2";"9";"72";"37323"
"2";"1";"1";"9";"72";"37324"
"348";"317";"31";"9";"72";"37326"
"2";"0";"2";"9";"72";"37328"
"7";"1";"6";"9";"72";"37333"
"7";"1";"6";"9";"72";"37334"
"2";"0";"2";"9";"72";"37340"
"5";"1";"4";"9";"72";"37341"
"5";"1";"4";"9";"72";"37346"
"36";"27";"9";"9";"72";"37350"
"1";"1";"0";"9";"72";"37351"
"5";"1";"4";"9";"72";"37354"
"2";"1";"1";"9";"72";"37355"
"4";"0";"4";"9";"72";"37356"
"11";"1";"10";"9";"72";"37360"
"3";"1";"2";"9";"72";"37362"
"10";"6";"4";"9";"72";"37363"
"5";"1";"4";"9";"72";"37366"
"1";"0";"1";"9";"72";"37368"
"8";"4";"4";"9";"72";"37369"
"16";"5";"11";"9";"72";"37370"
"1";"0";"1";"9";"72";"37371"
"1";"1";"0";"9";"72";"37377"
"15";"6";"9";"9";"72";"37381"
"2";"0";"2";"9";"72";"37382"
"5";"2";"3";"9";"72";"37384"
"33";"20";"13";"9";"72";"37385"
"1";"1";"0";"9";"72";"37392"
"4";"1";"3";"9";"72";"37394"
"5";"0";"5";"9";"72";"37397"
"4";"0";"4";"9";"72";"37399"
"6";"2";"4";"9";"72";"37404"
"5";"1";"4";"9";"72";"37408"
"8";"1";"7";"9";"72";"37414"
"7";"1";"6";"9";"72";"37415"
"4";"4";"0";"9";"72";"37417"
"3";"0";"3";"9";"72";"37418"
"1";"1";"0";"9";"72";"37419"
"4";"0";"4";"9";"72";"37420"
"6";"0";"6";"9";"72";"37421"
"4";"1";"3";"9";"72";"37422"
"3";"0";"3";"9";"72";"37423"
"5";"2";"3";"9";"72";"37427"
"4";"0";"4";"9";"72";"37428"
"15";"5";"10";"9";"72";"37431"
"66";"52";"14";"9";"72";"37435"
"2";"0";"2";"9";"72";"37436"
"1";"1";"0";"9";"72";"37437"
"3";"1";"2";"9";"72";"37438"
"7";"1";"6";"9";"72";"37440"
"4";"1";"3";"9";"72";"37449"
"2";"1";"1";"9";"72";"37453"
"12";"0";"12";"9";"72";"37454"
"9";"4";"5";"9";"72";"37456"
"386";"253";"133";"9";"72";"37462"
"2";"0";"2";"9";"72";"37466"
"11";"5";"6";"9";"72";"37469"
"3";"1";"2";"9";"72";"37472"
"6";"0";"6";"9";"72";"37475"
"1";"1";"0";"9";"72";"37477"
"1";"1";"0";"9";"72";"37478"
"6";"1";"5";"9";"72";"37479"
"1";"1";"0";"9";"72";"37485"
"1";"1";"0";"9";"72";"37486"
"9";"1";"8";"9";"72";"37489"
"5";"0";"5";"9";"72";"37491"
"8";"1";"7";"9";"72";"37495"
"3";"0";"3";"9";"72";"37496"
"1";"1";"0";"9";"72";"37498"
"14";"4";"10";"9";"72";"37500"
"1";"1";"0";"9";"72";"37503"
"19";"12";"7";"9";"72";"37504"
"5";"0";"5";"9";"72";"37510"
"6";"1";"5";"9";"72";"37512"
"4";"0";"4";"9";"72";"37519"
"6";"1";"5";"9";"72";"37520"
"4";"1";"3";"9";"72";"37522"
"1";"1";"0";"9";"72";"37523"
"1";"1";"0";"9";"72";"37524"
"21";"13";"8";"9";"72";"37525"
"6";"1";"5";"9";"72";"37528"
"7";"1";"6";"9";"72";"37529"
"3";"0";"3";"9";"72";"37530"
"8";"1";"7";"9";"72";"37532"
"7";"2";"5";"9";"72";"37535"
"6";"0";"6";"9";"72";"37538"
"11";"8";"3";"9";"72";"37540"
"2";"1";"1";"9";"72";"37543"
"2";"0";"2";"9";"72";"37548"
"7";"1";"6";"9";"72";"37551"
"4";"0";"4";"9";"72";"37552"
"12";"5";"7";"9";"72";"37557"
"2";"0";"2";"9";"72";"37558"
"7";"2";"5";"9";"72";"37559"
"6";"0";"6";"9";"72";"37561"
"2";"2";"0";"9";"72";"37563"
"4";"1";"3";"9";"72";"37566"
"26";"9";"17";"9";"72";"37567"
"6";"0";"6";"9";"72";"37569"
"3";"3";"0";"9";"72";"37571"
"3";"0";"3";"9";"72";"37572"
"6";"1";"5";"9";"72";"37575"
"1";"1";"0";"9";"72";"37577"
"7";"2";"5";"9";"72";"37580"
"8";"0";"8";"9";"72";"37581"
"11";"9";"2";"9";"72";"37582"
"5";"2";"3";"9";"72";"37583"
"4";"1";"3";"9";"72";"37585"
"5";"1";"4";"9";"72";"37586"
"9";"6";"3";"9";"72";"37588"
"2";"0";"2";"9";"72";"37589"
"1";"0";"1";"9";"72";"37590"
"1";"1";"0";"9";"72";"37593"
"6";"1";"5";"9";"72";"37594"
"1";"1";"0";"9";"72";"37597"
"4";"4";"0";"9";"72";"37598"
"17";"3";"14";"9";"72";"37601"
"3";"0";"3";"9";"72";"37602"
"9";"0";"9";"9";"72";"37603"
"2";"0";"2";"9";"72";"37607"
"3";"0";"3";"9";"72";"37612"
"401";"348";"53";"9";"72";"37613"
"4";"2";"2";"9";"72";"37616"
"18";"3";"15";"9";"72";"37619"
"2";"1";"1";"9";"72";"37621"
"2";"1";"1";"9";"72";"37624"
"37";"25";"12";"9";"72";"37628"
"6";"3";"3";"9";"72";"37629"
"1";"0";"1";"9";"72";"37633"
"9";"1";"8";"9";"72";"37634"
"1";"1";"0";"9";"72";"37635"
"7";"1";"6";"9";"72";"37644"
"3";"0";"3";"9";"72";"37646"
"4";"1";"3";"9";"72";"37649"
"18";"2";"16";"9";"72";"37653"
"3";"0";"3";"9";"72";"37657"
"4";"1";"3";"9";"72";"37659"
"6";"0";"6";"9";"72";"37660"
"4";"1";"3";"9";"72";"37664"
"3";"2";"1";"9";"72";"37666"
"1";"1";"0";"9";"72";"37667"
"3";"0";"3";"9";"72";"37672"
"4";"4";"0";"9";"72";"37674"
"13";"1";"12";"9";"72";"37675"
"9";"4";"5";"9";"72";"37677"
"2";"1";"1";"9";"72";"37678"
"5";"1";"4";"9";"72";"37682"
"3";"1";"2";"9";"72";"37689"
"1";"0";"1";"9";"72";"37691"
"2";"0";"2";"9";"72";"37692"
"2";"1";"1";"9";"72";"37693"
"3";"1";"2";"9";"72";"37694"
"5";"1";"4";"9";"72";"37697"
"3";"1";"2";"9";"72";"37698"
"3";"0";"3";"9";"72";"37701"
"10";"2";"8";"9";"72";"37705"
"4";"0";"4";"9";"72";"37707"
"1";"1";"0";"9";"72";"37710"
"2";"1";"1";"9";"72";"37711"
"2";"1";"1";"9";"72";"37712"
"4";"1";"3";"9";"72";"37713"
"1";"1";"0";"9";"72";"37714"
"1";"0";"1";"9";"72";"37715"
"4";"2";"2";"9";"72";"37717"
"6";"5";"1";"9";"72";"37721"
"24";"3";"21";"9";"72";"37722"
"2";"2";"0";"9";"72";"37723"
"1";"1";"0";"9";"72";"37727"
"1";"1";"0";"9";"72";"37736"
"7";"2";"5";"9";"72";"37737"
"6";"2";"4";"9";"72";"37738"
"5";"1";"4";"9";"72";"37741"
"6";"2";"4";"9";"72";"37742"
"12";"8";"4";"9";"72";"37743"
"1";"1";"0";"9";"72";"37747"
"5";"1";"4";"9";"72";"37748"
"6";"0";"6";"9";"72";"37753"
"5";"1";"4";"9";"72";"37754"
"1";"1";"0";"9";"72";"37755"
"3";"1";"2";"9";"72";"37757"
"3";"1";"2";"9";"72";"37758"
"2";"0";"2";"9";"72";"37760"
"5";"1";"4";"9";"72";"37762"
"6";"0";"6";"9";"72";"37764"
"4";"1";"3";"9";"72";"37765"
"3";"0";"3";"9";"72";"37767"
"7";"5";"2";"9";"72";"37768"
"3";"0";"3";"9";"72";"37773"
"6";"3";"3";"9";"72";"37774"
"1";"0";"1";"9";"72";"37775"
"2";"1";"1";"9";"72";"37776"
"6";"1";"5";"9";"72";"37777"
"404";"308";"96";"9";"72";"37780"
"1";"1";"0";"9";"72";"37781"
"1";"1";"0";"9";"72";"37783"
"7";"2";"5";"9";"72";"37784"
"3";"0";"3";"9";"72";"37785"
"4";"1";"3";"9";"72";"37787"
"4";"1";"3";"9";"72";"37793"
"26";"5";"21";"9";"72";"37794"
"6";"1";"5";"9";"72";"37796"
"5";"0";"5";"9";"72";"37798"
"3";"3";"0";"9";"72";"37802"
"2";"0";"2";"9";"72";"37803"
"2";"1";"1";"9";"72";"37804"
"14";"2";"12";"9";"72";"37808"
"4";"1";"3";"9";"72";"37809"
"5";"1";"4";"9";"72";"37811"
"7";"1";"6";"9";"72";"37814"
"6";"2";"4";"9";"72";"37815"
"8";"1";"7";"9";"72";"37816"
"5";"0";"5";"9";"72";"37821"
"10";"3";"7";"9";"72";"37823"
"14";"3";"11";"9";"72";"37826"
"1";"1";"0";"9";"72";"37828"
"1";"0";"1";"9";"72";"37832"
"11";"1";"10";"9";"72";"37833"
"2";"0";"2";"9";"72";"37836"
"1";"1";"0";"9";"72";"37838"
"4";"2";"2";"9";"72";"37841"
"2";"1";"1";"9";"72";"37843"
"6";"3";"3";"9";"72";"37847"
"1";"0";"1";"9";"72";"37849"
"3";"0";"3";"9";"72";"37851"
"2";"2";"0";"9";"72";"37853"
"4";"3";"1";"9";"72";"37860"
"2";"0";"2";"9";"72";"37862"
"5";"0";"5";"9";"72";"37866"
"5";"0";"5";"9";"72";"37868"
"3";"1";"2";"9";"72";"37871"
"6";"6";"0";"9";"72";"37873"
"1";"1";"0";"9";"72";"37876"
"11";"2";"9";"9";"72";"37877"
"16";"4";"12";"9";"72";"37878"
"7";"2";"5";"9";"72";"37880"
"8";"1";"7";"9";"72";"37882"
"4";"1";"3";"9";"72";"37883"
"6";"5";"1";"9";"72";"37884"
"30";"16";"14";"9";"72";"37887"
"1";"0";"1";"9";"72";"37888"
"14";"3";"11";"9";"72";"37889"
"7";"3";"4";"9";"72";"37890"
"6";"3";"3";"9";"72";"37896"
"1";"0";"1";"9";"72";"37897"
"5";"2";"3";"9";"72";"37898"
"10";"3";"7";"9";"72";"37901"
"2";"0";"2";"9";"72";"37902"
"2";"0";"2";"9";"72";"37903"
"3";"0";"3";"9";"72";"37906"
"4";"1";"3";"9";"72";"37908"
"2";"0";"2";"9";"72";"37910"
"2";"2";"0";"9";"72";"37911"
"3";"1";"2";"9";"72";"37913"
"5";"2";"3";"9";"72";"37915"
"3";"1";"2";"9";"72";"37918"
"44";"23";"21";"9";"72";"37922"
"2";"1";"1";"9";"72";"37923"
"3";"0";"3";"9";"72";"37927"
"3";"0";"3";"9";"72";"37929"
"5";"1";"4";"9";"72";"37930"
"1";"1";"0";"9";"72";"37932"
"6";"2";"4";"9";"72";"37933"
"3";"1";"2";"9";"72";"37934"
"2";"1";"1";"9";"72";"37937"
"1";"1";"0";"9";"72";"37941"
"10";"1";"9";"9";"72";"37942"
"8";"3";"5";"9";"72";"37943"
"1";"0";"1";"9";"72";"37946"
"4";"1";"3";"9";"72";"37947"
"2";"1";"1";"9";"72";"37950"
"1";"1";"0";"9";"72";"37952"
"4";"0";"4";"9";"72";"37953"
"5";"2";"3";"9";"72";"37956"
"7";"2";"5";"9";"72";"37960"
"6";"2";"4";"9";"72";"37961"
"1";"1";"0";"9";"72";"37962"
"2";"2";"0";"9";"72";"37966"
"3";"3";"0";"9";"72";"37967"
"18";"11";"7";"9";"72";"37968"
"30";"7";"23";"9";"72";"37969"
"1";"1";"0";"9";"72";"37971"
"2";"1";"1";"9";"72";"37972"
"1";"1";"0";"9";"72";"37974"
"2";"2";"0";"9";"72";"37977"
"5";"0";"5";"9";"72";"37980"
"2";"0";"2";"9";"72";"37984"
"8";"2";"6";"9";"72";"37986"
"4";"1";"3";"9";"72";"37989"
"3";"1";"2";"9";"72";"37990"
"1";"1";"0";"9";"72";"37992"
"2";"2";"0";"9";"72";"37998"
"1";"1";"0";"9";"72";"37999"
"1";"1";"0";"9";"72";"38007"
"2";"2";"0";"9";"72";"38010"
"4";"1";"3";"9";"72";"38014"
"1";"1";"0";"9";"72";"38017"
"5";"2";"3";"9";"72";"38021"
"1";"0";"1";"9";"72";"38023"
"1";"1";"0";"9";"72";"38025"
"3";"0";"3";"9";"72";"38029"
"1";"1";"0";"9";"72";"38032"
"1";"1";"0";"9";"72";"38033"
"15";"5";"10";"9";"72";"38038"
"5";"0";"5";"9";"72";"38039"
"2";"1";"1";"9";"72";"38040"
"8";"3";"5";"9";"72";"38041"
"3";"0";"3";"9";"72";"38044"
"5";"0";"5";"9";"72";"38047"
"1";"1";"0";"9";"72";"38050"
"12";"0";"12";"9";"72";"38058"
"1";"1";"0";"9";"72";"38059"
"44";"16";"28";"9";"72";"38062"
"2";"0";"2";"9";"72";"38067"
"5";"2";"3";"9";"72";"38068"
"57";"24";"33";"9";"72";"38069"
"1";"1";"0";"9";"72";"38074"
"2";"1";"1";"9";"72";"38075"
"2";"0";"2";"9";"72";"38080"
"6";"2";"4";"9";"72";"38083"
"4";"1";"3";"9";"72";"38087"
"4";"2";"2";"9";"72";"38093"
"3";"0";"3";"9";"72";"38095"
"2";"1";"1";"9";"72";"38097"
"2";"0";"2";"9";"72";"38102"
"2";"1";"1";"9";"72";"38104"
"11";"1";"10";"9";"72";"38105"
"2";"1";"1";"9";"72";"38106"
"1";"0";"1";"9";"72";"38108"
"12";"3";"9";"9";"72";"38109"
"2";"0";"2";"9";"72";"38110"
"5";"1";"4";"9";"72";"38113"
"6";"2";"4";"9";"72";"38115"
"2";"2";"0";"9";"72";"38119"
"2";"1";"1";"9";"72";"38122"
"3";"1";"2";"9";"72";"38128"
"5";"1";"4";"9";"72";"38134"
"1";"0";"1";"9";"72";"38136"
"1";"1";"0";"9";"72";"38138"
"4";"2";"2";"9";"72";"38139"
"1";"1";"0";"9";"72";"38140"
"5";"1";"4";"9";"72";"38143"
"1";"0";"1";"9";"72";"38144"
"1";"0";"1";"9";"72";"38147"
"1";"1";"0";"9";"72";"38148"
"3";"0";"3";"9";"72";"38149"
"5";"1";"4";"9";"72";"38154"
"6";"1";"5";"9";"72";"38155"
"1";"0";"1";"9";"72";"38157"
"12";"3";"9";"9";"72";"38164"
"5";"1";"4";"9";"72";"38168"
"6";"1";"5";"9";"72";"38169"
"3";"0";"3";"9";"72";"38170"
"18";"11";"7";"9";"72";"38171"
"1";"1";"0";"9";"72";"38172"
"1";"1";"0";"9";"72";"38173"
"4";"1";"3";"9";"72";"38175"
"2";"0";"2";"9";"72";"38177"
"22";"15";"7";"9";"72";"38182"
"7";"1";"6";"9";"72";"38185"
"6";"1";"5";"9";"72";"38187"
"3";"1";"2";"9";"72";"38188"
"4";"4";"0";"9";"72";"38189"
"16";"8";"8";"9";"72";"38192"
"4";"1";"3";"9";"72";"38194"
"9";"2";"7";"9";"72";"38198"
"6";"3";"3";"9";"72";"38200"
"2";"0";"2";"9";"72";"38204"
"21";"6";"15";"9";"72";"38205"
"12";"1";"11";"9";"72";"38209"
"42";"3";"39";"9";"72";"38212"
"53";"5";"48";"9";"72";"38213"
"1";"0";"1";"9";"72";"38216"
"1";"1";"0";"9";"72";"38217"
"3";"1";"2";"9";"72";"38218"
"4";"1";"3";"9";"72";"38219"
"30";"10";"20";"9";"72";"38220"
"1";"1";"0";"9";"72";"38222"
"3";"0";"3";"9";"72";"38225"
"1";"0";"1";"9";"72";"38231"
"3";"1";"2";"9";"72";"38232"
"1";"0";"1";"9";"72";"38234"
"2";"2";"0";"9";"72";"38236"
"6";"1";"5";"9";"72";"38238"
"7";"2";"5";"9";"72";"38240"
"7";"3";"4";"9";"72";"38241"
"4";"3";"1";"9";"72";"38242"
"4";"0";"4";"9";"72";"38243"
"5";"0";"5";"9";"72";"38244"
"4";"0";"4";"9";"72";"38245"
"4";"0";"4";"9";"72";"38246"
"5";"0";"5";"9";"72";"38247"
"29";"11";"18";"9";"72";"38248"
"15";"2";"13";"9";"72";"38249"
"2";"1";"1";"9";"72";"38250"
"3";"3";"0";"9";"72";"38251"
"27";"0";"27";"9";"72";"38252"
"4";"1";"3";"9";"72";"38256"
"7";"3";"4";"9";"72";"38258"
"5";"1";"4";"9";"72";"38259"
"13";"7";"6";"9";"72";"38260"
"9";"0";"9";"9";"72";"38261"
"1";"0";"1";"9";"72";"38262"
"22";"12";"10";"9";"72";"38263"
"3";"1";"2";"9";"72";"38264"
"5";"0";"5";"9";"72";"38266"
"18";"11";"7";"9";"72";"38267"
"6";"0";"6";"9";"72";"38268"
"1";"1";"0";"9";"72";"38269"
"17";"1";"16";"9";"72";"38272"
"5";"1";"4";"9";"72";"38273"
"3";"0";"3";"9";"72";"38277"
"7";"4";"3";"9";"72";"38278"
"10";"1";"9";"9";"72";"38279"
"8";"2";"6";"9";"72";"38280"
"2";"1";"1";"9";"72";"38281"
"1";"1";"0";"9";"72";"38282"
"2";"1";"1";"9";"72";"38283"
"1";"1";"0";"9";"72";"38284"
"3";"1";"2";"9";"72";"38286"
"1";"0";"1";"9";"72";"38288"
"3";"1";"2";"9";"72";"38289"
"34";"10";"24";"9";"72";"38290"
"5";"1";"4";"9";"72";"38296"
"1";"1";"0";"9";"72";"38298"
"3";"1";"2";"9";"72";"38301"
"1";"0";"1";"9";"72";"38304"
"2";"1";"1";"9";"72";"38307"
"4";"0";"4";"9";"72";"38308"
"6";"1";"5";"9";"72";"38309"
"5";"1";"4";"9";"72";"38314"
"3";"1";"2";"9";"72";"38316"
"4";"1";"3";"9";"72";"38321"
"12";"4";"8";"9";"72";"38322"
"2";"0";"2";"9";"72";"38324"
"4";"0";"4";"9";"72";"38325"
"6";"1";"5";"9";"72";"38326"
"6";"4";"2";"9";"72";"38327"
"8";"2";"6";"9";"72";"38328"
"11";"1";"10";"9";"72";"38331"
"1";"0";"1";"9";"72";"38332"
"2";"2";"0";"9";"72";"38335"
"5";"2";"3";"9";"72";"38337"
"8";"1";"7";"9";"72";"38338"
"15";"3";"12";"9";"72";"38339"
"4";"2";"2";"9";"72";"38343"
"5";"2";"3";"9";"72";"38345"
"1";"0";"1";"9";"72";"38347"
"5";"0";"5";"9";"72";"38352"
"78";"54";"24";"9";"72";"38353"
"1";"0";"1";"9";"72";"38358"
"6";"1";"5";"9";"72";"38359"
"1";"1";"0";"9";"72";"38361"
"21";"2";"19";"9";"72";"38363"
"7";"3";"4";"9";"72";"38365"
"1";"0";"1";"9";"72";"38370"
"6";"0";"6";"9";"72";"38372"
"4";"1";"3";"9";"72";"38373"
"5";"1";"4";"9";"72";"38374"
"2";"0";"2";"9";"72";"38376"
"1";"0";"1";"9";"72";"38378"
"3";"1";"2";"9";"72";"38381"
"5";"2";"3";"9";"72";"38385"
"2";"0";"2";"9";"72";"38387"
"2";"0";"2";"9";"72";"38388"
"1";"0";"1";"9";"72";"38391"
"5";"1";"4";"9";"72";"38394"
"1";"1";"0";"9";"72";"38395"
"2";"0";"2";"9";"72";"38400"
"5";"1";"4";"9";"72";"38402"
"1";"1";"0";"9";"72";"38405"
"1";"1";"0";"9";"72";"38412"
"5";"0";"5";"9";"72";"38416"
"6";"2";"4";"9";"72";"38420"
"31";"7";"24";"9";"72";"38421"
"3";"0";"3";"9";"72";"38427"
"1";"1";"0";"9";"72";"38433"
"5";"0";"5";"9";"72";"38436"
"5";"1";"4";"9";"72";"38438"
"4";"2";"2";"9";"72";"38439"
"4";"1";"3";"9";"72";"38440"
"1";"1";"0";"9";"72";"38441"
"8";"2";"6";"9";"72";"38444"
"5";"5";"0";"9";"72";"38448"
"1";"1";"0";"9";"72";"38451"
"2";"1";"1";"9";"72";"38453"
"1";"1";"0";"9";"72";"38454"
"1";"0";"1";"9";"72";"38455"
"9";"0";"9";"9";"72";"38460"
"4";"2";"2";"9";"72";"38463"
"4";"1";"3";"9";"72";"38464"
"2";"1";"1";"9";"72";"38467"
"2";"1";"1";"9";"72";"38468"
"17";"2";"15";"9";"72";"38469"
"1";"0";"1";"9";"72";"38471"
"8";"1";"7";"9";"72";"38474"
"4";"2";"2";"9";"72";"38476"
"4";"0";"4";"9";"72";"38482"
"5";"1";"4";"9";"72";"38485"
"1";"0";"1";"9";"72";"38486"
"15";"4";"11";"9";"72";"38488"
"9";"1";"8";"9";"72";"38491"
"9";"6";"3";"9";"72";"38493"
"11";"1";"10";"9";"72";"38499"
"6";"2";"4";"9";"72";"38500"
"5";"1";"4";"9";"72";"38501"
"4";"0";"4";"9";"72";"38505"
"2";"0";"2";"9";"72";"38506"
"4";"1";"3";"9";"72";"38510"
"5";"1";"4";"9";"72";"38513"
"2";"2";"0";"9";"72";"38515"
"1";"0";"1";"9";"72";"38516"
"1";"1";"0";"9";"72";"38518"
"4";"0";"4";"9";"72";"38520"
"4";"3";"1";"9";"72";"38522"
"18";"5";"13";"9";"72";"38523"
"3";"1";"2";"9";"72";"38526"
"4";"0";"4";"9";"72";"38527"
"2";"1";"1";"9";"72";"38531"
"1";"1";"0";"9";"72";"38537"
"2";"1";"1";"9";"72";"38538"
"13";"3";"10";"9";"72";"38539"
"104";"75";"29";"9";"72";"38540"
"3";"1";"2";"9";"72";"38542"
"4";"1";"3";"9";"72";"38545"
"6";"3";"3";"9";"72";"38546"
"1";"1";"0";"9";"72";"38547"
"4";"2";"2";"9";"72";"38551"
"1";"1";"0";"9";"72";"38552"
"5";"1";"4";"9";"72";"38553"
"6";"3";"3";"9";"72";"38556"
"23";"7";"16";"9";"72";"38558"
"1";"0";"1";"9";"72";"38559"
"3";"1";"2";"9";"72";"38560"
"1";"0";"1";"9";"72";"38562"
"3";"1";"2";"9";"72";"38569"
"4";"1";"3";"9";"72";"38571"
"34";"13";"21";"9";"72";"38574"
"64";"44";"20";"9";"72";"38575"
"37";"22";"15";"9";"72";"38580"
"1";"1";"0";"9";"72";"38587"
"8";"1";"7";"9";"72";"38589"
"2";"1";"1";"9";"72";"38593"
"16";"4";"12";"9";"72";"38595"
"2";"1";"1";"9";"72";"38597"
"13";"1";"12";"9";"72";"38599"
"4";"1";"3";"9";"72";"38601"
"10";"1";"9";"9";"72";"38608"
"2";"0";"2";"9";"72";"38609"
"1";"1";"0";"9";"72";"38613"
"12";"12";"0";"9";"72";"38616"
"4";"4";"0";"9";"72";"38617"
"1";"0";"1";"9";"72";"38618"
"7";"2";"5";"9";"72";"38620"
"8";"4";"4";"9";"72";"38623"
"3";"1";"2";"9";"72";"38629"
"4";"4";"0";"9";"72";"38630"
"4";"1";"3";"9";"72";"38632"
"4";"0";"4";"9";"72";"38635"
"1";"1";"0";"9";"72";"38636"
"1";"0";"1";"9";"72";"38637"
"3";"2";"1";"9";"72";"38638"
"2";"1";"1";"9";"72";"38643"
"6";"1";"5";"9";"72";"38648"
"5";"0";"5";"9";"72";"38649"
"4";"1";"3";"9";"72";"38650"
"2";"1";"1";"9";"72";"38652"
"1";"1";"0";"9";"72";"38653"
"2";"0";"2";"9";"72";"38655"
"5";"5";"0";"9";"72";"38659"
"6";"3";"3";"9";"72";"38662"
"1";"1";"0";"9";"72";"38663"
"2";"1";"1";"9";"72";"38664"
"2";"0";"2";"9";"72";"38666"
"1";"1";"0";"9";"72";"38668"
"1";"0";"1";"9";"72";"38670"
"1";"0";"1";"9";"72";"38672"
"1";"0";"1";"9";"72";"38673"
"6";"1";"5";"9";"72";"38674"
"5";"2";"3";"9";"72";"38678"
"8";"1";"7";"9";"72";"38682"
"6";"1";"5";"9";"72";"38684"
"1";"0";"1";"9";"72";"38685"
"7";"0";"7";"9";"72";"38687"
"4";"0";"4";"9";"72";"38688"
"8";"1";"7";"9";"72";"38689"
"6";"2";"4";"9";"72";"38691"
"2";"1";"1";"9";"72";"38697"
"3";"1";"2";"9";"72";"38703"
"7";"1";"6";"9";"72";"38704"
"67";"7";"60";"9";"72";"38706"
"7";"3";"4";"9";"72";"38710"
"2";"0";"2";"9";"72";"38712"
"3";"0";"3";"9";"72";"38713"
"3";"0";"3";"9";"72";"38719"
"5";"1";"4";"9";"72";"38720"
"5";"3";"2";"9";"72";"38721"
"8";"0";"8";"9";"72";"38724"
"399";"316";"83";"9";"72";"38725"
"2";"0";"2";"9";"72";"38727"
"1";"1";"0";"9";"72";"38730"
"1";"1";"0";"9";"72";"38731"
"5";"0";"5";"9";"72";"38732"
"1";"1";"0";"9";"72";"38733"
"1";"1";"0";"9";"72";"38735"
"1";"1";"0";"9";"72";"38736"
"8";"6";"2";"9";"72";"38739"
"4";"2";"2";"9";"72";"38740"
"2";"1";"1";"9";"72";"38742"
"2";"1";"1";"9";"72";"38745"
"3";"1";"2";"9";"72";"38746"
"19";"4";"15";"9";"72";"38747"
"7";"2";"5";"9";"72";"38748"
"2";"0";"2";"9";"72";"38749"
"5";"1";"4";"9";"72";"38750"
"1";"0";"1";"9";"72";"38752"
"4";"0";"4";"9";"72";"38753"
"3";"1";"2";"9";"72";"38754"
"1";"1";"0";"9";"72";"38757"
"6";"2";"4";"9";"72";"38761"
"4";"1";"3";"9";"72";"38765"
"4";"4";"0";"9";"72";"38766"
"2";"0";"2";"9";"72";"38767"
"7";"4";"3";"9";"72";"38769"
"10";"2";"8";"9";"72";"38770"
"42";"21";"21";"9";"72";"38771"
"2";"2";"0";"9";"72";"38772"
"1";"0";"1";"9";"72";"38774"
"4";"1";"3";"9";"72";"38777"
"14";"1";"13";"9";"72";"38779"
"1";"1";"0";"9";"72";"38781"
"3";"0";"3";"9";"72";"38783"
"4";"1";"3";"9";"72";"38784"
"1";"1";"0";"9";"72";"38786"
"3";"0";"3";"9";"72";"38787"
"2";"2";"0";"9";"72";"38791"
"2";"1";"1";"9";"72";"38792"
"2";"0";"2";"9";"72";"38796"
"5";"1";"4";"9";"72";"38797"
"26";"17";"9";"9";"72";"38800"
"5";"0";"5";"9";"72";"38801"
"3";"0";"3";"9";"72";"38802"
"2";"1";"1";"9";"72";"38811"
"4";"1";"3";"9";"72";"38815"
"2";"0";"2";"9";"72";"38816"
"1";"0";"1";"9";"72";"38819"
"1";"0";"1";"9";"72";"38821"
"5";"1";"4";"9";"72";"38826"
"8";"1";"7";"9";"72";"38827"
"3";"0";"3";"9";"72";"38829"
"1";"1";"0";"9";"72";"38838"
"1";"1";"0";"9";"72";"38839"
"1";"1";"0";"9";"72";"38840"
"1";"1";"0";"9";"72";"38843"
"9";"4";"5";"9";"72";"38846"
"4";"0";"4";"9";"72";"38847"
"5";"1";"4";"9";"72";"38848"
"2";"1";"1";"9";"72";"38849"
"1";"1";"0";"9";"72";"38850"
"4";"2";"2";"9";"72";"38851"
"3";"1";"2";"9";"72";"38852"
"1";"1";"0";"9";"72";"38853"
"4";"0";"4";"9";"72";"38854"
"4";"2";"2";"9";"72";"38856"
"200";"148";"52";"9";"72";"38858"
"1";"0";"1";"9";"72";"38860"
"1";"0";"1";"9";"72";"38862"
"9";"2";"7";"9";"72";"38864"
"1";"1";"0";"9";"72";"38872"
"1";"1";"0";"9";"72";"38874"
"1";"0";"1";"9";"72";"38876"
"6";"1";"5";"9";"72";"38878"
"29";"6";"23";"9";"72";"38879"
"5";"1";"4";"9";"72";"38880"
"10";"4";"6";"9";"72";"38881"
"3";"1";"2";"9";"72";"38882"
"1";"0";"1";"9";"72";"38884"
"3";"0";"3";"9";"72";"38887"
"2";"0";"2";"9";"72";"38890"
"1";"0";"1";"9";"72";"38892"
"5";"2";"3";"9";"72";"38893"
"2";"1";"1";"9";"72";"38895"
"3";"1";"2";"9";"72";"38896"
"1";"0";"1";"9";"72";"38898"
"5";"1";"4";"9";"72";"38902"
"1";"0";"1";"9";"72";"38903"
"3";"0";"3";"9";"72";"38906"
"3";"1";"2";"9";"72";"38907"
"2";"0";"2";"9";"72";"38908"
"3";"0";"3";"9";"72";"38909"
"2";"1";"1";"9";"72";"38910"
"1";"0";"1";"9";"72";"38911"
"5";"1";"4";"9";"72";"38912"
"3";"0";"3";"9";"72";"38914"
"8";"2";"6";"9";"72";"38915"
"1";"0";"1";"9";"72";"38918"
"6";"0";"6";"9";"72";"38920"
"1";"1";"0";"9";"72";"38921"
"5";"2";"3";"9";"72";"38922"
"2";"1";"1";"9";"72";"38923"
"2";"0";"2";"9";"72";"38927"
"3";"0";"3";"9";"72";"38929"
"2";"0";"2";"9";"72";"38930"
"5";"2";"3";"9";"72";"38931"
"2";"1";"1";"9";"72";"38933"
"1";"0";"1";"9";"72";"38934"
"1";"0";"1";"9";"72";"38935"
"2";"1";"1";"9";"72";"38940"
"8";"0";"8";"9";"72";"38942"
"6";"3";"3";"9";"72";"38943"
"4";"2";"2";"9";"72";"38944"
"2";"1";"1";"9";"72";"38945"
"2";"1";"1";"9";"72";"38946"
"1";"1";"0";"9";"72";"38954"
"3";"0";"3";"9";"72";"38956"
"5";"0";"5";"9";"72";"38957"
"12";"5";"7";"9";"72";"38959"
"2";"1";"1";"9";"72";"38961"
"5";"2";"3";"9";"72";"38963"
"2";"0";"2";"9";"72";"38966"
"16";"4";"12";"9";"72";"38967"
"1";"0";"1";"9";"72";"38968"
"13";"5";"8";"9";"72";"38969"
"6";"0";"6";"9";"72";"38971"
"1";"0";"1";"9";"72";"38972"
"20";"4";"16";"9";"72";"38974"
"95";"72";"23";"9";"72";"38976"
"4";"3";"1";"9";"72";"38981"
"8";"2";"6";"9";"72";"38983"
"2";"0";"2";"9";"72";"38989"
"1";"0";"1";"9";"72";"38991"
"1";"1";"0";"9";"72";"38992"
"22";"14";"8";"9";"72";"38993"
"1";"1";"0";"9";"72";"38994"
"4";"1";"3";"9";"72";"38995"
"3";"0";"3";"9";"72";"38997"
"1";"1";"0";"9";"72";"38998"
"1";"0";"1";"9";"72";"39000"
"2";"2";"0";"9";"72";"39003"
"2";"0";"2";"9";"72";"39004"
"149";"122";"27";"9";"72";"39006"
"9";"3";"6";"9";"72";"39007"
"5";"0";"5";"9";"72";"39008"
"2";"2";"0";"9";"72";"39011"
"6";"1";"5";"9";"72";"39015"
"1";"1";"0";"9";"72";"39017"
"16";"4";"12";"9";"72";"39020"
"4";"0";"4";"9";"72";"39021"
"4";"1";"3";"9";"72";"39024"
"116";"79";"37";"9";"72";"39026"
"1";"0";"1";"9";"72";"39027"
"6";"0";"6";"9";"72";"39028"
"1";"1";"0";"9";"72";"39031"
"2";"2";"0";"9";"72";"39032"
"4";"1";"3";"9";"72";"39036"
"65";"33";"32";"9";"72";"39038"
"5";"2";"3";"9";"72";"39039"
"6";"0";"6";"9";"72";"39041"
"2";"0";"2";"9";"72";"39045"
"5";"0";"5";"9";"72";"39046"
"5";"1";"4";"9";"72";"39048"
"129";"87";"42";"9";"72";"39050"
"1";"1";"0";"9";"72";"39051"
"1";"0";"1";"9";"72";"39052"
"2";"0";"2";"9";"72";"39054"
"2";"0";"2";"9";"72";"39056"
"27";"4";"23";"9";"72";"39057"
"8";"3";"5";"9";"72";"39063"
"7";"3";"4";"9";"72";"39064"
"2";"0";"2";"9";"72";"39066"
"9";"2";"7";"9";"72";"39067"
"6";"2";"4";"9";"72";"39071"
"6";"3";"3";"9";"72";"39074"
"1";"1";"0";"9";"72";"39075"
"3";"0";"3";"9";"72";"39076"
"1";"1";"0";"9";"72";"39077"
"1";"0";"1";"9";"72";"39079"
"20";"16";"4";"9";"72";"39081"
"1";"0";"1";"9";"72";"39087"
"2";"1";"1";"9";"72";"39091"
"6";"2";"4";"9";"72";"39093"
"1";"1";"0";"9";"72";"39094"
"6";"1";"5";"9";"72";"39097"
"1";"1";"0";"9";"72";"39098"
"3";"0";"3";"9";"72";"39101"
"15";"8";"7";"9";"72";"39103"
"6";"2";"4";"9";"72";"39106"
"1";"0";"1";"9";"72";"39108"
"2";"0";"2";"9";"72";"39109"
"1";"0";"1";"9";"72";"39111"
"9";"2";"7";"9";"72";"39115"
"36";"23";"13";"9";"72";"39118"
"1";"1";"0";"9";"72";"39119"
"3";"0";"3";"9";"72";"39121"
"7";"2";"5";"9";"72";"39123"
"7";"0";"7";"9";"72";"39124"
"3";"0";"3";"9";"72";"39125"
"1";"1";"0";"9";"72";"39127"
"2";"0";"2";"9";"72";"39133"
"7";"2";"5";"9";"72";"39134"
"6";"1";"5";"9";"72";"39135"
"7";"1";"6";"9";"72";"39137"
"3";"0";"3";"9";"72";"39139"
"3";"3";"0";"9";"72";"39143"
"78";"61";"17";"9";"72";"39144"
"5";"1";"4";"9";"72";"39145"
"4";"2";"2";"9";"72";"39146"
"11";"2";"9";"9";"72";"39148"
"1";"0";"1";"9";"72";"39149"
"7";"1";"6";"9";"72";"39152"
"16";"2";"14";"9";"72";"39153"
"2";"1";"1";"9";"72";"39154"
"8";"2";"6";"9";"72";"39155"
"3";"1";"2";"9";"72";"39156"
"7";"2";"5";"9";"72";"39157"
"1";"0";"1";"9";"72";"39160"
"2";"1";"1";"9";"72";"39163"
"34";"23";"11";"9";"72";"39165"
"2";"0";"2";"9";"72";"39170"
"1";"0";"1";"9";"72";"39171"
"6";"0";"6";"9";"72";"39172"
"21";"7";"14";"9";"72";"39173"
"4";"1";"3";"9";"72";"39176"
"1";"0";"1";"9";"72";"39177"
"2";"0";"2";"9";"72";"39181"
"1";"1";"0";"9";"72";"39183"
"2";"0";"2";"9";"72";"39187"
"3";"1";"2";"9";"72";"39191"
"3";"2";"1";"9";"72";"39195"
"3";"0";"3";"9";"72";"39197"
"2";"2";"0";"9";"72";"39198"
"6";"2";"4";"9";"72";"39199"
"4";"3";"1";"9";"72";"39202"
"4";"2";"2";"9";"72";"39204"
"9";"4";"5";"9";"72";"39205"
"10";"3";"7";"9";"72";"39209"
"4";"1";"3";"9";"72";"39210"
"3";"0";"3";"9";"72";"39213"
"1";"1";"0";"9";"72";"39216"
"8";"5";"3";"9";"72";"39217"
"4";"2";"2";"9";"72";"39218"
"10";"5";"5";"9";"72";"39219"
"8";"1";"7";"9";"72";"39222"
"1";"0";"1";"9";"72";"39223"
"1";"0";"1";"9";"72";"39224"
"11";"4";"7";"9";"72";"39226"
"4";"2";"2";"9";"72";"39230"
"1";"0";"1";"9";"72";"39235"
"15";"8";"7";"9";"72";"39236"
"1";"1";"0";"9";"72";"39237"
"1";"0";"1";"9";"72";"39240"
"5";"2";"3";"9";"72";"39244"
"4";"0";"4";"9";"72";"39245"
"2";"1";"1";"9";"72";"39247"
"3";"3";"0";"9";"72";"39249"
"4";"2";"2";"9";"72";"39251"
"1";"1";"0";"9";"72";"39253"
"2";"1";"1";"9";"72";"39255"
"6";"0";"6";"9";"72";"39256"
"8";"2";"6";"9";"72";"39259"
"30";"5";"25";"9";"72";"39261"
"2";"1";"1";"9";"72";"39263"
"4";"0";"4";"9";"72";"39267"
"25";"10";"15";"9";"72";"39269"
"11";"3";"8";"9";"72";"39270"
"4";"2";"2";"9";"72";"39274"
"1";"0";"1";"9";"72";"39275"
"7";"3";"4";"9";"72";"39278"
"59";"39";"20";"9";"72";"39282"
"3";"1";"2";"9";"72";"39283"
"2";"2";"0";"9";"72";"39284"
"2";"1";"1";"9";"72";"39285"
"3";"0";"3";"9";"72";"39287"
"5";"1";"4";"9";"72";"39293"
"2";"0";"2";"9";"72";"39294"
"3";"0";"3";"9";"72";"39296"
"11";"4";"7";"9";"72";"39299"
"5";"2";"3";"9";"72";"39300"
"2";"0";"2";"9";"72";"39302"
"2";"1";"1";"9";"72";"39303"
"3";"1";"2";"9";"72";"39304"
"2";"0";"2";"9";"72";"39305"
"3";"1";"2";"9";"72";"39306"
"1";"0";"1";"9";"72";"39307"
"5";"2";"3";"9";"72";"39308"
"14";"7";"7";"9";"72";"39310"
"1";"1";"0";"9";"72";"39312"
"1";"0";"1";"9";"72";"39313"
"1";"0";"1";"9";"72";"39315"
"1";"1";"0";"9";"72";"39317"
"42";"28";"14";"9";"72";"39318"
"8";"2";"6";"9";"72";"39319"
"18";"11";"7";"9";"72";"39320"
"4";"1";"3";"9";"72";"39326"
"2";"1";"1";"9";"72";"39328"
"3";"1";"2";"9";"72";"39330"
"5";"1";"4";"9";"72";"39332"
"5";"3";"2";"9";"72";"39333"
"5";"1";"4";"9";"72";"39335"
"5";"1";"4";"9";"72";"39337"
"5";"2";"3";"9";"72";"39340"
"1";"1";"0";"9";"72";"39342"
"7";"3";"4";"9";"72";"39343"
"5";"1";"4";"9";"72";"39346"
"6";"1";"5";"9";"72";"39347"
"4";"1";"3";"9";"72";"39348"
"1";"0";"1";"9";"72";"39349"
"3";"1";"2";"9";"72";"39350"
"1";"1";"0";"9";"72";"39351"
"10";"3";"7";"9";"72";"39352"
"2";"0";"2";"9";"72";"39353"
"1";"0";"1";"9";"72";"39354"
"2";"0";"2";"9";"72";"39356"
"1";"1";"0";"9";"72";"39359"
"3";"1";"2";"9";"72";"39367"
"3";"1";"2";"9";"72";"39369"
"6";"1";"5";"9";"72";"39370"
"2";"1";"1";"9";"72";"39372"
"2";"0";"2";"9";"72";"39375"
"1";"1";"0";"9";"72";"39376"
"6";"1";"5";"9";"72";"39377"
"3";"1";"2";"9";"72";"39380"
"1";"1";"0";"9";"72";"39381"
"3";"2";"1";"9";"72";"39382"
"1";"0";"1";"9";"72";"39386"
"2";"0";"2";"9";"72";"39389"
"3";"0";"3";"9";"72";"39390"
"15";"1";"14";"9";"72";"39391"
"7";"0";"7";"9";"72";"39392"
"28";"17";"11";"9";"72";"39394"
"4";"2";"2";"9";"72";"39402"
"4";"1";"3";"9";"72";"39403"
"1";"1";"0";"9";"72";"39405"
"1";"1";"0";"9";"72";"39410"
"3";"0";"3";"9";"72";"39413"
"4";"0";"4";"9";"72";"39414"
"5";"2";"3";"9";"72";"39415"
"3";"1";"2";"9";"72";"39416"
"1";"0";"1";"9";"72";"39418"
"11";"3";"8";"9";"72";"39426"
"10";"4";"6";"9";"72";"39434"
"2";"2";"0";"9";"72";"39439"
"4";"1";"3";"9";"72";"39442"
"1";"0";"1";"9";"72";"39444"
"10";"0";"10";"9";"72";"39448"
"3";"0";"3";"9";"72";"39449"
"5";"0";"5";"9";"72";"39452"
"1";"0";"1";"9";"72";"39453"
"2";"1";"1";"9";"72";"39454"
"2";"1";"1";"9";"72";"39455"
"2";"1";"1";"9";"72";"39456"
"2";"1";"1";"9";"72";"39462"
"2";"0";"2";"9";"72";"39464"
"9";"1";"8";"9";"72";"39465"
"5";"1";"4";"9";"72";"39466"
"4";"4";"0";"9";"72";"39467"
"11";"8";"3";"9";"72";"39472"
"1";"0";"1";"9";"72";"39474"
"1";"1";"0";"9";"72";"39478"
"1";"1";"0";"9";"72";"39479"
"7";"3";"4";"9";"72";"39482"
"6";"1";"5";"9";"72";"39486"
"1";"0";"1";"9";"72";"39489"
"2";"1";"1";"9";"72";"39492"
"3";"2";"1";"9";"72";"39495"
"2";"1";"1";"9";"72";"39497"
"1";"0";"1";"9";"72";"39499"
"1";"0";"1";"9";"72";"39500"
"2";"1";"1";"9";"72";"39505"
"4";"2";"2";"9";"72";"39507"
"6";"2";"4";"9";"72";"39509"
"12";"1";"11";"9";"72";"39511"
"2";"1";"1";"9";"72";"39512"
"4";"0";"4";"9";"72";"39513"
"2";"0";"2";"9";"72";"39515"
"2";"0";"2";"9";"72";"39516"
"6";"1";"5";"9";"72";"39517"
"4";"0";"4";"9";"72";"39518"
"5";"2";"3";"9";"72";"39519"
"8";"2";"6";"9";"72";"39521"
"4";"0";"4";"9";"72";"39522"
"9";"2";"7";"9";"72";"39523"
"13";"5";"8";"9";"72";"39524"
"2";"0";"2";"9";"72";"39525"
"4";"0";"4";"9";"72";"39527"
"2";"1";"1";"9";"72";"39529"
"2";"1";"1";"9";"72";"39530"
"1";"1";"0";"9";"72";"39534"
"1";"1";"0";"9";"72";"39539"
"4";"1";"3";"9";"72";"39542"
"3";"1";"2";"9";"72";"39545"
"6";"1";"5";"9";"72";"39546"
"2";"0";"2";"9";"72";"39548"
"5";"1";"4";"9";"72";"39549"
"2";"0";"2";"9";"72";"39552"
"1";"1";"0";"9";"72";"39553"
"1";"0";"1";"9";"72";"39556"
"1";"0";"1";"9";"72";"39557"
"6";"2";"4";"9";"72";"39559"
"7";"2";"5";"9";"72";"39560"
"2";"0";"2";"9";"72";"39562"
"2";"0";"2";"9";"72";"39563"
"5";"2";"3";"9";"72";"39565"
"3";"1";"2";"9";"72";"39566"
"8";"3";"5";"9";"72";"39570"
"1";"1";"0";"9";"72";"39573"
"4";"1";"3";"9";"72";"39574"
"2";"0";"2";"9";"72";"39576"
"4";"3";"1";"9";"72";"39579"
"18";"5";"13";"9";"72";"39580"
"16";"12";"4";"9";"72";"39589"
"4";"1";"3";"9";"72";"39591"
"10";"1";"9";"9";"72";"39592"
"3";"0";"3";"9";"72";"39593"
"7";"4";"3";"9";"72";"39595"
"4";"0";"4";"9";"72";"39598"
"1";"1";"0";"9";"72";"39599"
"3";"0";"3";"9";"72";"39602"
"7";"1";"6";"9";"72";"39605"
"3";"0";"3";"9";"72";"39606"
"2";"0";"2";"9";"72";"39608"
"3";"0";"3";"9";"72";"39614"
"2";"1";"1";"9";"72";"39616"
"12";"3";"9";"9";"72";"39623"
"4";"0";"4";"9";"72";"39627"
"7";"5";"2";"9";"72";"39629"
"6";"2";"4";"9";"72";"39630"
"5";"1";"4";"9";"72";"39632"
"8";"1";"7";"9";"72";"39634"
"3";"1";"2";"9";"72";"39635"
"4";"1";"3";"9";"72";"39637"
"1";"1";"0";"9";"72";"39638"
"2";"0";"2";"9";"72";"39641"
"4";"1";"3";"9";"72";"39642"
"2";"0";"2";"9";"72";"39644"
"7";"3";"4";"9";"72";"39645"
"2";"1";"1";"9";"72";"39647"
"1";"1";"0";"9";"72";"39648"
"3";"1";"2";"9";"72";"39655"
"2";"1";"1";"9";"72";"39657"
"5";"1";"4";"9";"72";"39663"
"1";"1";"0";"9";"72";"39665"
"3";"1";"2";"9";"72";"39669"
"2";"1";"1";"9";"72";"39670"
"4";"1";"3";"9";"72";"39673"
"6";"2";"4";"9";"72";"39674"
"8";"1";"7";"9";"72";"39675"
"3";"1";"2";"9";"72";"39678"
"29";"23";"6";"9";"72";"39679"
"1";"1";"0";"9";"72";"39680"
"4";"1";"3";"9";"72";"39682"
"8";"3";"5";"9";"72";"39684"
"1";"0";"1";"9";"72";"39685"
"2";"1";"1";"9";"72";"39692"
"6";"1";"5";"9";"72";"39693"
"7";"1";"6";"9";"72";"39697"
"5";"1";"4";"9";"72";"39699"
"2";"0";"2";"9";"72";"39700"
"2";"0";"2";"9";"72";"39706"
"1";"1";"0";"9";"72";"39710"
"15";"9";"6";"9";"72";"39711"
"1";"0";"1";"9";"72";"39713"
"1";"1";"0";"9";"72";"39714"
"5";"2";"3";"9";"72";"39719"
"2";"0";"2";"9";"72";"39720"
"4";"1";"3";"9";"72";"39721"
"140";"86";"54";"9";"72";"39722"
"1";"0";"1";"9";"72";"39723"
"10";"5";"5";"9";"72";"39725"
"1";"0";"1";"9";"72";"39728"
"14";"3";"11";"9";"72";"39729"
"1";"1";"0";"9";"72";"39731"
"3";"3";"0";"9";"72";"39737"
"4";"1";"3";"9";"72";"39739"
"8";"2";"6";"9";"72";"39743"
"3";"1";"2";"9";"72";"39744"
"1";"0";"1";"9";"72";"39745"
"3";"1";"2";"9";"72";"39746"
"4";"1";"3";"9";"72";"39747"
"2";"0";"2";"9";"72";"39748"
"2";"1";"1";"9";"72";"39750"
"2";"2";"0";"9";"72";"39751"
"5";"5";"0";"9";"72";"39754"
"6";"0";"6";"9";"72";"39755"
"1";"1";"0";"9";"72";"39758"
"1";"1";"0";"9";"72";"39759"
"30";"17";"13";"9";"72";"39760"
"6";"2";"4";"9";"72";"39761"
"1";"1";"0";"9";"72";"39762"
"2";"1";"1";"9";"72";"39764"
"6";"2";"4";"9";"72";"39765"
"3";"1";"2";"9";"72";"39768"
"1";"1";"0";"9";"72";"39769"
"6";"0";"6";"9";"72";"39770"
"1";"1";"0";"9";"72";"39771"
"7";"1";"6";"9";"72";"39772"
"3";"1";"2";"9";"72";"39773"
"2";"0";"2";"9";"72";"39775"
"1";"1";"0";"9";"72";"39776"
"2";"1";"1";"9";"72";"39778"
"5";"0";"5";"9";"72";"39781"
"2";"1";"1";"9";"72";"39784"
"3";"1";"2";"9";"72";"39785"
"8";"2";"6";"9";"72";"39786"
"2";"1";"1";"9";"72";"39787"
"1";"1";"0";"9";"72";"39791"
"2";"1";"1";"9";"72";"39794"
"5";"0";"5";"9";"72";"39796"
"4";"1";"3";"9";"72";"39800"
"5";"2";"3";"9";"72";"39801"
"13";"3";"10";"9";"72";"39803"
"24";"12";"12";"9";"72";"39808"
"5";"1";"4";"9";"72";"39812"
"2";"0";"2";"9";"72";"39813"
"8";"3";"5";"9";"72";"39814"
"3";"0";"3";"9";"72";"39821"
"5";"1";"4";"9";"72";"39822"
"4";"0";"4";"9";"72";"39823"
"3";"0";"3";"9";"72";"39826"
"2";"0";"2";"9";"72";"39830"
"3";"0";"3";"9";"72";"39831"
"10";"4";"6";"9";"72";"39834"
"5";"1";"4";"9";"72";"39835"
"12";"6";"6";"9";"72";"39836"
"12";"6";"6";"9";"72";"39837"
"2";"0";"2";"9";"72";"39839"
"20";"12";"8";"9";"72";"39840"
"3";"0";"3";"9";"72";"39844"
"12";"3";"9";"9";"72";"39845"
"1";"0";"1";"9";"72";"39846"
"3";"0";"3";"9";"72";"39848"
"1";"1";"0";"9";"72";"39849"
"2";"1";"1";"9";"72";"39850"
"2";"0";"2";"9";"72";"39859"
"3";"2";"1";"9";"72";"39860"
"30";"14";"16";"9";"72";"39861"
"14";"2";"12";"9";"72";"39863"
"1";"0";"1";"9";"72";"39867"
"5";"1";"4";"9";"72";"39870"
"1";"0";"1";"9";"72";"39875"
"3";"0";"3";"9";"72";"39876"
"15";"1";"14";"9";"72";"39878"
"14";"4";"10";"9";"72";"39880"
"1";"1";"0";"9";"72";"39882"
"1";"0";"1";"9";"72";"39883"
"4";"2";"2";"9";"72";"39884"
"7";"1";"6";"9";"72";"39887"
"2";"0";"2";"9";"72";"39896"
"4";"1";"3";"9";"72";"39898"
"1";"1";"0";"9";"72";"39902"
"1";"1";"0";"9";"72";"39905"
"1";"1";"0";"9";"72";"39906"
"7";"3";"4";"9";"72";"39907"
"1";"0";"1";"9";"72";"39909"
"1";"0";"1";"9";"72";"39911"
"8";"1";"7";"9";"72";"39913"
"27";"4";"23";"9";"72";"39917"
"2";"1";"1";"9";"72";"39922"
"17";"15";"2";"9";"72";"39927"
"10";"1";"9";"9";"72";"39931"
"1";"1";"0";"9";"72";"39933"
"5";"1";"4";"9";"72";"39934"
"5";"1";"4";"9";"72";"39938"
"1";"0";"1";"9";"72";"39939"
"1";"0";"1";"9";"72";"39944"
"7";"0";"7";"9";"72";"39946"
"182";"107";"75";"9";"72";"39952"
"3";"1";"2";"9";"72";"39954"
"3";"3";"0";"9";"72";"39955"
"5";"1";"4";"9";"72";"39956"
"2";"1";"1";"9";"72";"39967"
"3";"1";"2";"9";"72";"39968"
"4";"0";"4";"9";"72";"39972"
"13";"1";"12";"9";"72";"39975"
"1";"0";"1";"9";"72";"39976"
"4";"0";"4";"9";"72";"39977"
"5";"1";"4";"9";"72";"39978"
"3";"1";"2";"9";"72";"39979"
"4";"0";"4";"9";"72";"39980"
"7";"1";"6";"9";"72";"39983"
"2";"2";"0";"9";"72";"39985"
"5";"0";"5";"9";"72";"39987"
"4";"1";"3";"9";"72";"39988"
"7";"1";"6";"9";"72";"39990"
"12";"4";"8";"9";"72";"39994"
"1";"1";"0";"9";"72";"39997"
"3";"1";"2";"9";"72";"39998"
"4";"0";"4";"9";"72";"40005"
"2";"2";"0";"9";"72";"40006"
"2";"2";"0";"9";"72";"40008"
"1";"0";"1";"9";"72";"40010"
"1";"0";"1";"9";"72";"40013"
"4";"4";"0";"9";"72";"40014"
"3";"2";"1";"9";"72";"40018"
"7";"3";"4";"9";"72";"40021"
"2";"1";"1";"9";"72";"40027"
"24";"6";"18";"9";"72";"40029"
"5";"0";"5";"9";"72";"40030"
"2";"0";"2";"9";"72";"40037"
"1";"0";"1";"9";"72";"40038"
"1";"0";"1";"9";"72";"40047"
"5";"1";"4";"9";"72";"40050"
"2";"0";"2";"9";"72";"40052"
"3";"1";"2";"9";"72";"40055"
"6";"1";"5";"9";"72";"40057"
"11";"1";"10";"9";"72";"40062"
"3";"0";"3";"9";"72";"40063"
"1";"0";"1";"9";"72";"40064"
"3";"0";"3";"9";"72";"40065"
"3";"1";"2";"9";"72";"40071"
"1";"0";"1";"9";"72";"40075"
"2";"1";"1";"9";"72";"40080"
"5";"1";"4";"9";"72";"40081"
"1";"1";"0";"9";"72";"40086"
"2";"0";"2";"9";"72";"40091"
"7";"1";"6";"9";"72";"40094"
"3";"0";"3";"9";"72";"40100"
"2";"0";"2";"9";"72";"40101"
"8";"3";"5";"9";"72";"40104"
"2";"2";"0";"9";"72";"40105"
"3";"0";"3";"9";"72";"40107"
"4";"2";"2";"9";"72";"40112"
"2";"0";"2";"9";"72";"40113"
"2";"0";"2";"9";"72";"40114"
"1";"1";"0";"9";"72";"40115"
"2";"0";"2";"9";"72";"40117"
"9";"9";"0";"9";"72";"40124"
"1";"1";"0";"9";"72";"40125"
"10";"7";"3";"9";"72";"40126"
"1";"0";"1";"9";"72";"40127"
"1";"1";"0";"9";"72";"40129"
"1";"1";"0";"9";"72";"40131"
"1";"0";"1";"9";"72";"40133"
"1";"1";"0";"9";"72";"40135"
"16";"6";"10";"9";"72";"40137"
"4";"2";"2";"9";"72";"40140"
"8";"2";"6";"9";"72";"40143"
"4";"1";"3";"9";"72";"40154"
"6";"1";"5";"9";"72";"40156"
"8";"1";"7";"9";"72";"40159"
"1";"0";"1";"9";"72";"40163"
"3";"0";"3";"9";"72";"40165"
"1";"1";"0";"9";"72";"40169"
"3";"0";"3";"9";"72";"40173"
"2";"2";"0";"9";"72";"40183"
"8";"2";"6";"9";"72";"40184"
"1";"0";"1";"9";"72";"40185"
"4";"0";"4";"9";"72";"40186"
"4";"1";"3";"9";"72";"40187"
"2";"0";"2";"9";"72";"40193"
"11";"0";"11";"9";"72";"40197"
"2";"0";"2";"9";"72";"40207"
"2";"1";"1";"9";"72";"40211"
"2";"0";"2";"9";"72";"40216"
"3";"1";"2";"9";"72";"40219"
"7";"1";"6";"9";"72";"40221"
"2";"0";"2";"9";"72";"40223"
"3";"1";"2";"9";"72";"40228"
"4";"0";"4";"9";"72";"40230"
"8";"2";"6";"9";"72";"40231"
"3";"1";"2";"9";"72";"40233"
"5";"2";"3";"9";"72";"40234"
"1";"0";"1";"9";"72";"40237"
"1";"0";"1";"9";"72";"40238"
"9";"5";"4";"9";"72";"40241"
"2";"2";"0";"9";"72";"40244"
"5";"0";"5";"9";"72";"40246"
"5";"1";"4";"9";"72";"40251"
"1";"0";"1";"9";"72";"40256"
"15";"5";"10";"9";"72";"40257"
"1";"1";"0";"9";"72";"40263"
"21";"8";"13";"9";"72";"40264"
"8";"5";"3";"9";"72";"40265"
"2";"0";"2";"9";"72";"40268"
"6";"0";"6";"9";"72";"40269"
"5";"1";"4";"9";"72";"40271"
"1";"1";"0";"9";"72";"40272"
"5";"2";"3";"9";"72";"40274"
"2";"1";"1";"9";"72";"40275"
"1";"1";"0";"9";"72";"40277"
"11";"4";"7";"9";"72";"40283"
"59";"36";"23";"9";"72";"40284"
"5";"0";"5";"9";"72";"40286"
"5";"2";"3";"9";"72";"40287"
"4";"1";"3";"9";"72";"40288"
"4";"2";"2";"9";"72";"40291"
"6";"2";"4";"9";"72";"40299"
"1";"1";"0";"9";"72";"40301"
"1";"0";"1";"9";"72";"40305"
"3";"1";"2";"9";"72";"40315"
"2";"0";"2";"9";"72";"40321"
"1";"1";"0";"9";"72";"40322"
"49";"21";"28";"9";"72";"40323"
"15";"9";"6";"9";"72";"40324"
"6";"2";"4";"9";"72";"40325"
"6";"3";"3";"9";"72";"40327"
"3";"0";"3";"9";"72";"40328"
"10";"4";"6";"9";"72";"40329"
"7";"2";"5";"9";"72";"40333"
"5";"1";"4";"9";"72";"40334"
"1";"1";"0";"9";"72";"40338"
"1";"1";"0";"9";"72";"40341"
"8";"5";"3";"9";"72";"40342"
"3";"1";"2";"9";"72";"40343"
"1";"1";"0";"9";"72";"40353"
"2";"0";"2";"9";"72";"40355"
"4";"1";"3";"9";"72";"40360"
"3";"1";"2";"9";"72";"40363"
"28";"4";"24";"9";"72";"40365"
"1";"1";"0";"9";"72";"40367"
"6";"2";"4";"9";"72";"40371"
"18";"10";"8";"9";"72";"40373"
"2";"0";"2";"9";"72";"40374"
"6";"0";"6";"9";"72";"40377"
"12";"0";"12";"9";"72";"40379"
"2";"0";"2";"9";"72";"40381"
"2";"0";"2";"9";"72";"40386"
"1";"0";"1";"9";"72";"40392"
"12";"6";"6";"9";"72";"40395"
"2";"0";"2";"9";"72";"40397"
"2";"0";"2";"9";"72";"40403"
"4";"1";"3";"9";"72";"40408"
"1";"0";"1";"9";"72";"40417"
"1";"1";"0";"9";"72";"40419"
"3";"1";"2";"9";"72";"40425"
"1";"0";"1";"9";"72";"40432"
"6";"2";"4";"9";"72";"40434"
"2";"1";"1";"9";"72";"40435"
"1";"0";"1";"9";"72";"40436"
"3";"0";"3";"9";"72";"40438"
"4";"1";"3";"9";"72";"40445"
"16";"5";"11";"9";"72";"40446"
"7";"3";"4";"9";"72";"40447"
"13";"6";"7";"9";"72";"40449"
"2";"1";"1";"9";"72";"40451"
"6";"3";"3";"9";"72";"40453"
"1";"0";"1";"9";"72";"40455"
"2";"1";"1";"9";"72";"40458"
"4";"1";"3";"9";"72";"40464"
"1";"1";"0";"9";"72";"40468"
"6";"2";"4";"9";"72";"40469"
"1";"1";"0";"9";"72";"40474"
"2";"2";"0";"9";"72";"40476"
"1";"1";"0";"9";"72";"40483"
"2";"1";"1";"9";"72";"40485"
"4";"0";"4";"9";"72";"40486"
"8";"3";"5";"9";"72";"40488"
"1";"1";"0";"9";"72";"40490"
"1";"1";"0";"9";"72";"40492"
"5";"2";"3";"9";"72";"40493"
"2";"2";"0";"9";"72";"40494"
"9";"1";"8";"9";"72";"40499"
"5";"3";"2";"9";"72";"40504"
"3";"0";"3";"9";"72";"40510"
"7";"2";"5";"9";"72";"40516"
"10";"3";"7";"9";"72";"40519"
"2";"1";"1";"9";"72";"40520"
"4";"1";"3";"9";"72";"40523"
"21";"2";"19";"9";"72";"40524"
"11";"2";"9";"9";"72";"40526"
"5";"0";"5";"9";"72";"40527"
"3";"1";"2";"9";"72";"40528"
"10";"1";"9";"9";"72";"40529"
"1";"1";"0";"9";"72";"40531"
"3";"0";"3";"9";"72";"40533"
"1";"1";"0";"9";"72";"40536"
"1";"0";"1";"9";"72";"40537"
"1";"0";"1";"9";"72";"40543"
"71";"8";"63";"9";"72";"40544"
"1";"0";"1";"9";"72";"40547"
"4";"2";"2";"9";"72";"40550"
"3";"1";"2";"9";"72";"40555"
"5";"1";"4";"9";"72";"40564"
"3";"0";"3";"9";"72";"40565"
"2";"1";"1";"9";"72";"40566"
"8";"3";"5";"9";"72";"40570"
"3";"0";"3";"9";"72";"40573"
"1";"1";"0";"9";"72";"40580"
"3";"0";"3";"9";"72";"40581"
"35";"5";"30";"9";"72";"40582"
"4";"1";"3";"9";"72";"40583"
"3";"1";"2";"9";"72";"40584"
"6";"2";"4";"9";"72";"40586"
"6";"4";"2";"9";"72";"40589"
"6";"2";"4";"9";"72";"40591"
"1";"0";"1";"9";"72";"40602"
"4";"1";"3";"9";"72";"40604"
"5";"0";"5";"9";"72";"40609"
"8";"0";"8";"9";"72";"40610"
"1";"1";"0";"9";"72";"40611"
"8";"0";"8";"9";"72";"40613"
"4";"2";"2";"9";"72";"40616"
"1";"0";"1";"9";"72";"40617"
"9";"1";"8";"9";"72";"40619"
"4";"0";"4";"9";"72";"40629"
"1";"0";"1";"9";"72";"40631"
"7";"2";"5";"9";"72";"40634"
"1";"0";"1";"9";"72";"40637"
"4";"0";"4";"9";"72";"40640"
"1";"0";"1";"9";"72";"40641"
"4";"1";"3";"9";"72";"40642"
"12";"3";"9";"9";"72";"40643"
"1";"1";"0";"9";"72";"40646"
"5";"0";"5";"9";"72";"40648"
"3";"0";"3";"9";"72";"40650"
"9";"1";"8";"9";"72";"40658"
"6";"1";"5";"9";"72";"40665"
"6";"3";"3";"9";"72";"40666"
"3";"2";"1";"9";"72";"40667"
"3";"1";"2";"9";"72";"40668"
"3";"1";"2";"9";"72";"40669"
"2";"0";"2";"9";"72";"40674"
"5";"4";"1";"9";"72";"40678"
"6";"1";"5";"9";"72";"40679"
"5";"0";"5";"9";"72";"40681"
"12";"8";"4";"9";"72";"40685"
"1";"1";"0";"9";"72";"40687"
"4";"2";"2";"9";"72";"40698"
"50";"32";"18";"9";"72";"40703"
"4";"1";"3";"9";"72";"40706"
"3";"0";"3";"9";"72";"40707"
"9";"0";"9";"9";"72";"40708"
"3";"1";"2";"9";"72";"40710"
"5";"0";"5";"9";"72";"40712"
"1";"1";"0";"9";"72";"40716"
"4";"1";"3";"9";"72";"40718"
"6";"1";"5";"9";"72";"40722"
"3";"0";"3";"9";"72";"40723"
"5";"1";"4";"9";"72";"40724"
"5";"2";"3";"9";"72";"40726"
"9";"1";"8";"9";"72";"40729"
"7";"1";"6";"9";"72";"40731"
"11";"8";"3";"9";"72";"40734"
"26";"16";"10";"9";"72";"40735"
"5";"2";"3";"9";"72";"40736"
"21";"14";"7";"9";"72";"40746"
"1";"1";"0";"9";"72";"40747"
"3";"1";"2";"9";"72";"40749"
"1";"1";"0";"9";"72";"40750"
"2";"1";"1";"9";"72";"40757"
"2";"0";"2";"9";"72";"40759"
"1";"0";"1";"9";"72";"40761"
"1";"1";"0";"9";"72";"40763"
"10";"1";"9";"9";"72";"40767"
"1";"0";"1";"9";"72";"40768"
"5";"1";"4";"9";"72";"40769"
"1";"1";"0";"9";"72";"40772"
"5";"1";"4";"9";"72";"40778"
"1";"1";"0";"9";"72";"40780"
"2";"0";"2";"9";"72";"40781"
"7";"2";"5";"9";"72";"40783"
"3";"0";"3";"9";"72";"40785"
"7";"2";"5";"9";"72";"40791"
"4";"1";"3";"9";"72";"40792"
"3";"0";"3";"9";"72";"40795"
"3";"2";"1";"9";"72";"40799"
"8";"2";"6";"9";"72";"40801"
"3";"3";"0";"9";"72";"40804"
"3";"0";"3";"9";"72";"40805"
"16";"10";"6";"9";"72";"40808"
"1";"1";"0";"9";"72";"40810"
"2";"1";"1";"9";"72";"40813"
"4";"1";"3";"9";"72";"40815"
"2";"0";"2";"9";"72";"40816"
"1";"1";"0";"9";"72";"40818"
"2";"0";"2";"9";"72";"40825"
"2";"0";"2";"9";"72";"40831"
"4";"2";"2";"9";"72";"40832"
"1";"0";"1";"9";"72";"40834"
"1";"1";"0";"9";"72";"40837"
"1";"1";"0";"9";"72";"40838"
"1";"1";"0";"9";"72";"40841"
"1";"1";"0";"9";"72";"40849"
"1";"1";"0";"9";"72";"40851"
"2";"0";"2";"9";"72";"40853"
"2";"0";"2";"9";"72";"40858"
"1";"1";"0";"9";"72";"40863"
"9";"0";"9";"9";"72";"40866"
"2";"1";"1";"9";"72";"40868"
"1";"0";"1";"9";"72";"40869"
"73";"44";"29";"9";"72";"40870"
"4";"2";"2";"9";"72";"40874"
"5";"1";"4";"9";"72";"40879"
"4";"1";"3";"9";"72";"40882"
"6";"2";"4";"9";"72";"40885"
"467";"385";"82";"9";"72";"40886"
"3";"0";"3";"9";"72";"40895"
"7";"2";"5";"9";"72";"40897"
"4";"0";"4";"9";"72";"40899"
"3";"1";"2";"9";"72";"40900"
"2";"2";"0";"9";"72";"40901"
"1";"0";"1";"9";"72";"40902"
"19";"9";"10";"9";"72";"40906"
"2";"1";"1";"9";"72";"40907"
"5";"1";"4";"9";"72";"40910"
"6";"1";"5";"9";"72";"40912"
"6";"1";"5";"9";"72";"40914"
"2";"1";"1";"9";"72";"40916"
"2";"0";"2";"9";"72";"40918"
"2";"0";"2";"9";"72";"40920"
"2";"1";"1";"9";"72";"40921"
"6";"0";"6";"9";"72";"40929"
"1";"1";"0";"9";"72";"40933"
"14";"4";"10";"9";"72";"40939"
"11";"5";"6";"9";"72";"40945"
"3";"1";"2";"9";"72";"40956"
"1";"1";"0";"9";"72";"40966"
"6";"1";"5";"9";"72";"40976"
"6";"3";"3";"9";"72";"40977"
"2";"1";"1";"9";"72";"40982"
"4";"1";"3";"9";"72";"40984"
"7";"2";"5";"9";"72";"40985"
"2";"1";"1";"9";"72";"40986"
"1";"0";"1";"9";"72";"40990"
"3";"0";"3";"9";"72";"40991"
"1";"1";"0";"9";"72";"40992"
"2";"0";"2";"9";"72";"40994"
"4";"1";"3";"9";"72";"40999"
"4";"0";"4";"9";"72";"41000"
"1";"1";"0";"9";"72";"41001"
"1";"1";"0";"9";"72";"41005"
"3";"0";"3";"9";"72";"41008"
"3";"1";"2";"9";"72";"41011"
"7";"1";"6";"9";"72";"41012"
"29";"2";"27";"9";"72";"41014"
"2";"1";"1";"9";"72";"41019"
"2";"0";"2";"9";"72";"41020"
"18";"8";"10";"9";"72";"41021"
"2";"0";"2";"9";"72";"41023"
"9";"2";"7";"9";"72";"41031"
"2";"1";"1";"9";"72";"41042"
"1";"1";"0";"9";"72";"41043"
"3";"1";"2";"9";"72";"41049"
"5";"0";"5";"9";"72";"41051"
"7";"2";"5";"9";"72";"41054"
"2";"1";"1";"9";"72";"41055"
"6";"0";"6";"9";"72";"41058"
"2";"0";"2";"9";"72";"41059"
"2";"1";"1";"9";"72";"41060"
"4";"3";"1";"9";"72";"41061"
"24";"7";"17";"9";"72";"41069"
"4";"1";"3";"9";"72";"41070"
"11";"2";"9";"9";"72";"41072"
"3";"1";"2";"9";"72";"41073"
"1";"1";"0";"9";"72";"41077"
"5";"1";"4";"9";"72";"41078"
"6";"2";"4";"9";"72";"41079"
"6";"1";"5";"9";"72";"41085"
"2";"1";"1";"9";"72";"41091"
"7";"1";"6";"9";"72";"41095"
"7";"3";"4";"9";"72";"41096"
"6";"1";"5";"9";"72";"41097"
"6";"3";"3";"9";"72";"41103"
"8";"1";"7";"9";"72";"41104"
"1";"0";"1";"9";"72";"41105"
"1";"1";"0";"9";"72";"41106"
"1";"1";"0";"9";"72";"41107"
"27";"19";"8";"9";"72";"41110"
"2";"1";"1";"9";"72";"41111"
"2";"1";"1";"9";"72";"41112"
"1";"0";"1";"9";"72";"41114"
"5";"0";"5";"9";"72";"41115"
"22";"17";"5";"9";"72";"41117"
"5";"1";"4";"9";"72";"41118"
"5";"2";"3";"9";"72";"41121"
"5";"1";"4";"9";"72";"41122"
"3";"1";"2";"9";"72";"41123"
"3";"0";"3";"9";"72";"41127"
"2";"1";"1";"9";"72";"41133"
"5";"2";"3";"9";"72";"41134"
"4";"1";"3";"9";"72";"41135"
"3";"0";"3";"9";"72";"41138"
"25";"18";"7";"9";"72";"41140"
"1";"1";"0";"9";"72";"41141"
"8";"1";"7";"9";"72";"41144"
"1";"0";"1";"9";"72";"41146"
"2";"1";"1";"9";"72";"41147"
"3";"0";"3";"9";"72";"41152"
"2";"0";"2";"9";"72";"41153"
"9";"5";"4";"9";"72";"41154"
"5";"0";"5";"9";"72";"41157"
"41";"33";"8";"9";"72";"41159"
"4";"2";"2";"9";"72";"41168"
"2";"0";"2";"9";"72";"41170"
"3";"0";"3";"9";"72";"41171"
"1";"0";"1";"9";"72";"41175"
"1";"1";"0";"9";"72";"41176"
"2";"1";"1";"9";"72";"41179"
"1";"1";"0";"9";"72";"41180"
"18";"6";"12";"9";"72";"41181"
"2";"0";"2";"9";"72";"41184"
"7";"1";"6";"9";"72";"41185"
"3";"1";"2";"9";"72";"41186"
"1";"1";"0";"9";"72";"41188"
"4";"3";"1";"9";"72";"41192"
"6";"1";"5";"9";"72";"41200"
"3";"3";"0";"9";"72";"41202"
"1";"1";"0";"9";"72";"41204"
"1";"1";"0";"9";"72";"41206"
"2";"1";"1";"9";"72";"41207"
"4";"2";"2";"9";"72";"41208"
"2";"0";"2";"9";"72";"41209"
"5";"0";"5";"9";"72";"41210"
"4";"2";"2";"9";"72";"41211"
"7";"3";"4";"9";"72";"41212"
"2";"1";"1";"9";"72";"41214"
"12";"1";"11";"9";"72";"41217"
"10";"4";"6";"9";"72";"41221"
"1";"1";"0";"9";"72";"41225"
"4";"0";"4";"9";"72";"41226"
"3";"0";"3";"9";"72";"41231"
"1";"1";"0";"9";"72";"41232"
"1";"0";"1";"9";"72";"41234"
"19";"3";"16";"9";"72";"41239"
"2";"0";"2";"9";"72";"41241"
"9";"1";"8";"9";"72";"41243"
"1";"1";"0";"9";"72";"41244"
"18";"6";"12";"9";"72";"41245"
"4";"1";"3";"9";"72";"41247"
"6";"2";"4";"9";"72";"41251"
"2";"0";"2";"9";"72";"41254"
"12";"6";"6";"9";"72";"41255"
"8";"5";"3";"9";"72";"41256"
"7";"5";"2";"9";"72";"41257"
"3";"1";"2";"9";"72";"41258"
"3";"1";"2";"9";"72";"41260"
"8";"2";"6";"9";"72";"41262"
"6";"1";"5";"9";"72";"41264"
"6";"0";"6";"9";"72";"41266"
"1";"1";"0";"9";"72";"41272"
"34";"22";"12";"9";"72";"41280"
"8";"1";"7";"9";"72";"41282"
"2";"1";"1";"9";"72";"41284"
"21";"8";"13";"9";"72";"41293"
"142";"118";"24";"9";"72";"41298"
"9";"5";"4";"9";"72";"41299"
"1";"0";"1";"9";"72";"41301"
"7";"2";"5";"9";"72";"41302"
"5";"0";"5";"9";"72";"41306"
"6";"3";"3";"9";"72";"41307"
"1";"1";"0";"9";"72";"41308"
"1";"0";"1";"9";"72";"41310"
"3";"1";"2";"9";"72";"41312"
"4";"1";"3";"9";"72";"41316"
"2";"2";"0";"9";"72";"41317"
"3";"0";"3";"9";"72";"41321"
"1";"1";"0";"9";"72";"41323"
"8";"5";"3";"9";"72";"41324"
"3";"1";"2";"9";"72";"41326"
"3";"0";"3";"9";"72";"41329"
"4";"0";"4";"9";"72";"41338"
"4";"0";"4";"9";"72";"41339"
"2";"0";"2";"9";"72";"41340"
"3";"0";"3";"9";"72";"41344"
"2";"0";"2";"9";"72";"41347"
"6";"2";"4";"9";"72";"41349"
"3";"1";"2";"9";"72";"41354"
"16";"9";"7";"9";"72";"41355"
"5";"1";"4";"9";"72";"41356"
"3";"0";"3";"9";"72";"41358"
"1";"1";"0";"9";"72";"41359"
"5";"2";"3";"9";"72";"41361"
"11";"2";"9";"9";"72";"41362"
"1";"0";"1";"9";"72";"41365"
"16";"1";"15";"9";"72";"41369"
"5";"1";"4";"9";"72";"41372"
"4";"1";"3";"9";"72";"41374"
"5";"2";"3";"9";"72";"41375"
"7";"7";"0";"9";"72";"41376"
"1";"0";"1";"9";"72";"41377"
"2";"1";"1";"9";"72";"41383"
"2";"1";"1";"9";"72";"41388"
"4";"0";"4";"9";"72";"41389"
"2";"0";"2";"9";"72";"41397"
"2";"1";"1";"9";"72";"41398"
"7";"1";"6";"9";"72";"41399"
"13";"2";"11";"9";"72";"41402"
"1";"1";"0";"9";"72";"41407"
"4";"2";"2";"9";"72";"41408"
"5";"1";"4";"9";"72";"41410"
"4";"0";"4";"9";"72";"41415"
"1";"1";"0";"9";"72";"41425"
"6";"2";"4";"9";"72";"41428"
"7";"0";"7";"9";"72";"41432"
"5";"1";"4";"9";"72";"41437"
"4";"1";"3";"9";"72";"41439"
"2";"1";"1";"9";"72";"41441"
"3";"1";"2";"9";"72";"41442"
"5";"3";"2";"9";"72";"41444"
"1";"0";"1";"9";"72";"41449"
"1";"0";"1";"9";"72";"41459"
"36";"26";"10";"9";"72";"41460"
"3";"1";"2";"9";"72";"41463"
"71";"60";"11";"9";"72";"41467"
"4";"2";"2";"9";"72";"41468"
"6";"2";"4";"9";"72";"41473"
"117";"73";"44";"9";"72";"41474"
"6";"0";"6";"9";"72";"41476"
"7";"2";"5";"9";"72";"41478"
"3";"0";"3";"9";"72";"41482"
"15";"3";"12";"9";"72";"41485"
"1";"1";"0";"9";"72";"41489"
"6";"3";"3";"9";"72";"41493"
"1";"1";"0";"9";"72";"41499"
"2";"0";"2";"9";"72";"41500"
"2";"0";"2";"9";"72";"41504"
"2";"0";"2";"9";"72";"41505"
"4";"1";"3";"9";"72";"41507"
"1";"0";"1";"9";"72";"41508"
"5";"0";"5";"9";"72";"41511"
"2";"1";"1";"9";"72";"41512"
"2";"2";"0";"9";"72";"41513"
"6";"1";"5";"9";"72";"41515"
"3";"1";"2";"9";"72";"41517"
"200";"161";"39";"9";"72";"41522"
"4";"0";"4";"9";"72";"41525"
"38";"31";"7";"9";"72";"41526"
"4";"1";"3";"9";"72";"41530"
"1";"0";"1";"9";"72";"41538"
"5";"0";"5";"9";"72";"41541"
"2";"2";"0";"9";"72";"41543"
"1";"1";"0";"9";"72";"41546"
"1";"1";"0";"9";"72";"41551"
"9";"4";"5";"9";"72";"41555"
"2";"1";"1";"9";"72";"41559"
"1";"0";"1";"9";"72";"41562"
"1";"1";"0";"9";"72";"41565"
"4";"1";"3";"9";"72";"41571"
"7";"3";"4";"9";"72";"41572"
"3";"3";"0";"9";"72";"41574"
"1";"1";"0";"9";"72";"41581"
"1";"0";"1";"9";"72";"41585"
"4";"1";"3";"9";"72";"41586"
"6";"1";"5";"9";"72";"41589"
"4";"2";"2";"9";"72";"41591"
"10";"1";"9";"9";"72";"41592"
"1";"1";"0";"9";"72";"41594"
"2";"1";"1";"9";"72";"41597"
"8";"5";"3";"9";"72";"41598"
"5";"0";"5";"9";"72";"41599"
"6";"2";"4";"9";"72";"41607"
"1";"0";"1";"9";"72";"41608"
"1";"1";"0";"9";"72";"41610"
"1";"0";"1";"9";"72";"41612"
"3";"1";"2";"9";"72";"41613"
"8";"3";"5";"9";"72";"41614"
"2";"0";"2";"9";"72";"41619"
"1";"1";"0";"9";"72";"41620"
"19";"9";"10";"9";"72";"41623"
"3";"0";"3";"9";"72";"41627"
"2";"1";"1";"9";"72";"41630"
"1";"1";"0";"9";"72";"41635"
"6";"1";"5";"9";"72";"41637"
"2";"0";"2";"9";"72";"41640"
"2";"1";"1";"9";"72";"41643"
"1";"1";"0";"9";"72";"41644"
"2";"0";"2";"9";"72";"41654"
"1";"1";"0";"9";"72";"41656"
"2";"0";"2";"9";"72";"41659"
"6";"3";"3";"9";"72";"41670"
"4";"1";"3";"9";"72";"41671"
"1";"0";"1";"9";"72";"41678"
"8";"1";"7";"9";"72";"41680"
"7";"0";"7";"9";"72";"41694"
"4";"1";"3";"9";"72";"41698"
"3";"3";"0";"9";"72";"41699"
"1";"1";"0";"9";"72";"41700"
"13";"6";"7";"9";"72";"41702"
"1";"1";"0";"9";"72";"41703"
"16";"10";"6";"9";"72";"41705"
"2";"0";"2";"9";"72";"41713"
"5";"1";"4";"9";"72";"41714"
"3";"0";"3";"9";"72";"41717"
"4";"3";"1";"9";"72";"41721"
"7";"3";"4";"9";"72";"41723"
"3";"1";"2";"9";"72";"41729"
"2";"0";"2";"9";"72";"41732"
"33";"22";"11";"9";"72";"41735"
"4";"0";"4";"9";"72";"41743"
"2";"0";"2";"9";"72";"41744"
"1";"1";"0";"9";"72";"41751"
"1";"0";"1";"9";"72";"41756"
"10";"1";"9";"9";"72";"41758"
"3";"1";"2";"9";"72";"41764"
"12";"8";"4";"9";"72";"41768"
"10";"4";"6";"9";"72";"41771"
"26";"5";"21";"9";"72";"41775"
"2";"0";"2";"9";"72";"41776"
"10";"2";"8";"9";"72";"41777"
"4";"1";"3";"9";"72";"41781"
"1";"1";"0";"9";"72";"41782"
"6";"2";"4";"9";"72";"41785"
"2";"1";"1";"9";"72";"41786"
"2";"1";"1";"9";"72";"41788"
"4";"1";"3";"9";"72";"41789"
"3";"3";"0";"9";"72";"41790"
"4";"1";"3";"9";"72";"41791"
"4";"1";"3";"9";"72";"41795"
"1";"1";"0";"9";"72";"41798"
"13";"10";"3";"9";"72";"41802"
"16";"6";"10";"9";"72";"41804"
"4";"1";"3";"9";"72";"41811"
"1";"1";"0";"9";"72";"41813"
"4";"1";"3";"9";"72";"41822"
"1";"0";"1";"9";"72";"41823"
"3";"0";"3";"9";"72";"41824"
"5";"1";"4";"9";"72";"41831"
"3";"0";"3";"9";"72";"41835"
"6";"2";"4";"9";"72";"41839"
"5";"3";"2";"9";"72";"41840"
"4";"0";"4";"9";"72";"41842"
"1";"0";"1";"9";"72";"41849"
"1";"0";"1";"9";"72";"41851"
"1";"1";"0";"9";"72";"41853"
"1";"1";"0";"9";"72";"41856"
"3";"1";"2";"9";"72";"41858"
"1";"1";"0";"9";"72";"41863"
"4";"1";"3";"9";"72";"41866"
"3";"1";"2";"9";"72";"41867"
"1";"1";"0";"9";"72";"41874"
"3";"1";"2";"9";"72";"41877"
"3";"1";"2";"9";"72";"41879"
"2";"0";"2";"9";"72";"41881"
"1";"0";"1";"9";"72";"41882"
"2";"0";"2";"9";"72";"41885"
"1";"0";"1";"9";"72";"41889"
"3";"0";"3";"9";"72";"41891"
"12";"8";"4";"9";"72";"41892"
"6";"1";"5";"9";"72";"41893"
"2";"1";"1";"9";"72";"41895"
"3";"0";"3";"9";"72";"41898"
"22";"5";"17";"9";"72";"41900"
"7";"1";"6";"9";"72";"41903"
"9";"4";"5";"9";"72";"41912"
"1";"1";"0";"9";"72";"41915"
"7";"2";"5";"9";"72";"41916"
"10";"4";"6";"9";"72";"41917"
"6";"1";"5";"9";"72";"41923"
"2";"0";"2";"9";"72";"41927"
"3";"1";"2";"9";"72";"41935"
"4";"1";"3";"9";"72";"41940"
"10";"3";"7";"9";"72";"41947"
"9";"0";"9";"9";"72";"41950"
"5";"2";"3";"9";"72";"41955"
"6";"2";"4";"9";"72";"41956"
"2";"1";"1";"9";"72";"41958"
"8";"1";"7";"9";"72";"41962"
"3";"1";"2";"9";"72";"41966"
"172";"126";"46";"9";"72";"41973"
"3";"1";"2";"9";"72";"41976"
"8";"2";"6";"9";"72";"41978"
"1";"0";"1";"9";"72";"41979"
"8";"2";"6";"9";"72";"41982"
"3";"1";"2";"9";"72";"41985"
"2";"1";"1";"9";"72";"41986"
"15";"6";"9";"9";"72";"41988"
"5";"1";"4";"9";"72";"41990"
"35";"28";"7";"9";"72";"41994"
"2";"0";"2";"9";"72";"41999"
"2";"0";"2";"9";"72";"42000"
"22";"1";"21";"9";"72";"42001"
"2";"0";"2";"9";"72";"42003"
"4";"1";"3";"9";"72";"42004"
"6";"1";"5";"9";"72";"42008"
"10";"3";"7";"9";"72";"42011"
"9";"3";"6";"9";"72";"42012"
"1";"0";"1";"9";"72";"42016"
"9";"5";"4";"9";"72";"42021"
"1";"0";"1";"9";"72";"42025"
"18";"2";"16";"9";"72";"42028"
"4";"1";"3";"9";"72";"42029"
"3";"1";"2";"9";"72";"42033"
"3";"2";"1";"9";"72";"42035"
"2";"1";"1";"9";"72";"42038"
"3";"1";"2";"9";"72";"42046"
"4";"0";"4";"9";"72";"42048"
"3";"1";"2";"9";"72";"42051"
"7";"3";"4";"9";"72";"42052"
"1";"0";"1";"9";"72";"42054"
"8";"1";"7";"9";"72";"42060"
"2";"1";"1";"9";"72";"42062"
"14";"2";"12";"9";"72";"42063"
"1";"1";"0";"9";"72";"42068"
"1";"1";"0";"9";"72";"42074"
"3";"1";"2";"9";"72";"42079"
"2";"1";"1";"9";"72";"42082"
"1";"1";"0";"9";"72";"42083"
"1";"0";"1";"9";"72";"42085"
"1";"0";"1";"9";"72";"42088"
"3";"1";"2";"9";"72";"42091"
"4";"2";"2";"9";"72";"42092"
"14";"12";"2";"9";"72";"42105"
"2";"2";"0";"9";"72";"42106"
"4";"1";"3";"9";"72";"42107"
"16";"2";"14";"9";"72";"42113"
"2";"1";"1";"9";"72";"42121"
"13";"8";"5";"9";"72";"42123"
"3";"2";"1";"9";"72";"42124"
"12";"2";"10";"9";"72";"42126"
"11";"2";"9";"9";"72";"42132"
"1";"0";"1";"9";"72";"42133"
"7";"2";"5";"9";"72";"42134"
"6";"2";"4";"9";"72";"42136"
"1";"1";"0";"9";"72";"42139"
"5";"3";"2";"9";"72";"42140"
"8";"2";"6";"9";"72";"42142"
"2";"1";"1";"9";"72";"42143"
"5";"1";"4";"9";"72";"42144"
"3";"1";"2";"9";"72";"42152"
"1";"1";"0";"9";"72";"42154"
"4";"0";"4";"9";"72";"42155"
"12";"1";"11";"9";"72";"42156"
"5";"1";"4";"9";"72";"42157"
"8";"2";"6";"9";"72";"42162"
"1";"0";"1";"9";"72";"42165"
"3";"1";"2";"9";"72";"42168"
"7";"5";"2";"9";"72";"42169"
"1";"0";"1";"9";"72";"42172"
"9";"0";"9";"9";"72";"42176"
"11";"6";"5";"9";"72";"42178"
"1";"0";"1";"9";"72";"42180"
"11";"6";"5";"9";"72";"42181"
"4";"0";"4";"9";"72";"42185"
"2";"0";"2";"9";"72";"42186"
"6";"1";"5";"9";"72";"42190"
"3";"0";"3";"9";"72";"42192"
"2";"0";"2";"9";"72";"42193"
"2";"0";"2";"9";"72";"42197"
"2";"1";"1";"9";"72";"42199"
"2";"1";"1";"9";"72";"42200"
"5";"2";"3";"9";"72";"42202"
"1";"1";"0";"9";"72";"42203"
"5";"5";"0";"9";"72";"42208"
"1";"0";"1";"9";"72";"42210"
"3";"1";"2";"9";"72";"42219"
"6";"1";"5";"9";"72";"42220"
"4";"0";"4";"9";"72";"42228"
"2";"0";"2";"9";"72";"42233"
"2";"1";"1";"9";"72";"42234"
"3";"0";"3";"9";"72";"42238"
"9";"1";"8";"9";"72";"42243"
"1";"1";"0";"9";"72";"42249"
"3";"3";"0";"9";"72";"42250"
"5";"2";"3";"9";"72";"42251"
"2";"0";"2";"9";"72";"42256"
"4";"2";"2";"9";"72";"42257"
"2";"1";"1";"9";"72";"42263"
"3";"1";"2";"9";"72";"42265"
"3";"0";"3";"9";"72";"42266"
"6";"1";"5";"9";"72";"42268"
"25";"7";"18";"9";"72";"42269"
"3";"1";"2";"9";"72";"42270"
"1";"1";"0";"9";"72";"42275"
"5";"2";"3";"9";"72";"42276"
"5";"1";"4";"9";"72";"42281"
"5";"2";"3";"9";"72";"42282"
"2";"1";"1";"9";"72";"42283"
"2";"2";"0";"9";"72";"42286"
"3";"3";"0";"9";"72";"42287"
"3";"3";"0";"9";"72";"42294"
"2";"0";"2";"9";"72";"42295"
"13";"4";"9";"9";"72";"42300"
"1";"0";"1";"9";"72";"42309"
"2";"0";"2";"9";"72";"42311"
"4";"2";"2";"9";"72";"42312"
"1";"1";"0";"9";"72";"42315"
"11";"1";"10";"9";"72";"42316"
"2";"1";"1";"9";"72";"42317"
"4";"0";"4";"9";"72";"42321"
"8";"4";"4";"9";"72";"42322"
"8";"2";"6";"9";"72";"42327"
"2";"0";"2";"9";"72";"42329"
"1";"0";"1";"9";"72";"42330"
"3";"1";"2";"9";"72";"42333"
"5";"1";"4";"9";"72";"42335"
"5";"2";"3";"9";"72";"42338"
"4";"2";"2";"9";"72";"42340"
"1";"1";"0";"9";"72";"42342"
"7";"2";"5";"9";"72";"42346"
"1";"1";"0";"9";"72";"42348"
"3";"0";"3";"9";"72";"42349"
"9";"6";"3";"9";"72";"42351"
"5";"1";"4";"9";"72";"42352"
"1";"1";"0";"9";"72";"42354"
"13";"3";"10";"9";"72";"42358"
"5";"1";"4";"9";"72";"42360"
"5";"0";"5";"9";"72";"42366"
"3";"0";"3";"9";"72";"42367"
"5";"1";"4";"9";"72";"42368"
"2";"1";"1";"9";"72";"42370"
"2";"1";"1";"9";"72";"42374"
"2";"0";"2";"9";"72";"42375"
"2";"0";"2";"9";"72";"42376"
"3";"0";"3";"9";"72";"42379"
"3";"1";"2";"9";"72";"42381"
"3";"1";"2";"9";"72";"42382"
"2";"1";"1";"9";"72";"42384"
"6";"2";"4";"9";"72";"42385"
"2";"1";"1";"9";"72";"42386"
"2";"0";"2";"9";"72";"42394"
"28";"11";"17";"9";"72";"42395"
"7";"3";"4";"9";"72";"42396"
"6";"3";"3";"9";"72";"42397"
"5";"1";"4";"9";"72";"42399"
"3";"0";"3";"9";"72";"42404"
"6";"2";"4";"9";"72";"42406"
"3";"0";"3";"9";"72";"42407"
"1";"1";"0";"9";"72";"42412"
"8";"2";"6";"9";"72";"42414"
"5";"1";"4";"9";"72";"42415"
"1";"1";"0";"9";"72";"42416"
"3";"0";"3";"9";"72";"42417"
"1";"1";"0";"9";"72";"42420"
"4";"1";"3";"9";"72";"42421"
"1";"1";"0";"9";"72";"42422"
"7";"0";"7";"9";"72";"42427"
"4";"0";"4";"9";"72";"42429"
"1";"0";"1";"9";"72";"42430"
"5";"1";"4";"9";"72";"42432"
"32";"14";"18";"9";"72";"42435"
"2";"1";"1";"9";"72";"42438"
"2";"2";"0";"9";"72";"42442"
"1";"1";"0";"9";"72";"42443"
"14";"3";"11";"9";"72";"42444"
"1";"1";"0";"9";"72";"42446"
"2";"0";"2";"9";"72";"42447"
"4";"1";"3";"9";"72";"42451"
"4";"0";"4";"9";"72";"42455"
"2";"0";"2";"9";"72";"42456"
"1";"1";"0";"9";"72";"42457"
"217";"147";"70";"9";"72";"42459"
"1";"1";"0";"9";"72";"42461"
"2";"0";"2";"9";"72";"42467"
"1";"0";"1";"9";"72";"42474"
"6";"1";"5";"9";"72";"42476"
"1";"1";"0";"9";"72";"42477"
"1";"0";"1";"9";"72";"42479"
"1";"0";"1";"9";"72";"42483"
"5";"0";"5";"9";"72";"42486"
"5";"1";"4";"9";"72";"42487"
"1";"1";"0";"9";"72";"42489"
"2";"0";"2";"9";"72";"42490"
"20";"9";"11";"9";"72";"42500"
"3";"0";"3";"9";"72";"42503"
"1";"0";"1";"9";"72";"42504"
"2";"1";"1";"9";"72";"42506"
"1";"1";"0";"9";"72";"42507"
"1";"1";"0";"9";"72";"42512"
"5";"1";"4";"9";"72";"42517"
"17";"4";"13";"9";"72";"42520"
"3";"1";"2";"9";"72";"42521"
"4";"1";"3";"9";"72";"42527"
"6";"2";"4";"9";"72";"42528"
"1";"0";"1";"9";"72";"42529"
"4";"1";"3";"9";"72";"42530"
"10";"5";"5";"9";"72";"42534"
"4";"0";"4";"9";"72";"42536"
"4";"0";"4";"9";"72";"42537"
"8";"3";"5";"9";"72";"42538"
"7";"1";"6";"9";"72";"42541"
"1";"0";"1";"9";"72";"42542"
"1";"1";"0";"9";"72";"42543"
"8";"1";"7";"9";"72";"42546"
"7";"3";"4";"9";"72";"42550"
"3";"0";"3";"9";"72";"42558"
"8";"2";"6";"9";"72";"42560"
"5";"1";"4";"9";"72";"42570"
"2";"0";"2";"9";"72";"42573"
"3";"1";"2";"9";"72";"42574"
"1";"0";"1";"9";"72";"42576"
"9";"1";"8";"9";"72";"42581"
"5";"1";"4";"9";"72";"42583"
"4";"1";"3";"9";"72";"42586"
"1";"0";"1";"9";"72";"42591"
"1";"1";"0";"9";"72";"42595"
"12";"5";"7";"9";"72";"42596"
"2";"1";"1";"9";"72";"42599"
"2";"0";"2";"9";"72";"42613"
"5";"2";"3";"9";"72";"42614"
"4";"1";"3";"9";"72";"42617"
"6";"1";"5";"9";"72";"42620"
"4";"0";"4";"9";"72";"42621"
"1";"0";"1";"9";"72";"42624"
"4";"0";"4";"9";"72";"42625"
"7";"1";"6";"9";"72";"42630"
"4";"0";"4";"9";"72";"42634"
"1";"0";"1";"9";"72";"42635"
"2";"0";"2";"9";"72";"42637"
"2";"1";"1";"9";"72";"42638"
"5";"2";"3";"9";"72";"42641"
"3";"0";"3";"9";"72";"42642"
"6";"2";"4";"9";"72";"42644"
"4";"0";"4";"9";"72";"42646"
"1";"0";"1";"9";"72";"42648"
"2";"0";"2";"9";"72";"42649"
"2";"1";"1";"9";"72";"42651"
"5";"1";"4";"9";"72";"42656"
"1";"1";"0";"9";"72";"42657"
"7";"2";"5";"9";"72";"42658"
"1";"0";"1";"9";"72";"42665"
"7";"4";"3";"9";"72";"42670"
"2";"1";"1";"9";"72";"42675"
"1";"0";"1";"9";"72";"42679"
"3";"0";"3";"9";"72";"42680"
"14";"3";"11";"9";"72";"42681"
"8";"2";"6";"9";"72";"42682"
"2";"1";"1";"9";"72";"42690"
"4";"2";"2";"9";"72";"42693"
"13";"6";"7";"9";"72";"42704"
"2";"0";"2";"9";"72";"42709"
"1";"0";"1";"9";"72";"42715"
"6";"1";"5";"9";"72";"42718"
"7";"1";"6";"9";"72";"42720"
"1";"1";"0";"9";"72";"42723"
"5";"2";"3";"9";"72";"42725"
"1";"0";"1";"9";"72";"42726"
"7";"6";"1";"9";"72";"42727"
"3";"0";"3";"9";"72";"42730"
"5";"1";"4";"9";"72";"42731"
"6";"3";"3";"9";"72";"42738"
"1";"0";"1";"9";"72";"42739"
"7";"2";"5";"9";"72";"42740"
"2";"0";"2";"9";"72";"42742"
"6";"2";"4";"9";"72";"42747"
"4";"2";"2";"9";"72";"42751"
"7";"0";"7";"9";"72";"42752"
"1";"0";"1";"9";"72";"42759"
"5";"1";"4";"9";"72";"42761"
"3";"0";"3";"9";"72";"42762"
"5";"2";"3";"9";"72";"42765"
"3";"0";"3";"9";"72";"42778"
"1";"1";"0";"9";"72";"42784"
"10";"2";"8";"9";"72";"42785"
"5";"1";"4";"9";"72";"42789"
"2";"1";"1";"9";"72";"42793"
"1";"0";"1";"9";"72";"42794"
"1";"0";"1";"9";"72";"42798"
"4";"1";"3";"9";"72";"42799"
"7";"3";"4";"9";"72";"42803"
"2";"1";"1";"9";"72";"42804"
"1";"1";"0";"9";"72";"42805"
"9";"4";"5";"9";"72";"42806"
"3";"1";"2";"9";"72";"42812"
"3";"1";"2";"9";"72";"42818"
"4";"0";"4";"9";"72";"42822"
"1";"1";"0";"9";"72";"42823"
"1";"0";"1";"9";"72";"42824"
"6";"1";"5";"9";"72";"42825"
"4";"1";"3";"9";"72";"42826"
"13";"2";"11";"9";"72";"42830"
"3";"1";"2";"9";"72";"42835"
"2";"0";"2";"9";"72";"42842"
"2";"1";"1";"9";"72";"42844"
"3";"1";"2";"9";"72";"42845"
"2";"0";"2";"9";"72";"42846"
"3";"1";"2";"9";"72";"42855"
"2";"0";"2";"9";"72";"42856"
"2";"1";"1";"9";"72";"42858"
"3";"1";"2";"9";"72";"42859"
"17";"7";"10";"9";"72";"42860"
"2";"0";"2";"9";"72";"42861"
"1";"1";"0";"9";"72";"42864"
"11";"8";"3";"9";"72";"42865"
"2";"0";"2";"9";"72";"42867"
"11";"4";"7";"9";"72";"42868"
"1";"0";"1";"9";"72";"42870"
"3";"2";"1";"9";"72";"42874"
"1";"0";"1";"9";"72";"42878"
"6";"1";"5";"9";"72";"42879"
"2";"0";"2";"9";"72";"42883"
"13";"10";"3";"9";"72";"42884"
"4";"1";"3";"9";"72";"42893"
"1";"1";"0";"9";"72";"42896"
"2";"1";"1";"9";"72";"42897"
"3";"1";"2";"9";"72";"42899"
"2";"2";"0";"9";"72";"42905"
"6";"1";"5";"9";"72";"42906"
"4";"1";"3";"9";"72";"42907"
"11";"3";"8";"9";"72";"42908"
"24";"10";"14";"9";"72";"42910"
"6";"2";"4";"9";"72";"42912"
"1";"0";"1";"9";"72";"42915"
"1";"1";"0";"9";"72";"42916"
"4";"1";"3";"9";"72";"42919"
"1";"0";"1";"9";"72";"42923"
"5";"0";"5";"9";"72";"42924"
"6";"1";"5";"9";"72";"42925"
"1";"0";"1";"9";"72";"42936"
"1";"1";"0";"9";"72";"42937"
"10";"2";"8";"9";"72";"42939"
"1";"1";"0";"9";"72";"42943"
"3";"1";"2";"9";"72";"42944"
"27";"9";"18";"9";"72";"42946"
"5";"1";"4";"9";"72";"42949"
"1";"1";"0";"9";"72";"42952"
"4";"0";"4";"9";"72";"42954"
"19";"14";"5";"9";"72";"42956"
"4";"3";"1";"9";"72";"42958"
"6";"0";"6";"9";"72";"42963"
"1";"1";"0";"9";"72";"42967"
"2";"1";"1";"9";"72";"42969"
"7";"3";"4";"9";"72";"42972"
"2";"0";"2";"9";"72";"42974"
"9";"3";"6";"9";"72";"42975"
"29";"16";"13";"9";"72";"42978"
"1";"0";"1";"9";"72";"42981"
"6";"2";"4";"9";"72";"42982"
"1";"1";"0";"9";"72";"42983"
"5";"1";"4";"9";"72";"42984"
"4";"0";"4";"9";"72";"42985"
"3";"0";"3";"9";"72";"42986"
"4";"1";"3";"9";"72";"42988"
"5";"0";"5";"9";"72";"42989"
"2";"0";"2";"9";"72";"42990"
"1";"0";"1";"9";"72";"42992"
"4";"1";"3";"9";"72";"42993"
"7";"1";"6";"9";"72";"42994"
"8";"2";"6";"9";"72";"42996"
"59";"40";"19";"9";"72";"42998"
"2";"1";"1";"9";"72";"42999"
"5";"2";"3";"9";"72";"43000"
"34";"13";"21";"9";"72";"43001"
"2";"0";"2";"9";"72";"43002"
"2";"1";"1";"9";"72";"43005"
"4";"1";"3";"9";"72";"43007"
"3";"1";"2";"9";"72";"43010"
"33";"24";"9";"9";"72";"43012"
"3";"1";"2";"9";"72";"43014"
"2";"0";"2";"9";"72";"43015"
"9";"3";"6";"9";"72";"43016"
"2";"1";"1";"9";"72";"43022"
"2";"1";"1";"9";"72";"43024"
"2";"1";"1";"9";"72";"43025"
"3";"1";"2";"9";"72";"43026"
"1";"0";"1";"9";"72";"43027"
"11";"1";"10";"9";"72";"43028"
"1";"1";"0";"9";"72";"43029"
"2";"2";"0";"9";"72";"43030"
"1";"0";"1";"9";"72";"43032"
"3";"0";"3";"9";"72";"43038"
"12";"2";"10";"9";"72";"43041"
"1";"1";"0";"9";"72";"43042"
"4";"0";"4";"9";"72";"43060"
"9";"1";"8";"9";"72";"43061"
"4";"0";"4";"9";"72";"43062"
"25";"4";"21";"9";"72";"43063"
"1";"0";"1";"9";"72";"43064"
"18";"11";"7";"9";"72";"43066"
"5";"1";"4";"9";"72";"43067"
"6";"2";"4";"9";"72";"43068"
"2";"0";"2";"9";"72";"43077"
"25";"5";"20";"9";"72";"43078"
"2";"1";"1";"9";"72";"43081"
"4";"1";"3";"9";"72";"43085"
"41";"18";"23";"9";"72";"43090"
"1";"0";"1";"9";"72";"43091"
"5";"3";"2";"9";"72";"43092"
"3";"0";"3";"9";"72";"43093"
"1";"1";"0";"9";"72";"43096"
"1";"0";"1";"9";"72";"43100"
"1";"1";"0";"9";"72";"43104"
"14";"3";"11";"9";"72";"43107"
"6";"1";"5";"9";"72";"43110"
"2";"0";"2";"9";"72";"43111"
"12";"5";"7";"9";"72";"43113"
"2";"0";"2";"9";"72";"43114"
"8";"2";"6";"9";"72";"43115"
"6";"2";"4";"9";"72";"43118"
"4";"0";"4";"9";"72";"43119"
"3";"1";"2";"9";"72";"43123"
"4";"1";"3";"9";"72";"43128"
"1";"0";"1";"9";"72";"43130"
"10";"3";"7";"9";"72";"43135"
"2";"1";"1";"9";"72";"43136"
"4";"1";"3";"9";"72";"43137"
"5";"2";"3";"9";"72";"43138"
"5";"2";"3";"9";"72";"43139"
"18";"7";"11";"9";"72";"43141"
"2";"0";"2";"9";"72";"43147"
"4";"1";"3";"9";"72";"43150"
"2";"0";"2";"9";"72";"43155"
"4";"1";"3";"9";"72";"43156"
"4";"2";"2";"9";"72";"43157"
"1";"0";"1";"9";"72";"43158"
"6";"2";"4";"9";"72";"43162"
"2";"0";"2";"9";"72";"43163"
"6";"0";"6";"9";"72";"43171"
"3";"0";"3";"9";"72";"43174"
"7";"2";"5";"9";"72";"43175"
"4";"1";"3";"9";"72";"43177"
"3";"0";"3";"9";"72";"43179"
"9";"2";"7";"9";"72";"43180"
"5";"1";"4";"9";"72";"43185"
"16";"2";"14";"9";"72";"43189"
"1";"0";"1";"9";"72";"43192"
"2";"2";"0";"9";"72";"43194"
"5";"2";"3";"9";"72";"43195"
"11";"5";"6";"9";"72";"43199"
"6";"2";"4";"9";"72";"43200"
"1";"1";"0";"9";"72";"43204"
"7";"4";"3";"9";"72";"43205"
"1";"1";"0";"9";"72";"43215"
"11";"3";"8";"9";"72";"43217"
"1";"1";"0";"9";"72";"43218"
"1";"1";"0";"9";"72";"43219"
"2";"0";"2";"9";"72";"43221"
"8";"2";"6";"9";"72";"43228"
"3";"1";"2";"9";"72";"43231"
"21";"3";"18";"9";"72";"43235"
"9";"1";"8";"9";"72";"43236"
"2";"2";"0";"9";"72";"43240"
"1";"0";"1";"9";"72";"43241"
"3";"0";"3";"9";"72";"43243"
"3";"0";"3";"9";"72";"43246"
"1";"0";"1";"9";"72";"43249"
"2";"2";"0";"9";"72";"43252"
"2";"0";"2";"9";"72";"43260"
"3";"2";"1";"9";"72";"43263"
"6";"3";"3";"9";"72";"43268"
"11";"4";"7";"9";"72";"43272"
"4";"0";"4";"9";"72";"43274"
"3";"1";"2";"9";"72";"43279"
"2";"1";"1";"9";"72";"43280"
"3";"0";"3";"9";"72";"43282"
"7";"1";"6";"9";"72";"43293"
"2";"2";"0";"9";"72";"43294"
"1";"1";"0";"9";"72";"43302"
"5";"2";"3";"9";"72";"43305"
"2";"1";"1";"9";"72";"43307"
"7";"3";"4";"9";"72";"43308"
"2";"1";"1";"9";"72";"43310"
"1";"1";"0";"9";"72";"43313"
"3";"1";"2";"9";"72";"43316"
"1";"1";"0";"9";"72";"43317"
"3";"0";"3";"9";"72";"43320"
"9";"0";"9";"9";"72";"43322"
"13";"3";"10";"9";"72";"43323"
"3";"1";"2";"9";"72";"43334"
"2";"1";"1";"9";"72";"43337"
"2";"2";"0";"9";"72";"43338"
"1";"1";"0";"9";"72";"43346"
"1";"0";"1";"9";"72";"43347"
"9";"4";"5";"9";"72";"43350"
"6";"2";"4";"9";"72";"43351"
"4";"1";"3";"9";"72";"43352"
"2";"0";"2";"9";"72";"43357"
"2";"1";"1";"9";"72";"43359"
"3";"0";"3";"9";"72";"43360"
"18";"8";"10";"9";"72";"43363"
"5";"0";"5";"9";"72";"43364"
"4";"1";"3";"9";"72";"43365"
"2";"0";"2";"9";"72";"43366"
"1";"0";"1";"9";"72";"43368"
"5";"2";"3";"9";"72";"43369"
"4";"0";"4";"9";"72";"43370"
"34";"26";"8";"9";"72";"43373"
"3";"0";"3";"9";"72";"43377"
"7";"2";"5";"9";"72";"43379"
"4";"1";"3";"9";"72";"43381"
"5";"0";"5";"9";"72";"43388"
"1";"1";"0";"9";"72";"43389"
"1";"1";"0";"9";"72";"43390"
"7";"3";"4";"9";"72";"43396"
"5";"1";"4";"9";"72";"43400"
"4";"1";"3";"9";"72";"43404"
"4";"1";"3";"9";"72";"43408"
"417";"370";"47";"9";"72";"43409"
"2";"1";"1";"9";"72";"43411"
"7";"3";"4";"9";"72";"43413"
"15";"1";"14";"9";"72";"43414"
"5";"0";"5";"9";"72";"43422"
"9";"2";"7";"9";"72";"43423"
"5";"2";"3";"9";"72";"43425"
"6";"2";"4";"9";"72";"43428"
"3";"1";"2";"9";"72";"43435"
"1";"1";"0";"9";"72";"43440"
"1";"0";"1";"9";"72";"43444"
"1";"1";"0";"9";"72";"43445"
"4";"1";"3";"9";"72";"43446"
"13";"1";"12";"9";"72";"43450"
"2";"0";"2";"9";"72";"43453"
"6";"2";"4";"9";"72";"43459"
"3";"0";"3";"9";"72";"43462"
"1";"0";"1";"9";"72";"43466"
"4";"1";"3";"9";"72";"43467"
"32";"23";"9";"9";"72";"43470"
"3";"0";"3";"9";"72";"43473"
"3";"1";"2";"9";"72";"43476"
"2";"0";"2";"9";"72";"43477"
"5";"0";"5";"9";"72";"43479"
"1";"0";"1";"9";"72";"43486"
"7";"1";"6";"9";"72";"43487"
"13";"1";"12";"9";"72";"43492"
"3";"0";"3";"9";"72";"43498"
"6";"3";"3";"9";"72";"43499"
"11";"3";"8";"9";"72";"43500"
"7";"1";"6";"9";"72";"43502"
"16";"13";"3";"9";"72";"43504"
"11";"3";"8";"9";"72";"43514"
"2";"1";"1";"9";"72";"43517"
"5";"1";"4";"9";"72";"43518"
"7";"1";"6";"9";"72";"43521"
"5";"3";"2";"9";"72";"43528"
"5";"1";"4";"9";"72";"43532"
"10";"2";"8";"9";"72";"43533"
"1";"0";"1";"9";"72";"43534"
"19";"10";"9";"9";"72";"43536"
"7";"3";"4";"9";"72";"43537"
"2";"1";"1";"9";"72";"43550"
"1";"1";"0";"9";"72";"43556"
"1";"0";"1";"9";"72";"43560"
"8";"3";"5";"9";"72";"43561"
"2";"0";"2";"9";"72";"43567"
"2";"0";"2";"9";"72";"43574"
"2";"0";"2";"9";"72";"43577"
"2";"1";"1";"9";"72";"43579"
"2";"1";"1";"9";"72";"43586"
"20";"6";"14";"9";"72";"43593"
"7";"2";"5";"9";"72";"43594"
"4";"1";"3";"9";"72";"43598"
"4";"1";"3";"9";"72";"43599"
"2";"0";"2";"9";"72";"43601"
"3";"1";"2";"9";"72";"43602"
"5";"2";"3";"9";"72";"43604"
"17";"3";"14";"9";"72";"43605"
"29";"8";"21";"9";"72";"43615"
"10";"3";"7";"9";"72";"43616"
"7";"1";"6";"9";"72";"43617"
"2";"0";"2";"9";"72";"43618"
"6";"2";"4";"9";"72";"43621"
"10";"3";"7";"9";"72";"43624"
"2";"1";"1";"9";"72";"43627"
"4";"1";"3";"9";"72";"43633"
"5";"1";"4";"9";"72";"43637"
"3";"0";"3";"9";"72";"43638"
"6";"2";"4";"9";"72";"43639"
"5";"1";"4";"9";"72";"43640"
"7";"0";"7";"9";"72";"43641"
"1";"1";"0";"9";"72";"43642"
"2";"1";"1";"9";"72";"43645"
"1";"0";"1";"9";"72";"43646"
"8";"3";"5";"9";"72";"43650"
"2";"1";"1";"9";"72";"43652"
"5";"2";"3";"9";"72";"43654"
"1";"1";"0";"9";"72";"43656"
"2";"0";"2";"9";"72";"43660"
"2";"1";"1";"9";"72";"43661"
"17";"12";"5";"9";"72";"43662"
"15";"11";"4";"9";"72";"43664"
"2";"0";"2";"9";"72";"43665"
"17";"3";"14";"9";"72";"43678"
"2";"1";"1";"9";"72";"43683"
"9";"2";"7";"9";"72";"43684"
"6";"2";"4";"9";"72";"43686"
"1";"0";"1";"9";"72";"43690"
"1";"1";"0";"9";"72";"43692"
"6";"4";"2";"9";"72";"43699"
"2";"0";"2";"9";"72";"43702"
"3";"0";"3";"9";"72";"43703"
"8";"1";"7";"9";"72";"43704"
"1";"0";"1";"9";"72";"43708"
"4";"1";"3";"9";"72";"43709"
"2";"1";"1";"9";"72";"43712"
"5";"0";"5";"9";"72";"43713"
"11";"6";"5";"9";"72";"43718"
"1";"0";"1";"9";"72";"43721"
"1";"0";"1";"9";"72";"43722"
"1";"1";"0";"9";"72";"43726"
"5";"1";"4";"9";"72";"43729"
"4";"1";"3";"9";"72";"43732"
"4";"1";"3";"9";"72";"43733"
"4";"1";"3";"9";"72";"43735"
"2";"1";"1";"9";"72";"43738"
"2";"0";"2";"9";"72";"43739"
"3";"1";"2";"9";"72";"43746"
"6";"2";"4";"9";"72";"43755"
"6";"2";"4";"9";"72";"43760"
"8";"3";"5";"9";"72";"43765"
"1";"1";"0";"9";"72";"43766"
"10";"2";"8";"9";"72";"43767"
"11";"6";"5";"9";"72";"43773"
"2";"1";"1";"9";"72";"43774"
"4";"1";"3";"9";"72";"43777"
"1";"1";"0";"9";"72";"43779"
"1";"1";"0";"9";"72";"43781"
"1";"1";"0";"9";"72";"43782"
"5";"3";"2";"9";"72";"43787"
"6";"3";"3";"9";"72";"43789"
"1";"1";"0";"9";"72";"43794"
"2";"1";"1";"9";"72";"43795"
"1";"1";"0";"9";"72";"43798"
"7";"1";"6";"9";"72";"43801"
"7";"2";"5";"9";"72";"43803"
"2";"0";"2";"9";"72";"43812"
"3";"1";"2";"9";"72";"43813"
"3";"0";"3";"9";"72";"43820"
"2";"1";"1";"9";"72";"43827"
"6";"1";"5";"9";"72";"43834"
"9";"1";"8";"9";"72";"43835"
"2";"1";"1";"9";"72";"43837"
"2";"0";"2";"9";"72";"43842"
"3";"0";"3";"9";"72";"43845"
"5";"3";"2";"9";"72";"43846"
"1";"1";"0";"9";"72";"43850"
"4";"0";"4";"9";"72";"43852"
"5";"1";"4";"9";"72";"43854"
"2";"0";"2";"9";"72";"43855"
"1";"0";"1";"9";"72";"43858"
"8";"5";"3";"9";"72";"43860"
"6";"2";"4";"9";"72";"43861"
"4";"2";"2";"9";"72";"43864"
"1";"1";"0";"9";"72";"43867"
"3";"1";"2";"9";"72";"43868"
"4";"0";"4";"9";"72";"43870"
"2";"1";"1";"9";"72";"43871"
"1";"1";"0";"9";"72";"43874"
"14";"2";"12";"9";"72";"43875"
"3";"1";"2";"9";"72";"43876"
"7";"0";"7";"9";"72";"43879"
"4";"1";"3";"9";"72";"43881"
"3";"0";"3";"9";"72";"43884"
"1";"0";"1";"9";"72";"43886"
"2";"0";"2";"9";"72";"43891"
"7";"2";"5";"9";"72";"43892"
"6";"2";"4";"9";"72";"43894"
"1";"1";"0";"9";"72";"43896"
"11";"3";"8";"9";"72";"43901"
"4";"2";"2";"9";"72";"43902"
"7";"3";"4";"9";"72";"43904"
"12";"2";"10";"9";"72";"43905"
"3";"0";"3";"9";"72";"43906"
"2";"0";"2";"9";"72";"43907"
"3";"1";"2";"9";"72";"43909"
"4";"1";"3";"9";"72";"43910"
"2";"0";"2";"9";"72";"43913"
"9";"2";"7";"9";"72";"43914"
"2";"1";"1";"9";"72";"43915"
"3";"1";"2";"9";"72";"43917"
"4";"1";"3";"9";"72";"43918"
"1";"1";"0";"9";"72";"43922"
"4";"2";"2";"9";"72";"43924"
"1";"0";"1";"9";"72";"43926"
"1";"0";"1";"9";"72";"43928"
"1";"1";"0";"9";"72";"43930"
"7";"1";"6";"9";"72";"43931"
"4";"1";"3";"9";"72";"43934"
"2";"1";"1";"9";"72";"43935"
"3";"1";"2";"9";"72";"43937"
"1";"1";"0";"9";"72";"43939"
"5";"1";"4";"9";"72";"43941"
"2";"1";"1";"9";"72";"43943"
"1";"0";"1";"9";"72";"43945"
"2";"1";"1";"9";"72";"43947"
"5";"1";"4";"9";"72";"43948"
"2";"0";"2";"9";"72";"43951"
"7";"0";"7";"9";"72";"43952"
"4";"1";"3";"9";"72";"43955"
"5";"1";"4";"9";"72";"43959"
"1";"0";"1";"9";"72";"43964"
"1";"1";"0";"9";"72";"43965"
"6";"1";"5";"9";"72";"43973"
"1";"1";"0";"9";"72";"43975"
"5";"3";"2";"9";"72";"43981"
"4";"2";"2";"9";"72";"43985"
"12";"10";"2";"9";"72";"43986"
"7";"1";"6";"9";"72";"43988"
"2";"2";"0";"9";"72";"43989"
"3";"0";"3";"9";"72";"43990"
"4";"0";"4";"9";"72";"43991"
"4";"0";"4";"9";"72";"44000"
"6";"1";"5";"9";"72";"44003"
"1";"0";"1";"9";"72";"44005"
"5";"1";"4";"9";"72";"44009"
"12";"1";"11";"9";"72";"44011"
"3";"1";"2";"9";"72";"44012"
"3";"1";"2";"9";"72";"44013"
"1";"1";"0";"9";"72";"44015"
"1";"1";"0";"9";"72";"44017"
"2";"0";"2";"9";"72";"44021"
"3";"1";"2";"9";"72";"44022"
"4";"1";"3";"9";"72";"44025"
"4";"1";"3";"9";"72";"44026"
"2";"2";"0";"9";"72";"44027"
"2";"1";"1";"9";"72";"44030"
"11";"3";"8";"9";"72";"44032"
"2";"0";"2";"9";"72";"44033"
"5";"2";"3";"9";"72";"44035"
"2";"1";"1";"9";"72";"44037"
"4";"2";"2";"9";"72";"44039"
"2";"1";"1";"9";"72";"44041"
"3";"2";"1";"9";"72";"44042"
"5";"1";"4";"9";"72";"44044"
"2";"1";"1";"9";"72";"44045"
"1";"1";"0";"9";"72";"44047"
"1";"0";"1";"9";"72";"44052"
"5";"2";"3";"9";"72";"44057"
"2";"0";"2";"9";"72";"44065"
"5";"1";"4";"9";"72";"44070"
"16";"11";"5";"9";"72";"44071"
"27";"3";"24";"9";"72";"44072"
"6";"2";"4";"9";"72";"44081"
"16";"7";"9";"9";"72";"44087"
"3";"1";"2";"9";"72";"44090"
"3";"0";"3";"9";"72";"44097"
"3";"0";"3";"9";"72";"44099"
"6";"2";"4";"9";"72";"44107"
"2";"0";"2";"9";"72";"44110"
"4";"2";"2";"9";"72";"44113"
"109";"83";"26";"9";"72";"44117"
"23";"3";"20";"9";"72";"44126"
"14";"7";"7";"9";"72";"44129"
"8";"2";"6";"9";"72";"44133"
"1";"0";"1";"9";"72";"44134"
"5";"2";"3";"9";"72";"44141"
"2";"1";"1";"9";"72";"44144"
"3";"2";"1";"9";"72";"44146"
"23";"20";"3";"9";"72";"44147"
"2";"0";"2";"9";"72";"44150"
"2";"1";"1";"9";"72";"44152"
"8";"2";"6";"9";"72";"44153"
"7";"1";"6";"9";"72";"44154"
"1";"0";"1";"9";"72";"44156"
"3";"0";"3";"9";"72";"44157"
"3";"0";"3";"9";"72";"44162"
"3";"2";"1";"9";"72";"44164"
"4";"1";"3";"9";"72";"44166"
"4";"1";"3";"9";"72";"44170"
"1";"0";"1";"9";"72";"44173"
"4";"2";"2";"9";"72";"44177"
"1";"0";"1";"9";"72";"44178"
"5";"2";"3";"9";"72";"44180"
"29";"23";"6";"9";"72";"44181"
"5";"2";"3";"9";"72";"44183"
"2";"1";"1";"9";"72";"44184"
"4";"0";"4";"9";"72";"44185"
"5";"2";"3";"9";"72";"44188"
"1";"1";"0";"9";"72";"44190"
"8";"3";"5";"9";"72";"44191"
"3";"1";"2";"9";"72";"44195"
"8";"2";"6";"9";"72";"44199"
"2";"0";"2";"9";"72";"44200"
"1";"0";"1";"9";"72";"44202"
"2";"0";"2";"9";"72";"44206"
"2";"1";"1";"9";"72";"44208"
"6";"3";"3";"9";"72";"44209"
"2";"1";"1";"9";"72";"44210"
"4";"1";"3";"9";"72";"44211"
"4";"1";"3";"9";"72";"44212"
"3";"0";"3";"9";"72";"44213"
"3";"1";"2";"9";"72";"44215"
"2";"0";"2";"9";"72";"44221"
"3";"1";"2";"9";"72";"44225"
"3";"1";"2";"9";"72";"44226"
"3";"0";"3";"9";"72";"44236"
"3";"1";"2";"9";"72";"44246"
"8";"0";"8";"9";"72";"44247"
"17";"2";"15";"9";"72";"44250"
"2";"0";"2";"9";"72";"44251"
"4";"1";"3";"9";"72";"44253"
"9";"2";"7";"9";"72";"44255"
"4";"1";"3";"9";"72";"44256"
"6";"2";"4";"9";"72";"44259"
"7";"2";"5";"9";"72";"44260"
"3";"1";"2";"9";"72";"44261"
"2";"0";"2";"9";"72";"44262"
"5";"1";"4";"9";"72";"44268"
"2";"0";"2";"9";"72";"44269"
"4";"0";"4";"9";"72";"44279"
"7";"2";"5";"9";"72";"44283"
"4";"1";"3";"9";"72";"44287"
"18";"6";"12";"9";"72";"44288"
"4";"1";"3";"9";"72";"44290"
"4";"1";"3";"9";"72";"44291"
"3";"1";"2";"9";"72";"44293"
"2";"1";"1";"9";"72";"44294"
"1";"0";"1";"9";"72";"44305"
"4";"1";"3";"9";"72";"44307"
"9";"3";"6";"9";"72";"44314"
"10";"2";"8";"9";"72";"44315"
"1";"0";"1";"9";"72";"44318"
"8";"2";"6";"9";"72";"44320"
"3";"0";"3";"9";"72";"44322"
"20";"16";"4";"9";"72";"44324"
"1";"1";"0";"9";"72";"44325"
"1";"1";"0";"9";"72";"44327"
"1";"0";"1";"9";"72";"44328"
"2";"2";"0";"9";"72";"44330"
"1";"1";"0";"9";"72";"44336"
"2";"0";"2";"9";"72";"44339"
"1";"1";"0";"9";"72";"44344"
"7";"3";"4";"9";"72";"44348"
"2";"0";"2";"9";"72";"44352"
"2";"0";"2";"9";"72";"44353"
"1";"0";"1";"9";"72";"44355"
"4";"0";"4";"9";"72";"44357"
"1";"1";"0";"9";"72";"44358"
"4";"1";"3";"9";"72";"44367"
"3";"1";"2";"9";"72";"44369"
"6";"2";"4";"9";"72";"44371"
"6";"4";"2";"9";"72";"44372"
"5";"1";"4";"9";"72";"44374"
"1";"0";"1";"9";"72";"44376"
"8";"2";"6";"9";"72";"44378"
"6";"2";"4";"9";"72";"44380"
"3";"3";"0";"9";"72";"44381"
"9";"3";"6";"9";"72";"44382"
"6";"1";"5";"9";"72";"44384"
"3";"1";"2";"9";"72";"44387"
"3";"1";"2";"9";"72";"44395"
"4";"0";"4";"9";"72";"44397"
"6";"2";"4";"9";"72";"44404"
"6";"0";"6";"9";"72";"44405"
"55";"43";"12";"9";"72";"44409"
"1";"0";"1";"9";"72";"44413"
"2";"0";"2";"9";"72";"44418"
"14";"6";"8";"9";"72";"44419"
"4";"1";"3";"9";"72";"44421"
"2";"0";"2";"9";"72";"44425"
"9";"2";"7";"9";"72";"44427"
"9";"6";"3";"9";"72";"44430"
"15";"10";"5";"9";"72";"44431"
"6";"1";"5";"9";"72";"44433"
"2";"0";"2";"9";"72";"44443"
"6";"4";"2";"9";"72";"44445"
"2";"0";"2";"9";"72";"44449"
"2";"1";"1";"9";"72";"44450"
"2";"1";"1";"9";"72";"44454"
"5";"2";"3";"9";"72";"44461"
"3";"0";"3";"9";"72";"44462"
"7";"2";"5";"9";"72";"44465"
"10";"6";"4";"9";"72";"44468"
"1";"1";"0";"9";"72";"44474"
"5";"2";"3";"9";"72";"44475"
"5";"2";"3";"9";"72";"44478"
"5";"0";"5";"9";"72";"44479"
"8";"3";"5";"9";"72";"44484"
"1";"1";"0";"9";"72";"44485"
"5";"1";"4";"9";"72";"44486"
"1";"1";"0";"9";"72";"44487"
"1";"0";"1";"9";"72";"44491"
"378";"313";"65";"9";"72";"44492"
"3";"1";"2";"9";"72";"44496"
"3";"0";"3";"9";"72";"44497"
"2";"0";"2";"9";"72";"44498"
"2";"2";"0";"9";"72";"44500"
"5";"2";"3";"9";"72";"44502"
"5";"1";"4";"9";"72";"44505"
"5";"1";"4";"9";"72";"44507"
"2";"0";"2";"9";"72";"44508"
"10";"1";"9";"9";"72";"44510"
"2";"1";"1";"9";"72";"44512"
"7";"3";"4";"9";"72";"44513"
"7";"2";"5";"9";"72";"44515"
"15";"5";"10";"9";"72";"44519"
"1";"1";"0";"9";"72";"44521"
"1";"1";"0";"9";"72";"44523"
"7";"2";"5";"9";"72";"44524"
"4";"2";"2";"9";"72";"44526"
"17";"4";"13";"9";"72";"44531"
"3";"1";"2";"9";"72";"44534"
"3";"3";"0";"9";"72";"44536"
"5";"2";"3";"9";"72";"44539"
"6";"1";"5";"9";"72";"44541"
"3";"1";"2";"9";"72";"44542"
"1";"1";"0";"9";"72";"44543"
"2";"0";"2";"9";"72";"44549"
"10";"5";"5";"9";"72";"44554"
"5";"1";"4";"9";"72";"44559"
"3";"0";"3";"9";"72";"44560"
"6";"2";"4";"9";"72";"44563"
"3";"0";"3";"9";"72";"44564"
"1";"0";"1";"9";"72";"44569"
"1";"1";"0";"9";"72";"44570"
"4";"1";"3";"9";"72";"44571"
"5";"1";"4";"9";"72";"44573"
"7";"5";"2";"9";"72";"44577"
"3";"0";"3";"9";"72";"44578"
"7";"2";"5";"9";"72";"44587"
"1";"1";"0";"9";"72";"44594"
"9";"1";"8";"9";"72";"44596"
"4";"1";"3";"9";"72";"44600"
"1";"0";"1";"9";"72";"44602"
"2";"0";"2";"9";"72";"44604"
"4";"1";"3";"9";"72";"44607"
"18";"16";"2";"9";"72";"44610"
"4";"0";"4";"9";"72";"44614"
"4";"1";"3";"9";"72";"44620"
"1";"1";"0";"9";"72";"44621"
"2";"0";"2";"9";"72";"44623"
"4";"1";"3";"9";"72";"44625"
"27";"17";"10";"9";"72";"44627"
"2";"0";"2";"9";"72";"44629"
"1";"0";"1";"9";"72";"44631"
"6";"1";"5";"9";"72";"44632"
"4";"0";"4";"9";"72";"44633"
"6";"2";"4";"9";"72";"44640"
"2";"0";"2";"9";"72";"44641"
"4";"1";"3";"9";"72";"44643"
"1";"0";"1";"9";"72";"44644"
"34";"28";"6";"9";"72";"44647"
"2";"1";"1";"9";"72";"44648"
"5";"0";"5";"9";"72";"44650"
"1";"1";"0";"9";"72";"44651"
"17";"12";"5";"9";"72";"44653"
"8";"1";"7";"9";"72";"44657"
"3";"0";"3";"9";"72";"44664"
"1";"0";"1";"9";"72";"44666"
"7";"1";"6";"9";"72";"44670"
"1";"1";"0";"9";"72";"44676"
"2";"0";"2";"9";"72";"44683"
"10";"4";"6";"9";"72";"44688"
"2";"1";"1";"9";"72";"44690"
"1";"0";"1";"9";"72";"44693"
"1";"0";"1";"9";"72";"44702"
"2";"0";"2";"9";"72";"44705"
"2";"1";"1";"9";"72";"44706"
"6";"2";"4";"9";"72";"44707"
"17";"3";"14";"9";"72";"44730"
"3";"2";"1";"9";"72";"44734"
"7";"1";"6";"9";"72";"44738"
"7";"2";"5";"9";"72";"44745"
"1";"0";"1";"9";"72";"44746"
"3";"0";"3";"9";"72";"44751"
"7";"2";"5";"9";"72";"44759"
"3";"0";"3";"9";"72";"44762"
"1";"1";"0";"9";"72";"44772"
"5";"1";"4";"9";"72";"44775"
"5";"0";"5";"9";"72";"44780"
"2";"1";"1";"9";"72";"44782"
"2";"0";"2";"9";"72";"44786"
"8";"1";"7";"9";"72";"44787"
"5";"1";"4";"9";"72";"44795"
"4";"2";"2";"9";"72";"44796"
"4";"1";"3";"9";"72";"44808"
"18";"3";"15";"9";"72";"44809"
"3";"1";"2";"9";"72";"44810"
"4";"1";"3";"9";"72";"44811"
"5";"2";"3";"9";"72";"44822"
"2";"0";"2";"9";"72";"44823"
"3";"0";"3";"9";"72";"44828"
"3";"1";"2";"9";"72";"44832"
"1";"0";"1";"9";"72";"44845"
"5";"1";"4";"9";"72";"44859"
"15";"1";"14";"9";"72";"44862"
"2";"0";"2";"9";"72";"44863"
"1";"1";"0";"9";"72";"44872"
"2";"0";"2";"9";"72";"44875"
"1";"1";"0";"9";"72";"44878"
"27";"12";"15";"9";"72";"44887"
"2";"1";"1";"9";"72";"44890"
"3";"0";"3";"9";"72";"44896"
"1";"0";"1";"9";"72";"44898"
"4";"0";"4";"9";"72";"44899"
"1";"0";"1";"9";"72";"44900"
"2";"0";"2";"9";"72";"44901"
"10";"2";"8";"9";"72";"44903"
"2";"1";"1";"9";"72";"44908"
"1";"1";"0";"9";"72";"44910"
"7";"3";"4";"9";"72";"44911"
"3";"0";"3";"9";"72";"44913"
"5";"2";"3";"9";"72";"44917"
"1";"1";"0";"9";"72";"44925"
"3";"1";"2";"9";"72";"44928"
"4";"1";"3";"9";"72";"44931"
"4";"2";"2";"9";"72";"44936"
"1";"0";"1";"9";"72";"44949"
"6";"0";"6";"9";"72";"44952"
"2";"0";"2";"9";"72";"44953"
"2";"1";"1";"9";"72";"44962"
"4";"1";"3";"9";"72";"44969"
"1";"0";"1";"9";"72";"44971"
"1";"0";"1";"9";"72";"44975"
"1";"1";"0";"9";"72";"44976"
"5";"1";"4";"9";"72";"44977"
"36";"16";"20";"9";"72";"44978"
"2";"0";"2";"9";"72";"44985"
"1";"1";"0";"9";"72";"44994"
"6";"1";"5";"9";"72";"44996"
"2";"0";"2";"9";"72";"45010"
"1";"0";"1";"9";"72";"45017"
"1";"1";"0";"9";"72";"45018"
"1";"1";"0";"9";"72";"45026"
"2";"1";"1";"9";"72";"45032"
"3";"2";"1";"9";"72";"45036"
"1";"0";"1";"9";"72";"45041"
"8";"6";"2";"9";"72";"45042"
"1";"1";"0";"9";"72";"45048"
"4";"0";"4";"9";"72";"45051"
"59";"44";"15";"9";"72";"45053"
"2";"1";"1";"9";"72";"45056"
"1";"1";"0";"9";"72";"45058"
"1";"1";"0";"9";"72";"45061"
"2";"0";"2";"9";"72";"45069"
"4";"1";"3";"9";"72";"45074"
"2";"2";"0";"9";"72";"45075"
"1";"1";"0";"9";"72";"45076"
"8";"6";"2";"9";"72";"45081"
"2";"1";"1";"9";"72";"45095"
"20";"13";"7";"9";"72";"45097"
"38";"25";"13";"9";"72";"45099"
"1";"0";"1";"9";"72";"45100"
"2";"0";"2";"9";"72";"45110"
"7";"1";"6";"9";"72";"45112"
"7";"2";"5";"9";"72";"45118"
"2";"0";"2";"9";"72";"45121"
"4";"1";"3";"9";"72";"45128"
"1";"0";"1";"9";"72";"45135"
"1";"1";"0";"9";"72";"45137"
"5";"1";"4";"9";"72";"45145"
"10";"1";"9";"9";"72";"45147"
"3";"3";"0";"9";"72";"45148"
"4";"1";"3";"9";"72";"45154"
"2";"1";"1";"9";"72";"45155"
"3";"1";"2";"9";"72";"45156"
"13";"0";"13";"9";"72";"45160"
"32";"12";"20";"9";"72";"45161"
"7";"0";"7";"9";"72";"45163"
"2";"1";"1";"9";"72";"45170"
"1";"0";"1";"9";"72";"45171"
"1";"1";"0";"9";"72";"45173"
"1";"0";"1";"9";"72";"45177"
"1";"0";"1";"9";"72";"45178"
"4";"1";"3";"9";"72";"45183"
"6";"2";"4";"9";"72";"45187"
"1";"0";"1";"9";"72";"45189"
"3";"0";"3";"9";"72";"45196"
"5";"1";"4";"9";"72";"45202"
"4";"0";"4";"9";"72";"45203"
"2";"1";"1";"9";"72";"45212"
"2";"0";"2";"9";"72";"45219"
"22";"7";"15";"9";"72";"45221"
"4";"1";"3";"9";"72";"45223"
"2";"1";"1";"9";"72";"45230"
"3";"0";"3";"9";"72";"45234"
"4";"1";"3";"9";"72";"45237"
"6";"0";"6";"9";"72";"45238"
"1";"0";"1";"9";"72";"45241"
"2";"0";"2";"9";"72";"45247"
"4";"1";"3";"9";"72";"45253"
"1";"0";"1";"9";"72";"45256"
"3";"0";"3";"9";"72";"45259"
"1";"0";"1";"9";"72";"45260"
"1";"1";"0";"9";"72";"45262"
"222";"186";"36";"9";"72";"45263"
"4";"2";"2";"9";"72";"45270"
"4";"0";"4";"9";"72";"45273"
"6";"3";"3";"9";"72";"45276"
"4";"1";"3";"9";"72";"45278"
"5";"2";"3";"9";"72";"45290"
"2";"0";"2";"9";"72";"45292"
"2";"0";"2";"9";"72";"45298"
"3";"0";"3";"9";"72";"45300"
"4";"0";"4";"9";"72";"45301"
"6";"0";"6";"9";"72";"45306"
"3";"2";"1";"9";"72";"45307"
"5";"2";"3";"9";"72";"45308"
"2";"1";"1";"9";"72";"45312"
"2";"1";"1";"9";"72";"45315"
"1";"1";"0";"9";"72";"45316"
"1";"0";"1";"9";"72";"45326"
"24";"4";"20";"9";"72";"45336"
"2";"1";"1";"9";"72";"45339"
"5";"1";"4";"9";"72";"45348"
"1";"0";"1";"9";"72";"45351"
"1";"1";"0";"9";"72";"45354"
"8";"3";"5";"9";"72";"45360"
"10";"5";"5";"9";"72";"45366"
"1";"0";"1";"9";"72";"45368"
"2";"0";"2";"9";"72";"45373"
"8";"2";"6";"9";"72";"45386"
"5";"2";"3";"9";"72";"45388"
"2";"0";"2";"9";"72";"45400"
"2";"0";"2";"9";"72";"45403"
"10";"3";"7";"9";"72";"45406"
"6";"1";"5";"9";"72";"45409"
"4";"0";"4";"9";"72";"45410"
"3";"0";"3";"9";"72";"45411"
"1";"1";"0";"9";"72";"45413"
"9";"4";"5";"9";"72";"45416"
"1";"1";"0";"9";"72";"45417"
"8";"2";"6";"9";"72";"45419"
"5";"0";"5";"9";"72";"45420"
"1";"0";"1";"9";"72";"45423"
"1";"0";"1";"9";"72";"45432"
"9";"2";"7";"9";"72";"45434"
"1";"0";"1";"9";"72";"45441"
"5";"1";"4";"9";"72";"45443"
"1";"0";"1";"9";"72";"45445"
"2";"1";"1";"9";"72";"45449"
"2";"1";"1";"9";"72";"45450"
"3";"2";"1";"9";"72";"45456"
"6";"0";"6";"9";"72";"45457"
"6";"1";"5";"9";"72";"45458"
"1";"0";"1";"9";"72";"45465"
"3";"1";"2";"9";"72";"45482"
"2";"0";"2";"9";"72";"45487"
"7";"2";"5";"9";"72";"45492"
"1";"1";"0";"9";"72";"45499"
"1";"0";"1";"9";"72";"45500"
"8";"3";"5";"9";"72";"45503"
"6";"1";"5";"9";"72";"45505"
"3";"1";"2";"9";"72";"45511"
"4";"2";"2";"9";"72";"45517"
"1";"0";"1";"9";"72";"45519"
"3";"2";"1";"9";"72";"45522"
"2";"0";"2";"9";"72";"45525"
"3";"1";"2";"9";"72";"45532"
"1";"1";"0";"9";"72";"45535"
"1";"1";"0";"9";"72";"45540"
"4";"0";"4";"9";"72";"45549"
"8";"1";"7";"9";"72";"45553"
"46";"6";"40";"9";"72";"45558"
"1";"0";"1";"9";"72";"45568"
"4";"0";"4";"9";"72";"45574"
"8";"1";"7";"9";"72";"45581"
"1";"0";"1";"9";"72";"45585"
"8";"1";"7";"9";"72";"45592"
"5";"0";"5";"9";"72";"45599"
"4";"1";"3";"9";"72";"45601"
"1";"1";"0";"9";"72";"45605"
"7";"2";"5";"9";"72";"45606"
"7";"1";"6";"9";"72";"45607"
"14";"10";"4";"9";"72";"45611"
"7";"2";"5";"9";"72";"45617"
"2";"0";"2";"9";"72";"45619"
"5";"1";"4";"9";"72";"45623"
"4";"1";"3";"9";"72";"45633"
"1";"1";"0";"9";"72";"45643"
"1";"1";"0";"9";"72";"45647"
"5";"0";"5";"9";"72";"45649"
"2";"1";"1";"9";"72";"45652"
"4";"1";"3";"9";"72";"45657"
"1";"1";"0";"9";"72";"45658"
"1";"0";"1";"9";"72";"45660"
"8";"3";"5";"9";"72";"45661"
"5";"1";"4";"9";"72";"45665"
"12";"5";"7";"9";"72";"45667"
"2";"0";"2";"9";"72";"45672"
"5";"0";"5";"9";"72";"45676"
"3";"0";"3";"9";"72";"45677"
"1";"0";"1";"9";"72";"45681"
"5";"1";"4";"9";"72";"45684"
"10";"4";"6";"9";"72";"45685"
"5";"1";"4";"9";"72";"45689"
"1";"0";"1";"9";"72";"45694"
"2";"1";"1";"9";"72";"45696"
"1";"1";"0";"9";"72";"45697"
"2";"1";"1";"9";"72";"45698"
"8";"4";"4";"9";"72";"45703"
"1";"1";"0";"9";"72";"45711"
"2";"0";"2";"9";"72";"45722"
"3";"0";"3";"9";"72";"45728"
"2";"1";"1";"9";"72";"45734"
"3";"1";"2";"9";"72";"45746"
"2";"1";"1";"9";"72";"45749"
"4";"1";"3";"9";"72";"45758"
"1";"1";"0";"9";"72";"45759"
"3";"1";"2";"9";"72";"45766"
"1";"1";"0";"9";"72";"45770"
"6";"0";"6";"9";"72";"45778"
"2";"1";"1";"9";"72";"45781"
"1";"0";"1";"9";"72";"45789"
"2";"1";"1";"9";"72";"45790"
"1";"1";"0";"9";"72";"45792"
"31";"17";"14";"9";"72";"45793"
"17";"4";"13";"9";"72";"45796"
"2";"1";"1";"9";"72";"45800"
"2";"0";"2";"9";"72";"45802"
"3";"0";"3";"9";"72";"45803"
"6";"2";"4";"9";"72";"45812"
"1";"1";"0";"9";"72";"45814"
"10";"1";"9";"9";"72";"45818"
"1";"0";"1";"9";"72";"45819"
"4";"0";"4";"9";"72";"45823"
"2";"0";"2";"9";"72";"45834"
"2";"1";"1";"9";"72";"45837"
"1";"0";"1";"9";"72";"45839"
"5";"3";"2";"9";"72";"45847"
"5";"3";"2";"9";"72";"45854"
"1";"1";"0";"9";"72";"45856"
"7";"1";"6";"9";"72";"45866"
"3";"1";"2";"9";"72";"45881"
"1";"0";"1";"9";"72";"45887"
"1";"1";"0";"9";"72";"45889"
"4";"1";"3";"9";"72";"45890"
"2";"1";"1";"9";"72";"45892"
"1";"0";"1";"9";"72";"45893"
"2";"0";"2";"9";"72";"45894"
"10";"2";"8";"9";"72";"45895"
"5";"2";"3";"9";"72";"45901"
"4";"0";"4";"9";"72";"45914"
"1";"1";"0";"9";"72";"45925"
"7";"1";"6";"9";"72";"45926"
"3";"0";"3";"9";"72";"45931"
"4";"1";"3";"9";"72";"45941"
"1";"0";"1";"9";"72";"45942"
"3";"0";"3";"9";"72";"45945"
"3";"0";"3";"9";"72";"45947"
"3";"1";"2";"9";"72";"45949"
"1";"0";"1";"9";"72";"45957"
"1";"1";"0";"9";"72";"45960"
"6";"3";"3";"9";"72";"45961"
"25";"10";"15";"9";"72";"45965"
"1";"0";"1";"9";"72";"45969"
"11";"4";"7";"9";"72";"45974"
"5";"2";"3";"9";"72";"45975"
"4";"1";"3";"9";"72";"45981"
"2";"1";"1";"9";"72";"45986"
"3";"1";"2";"9";"72";"45987"
"5";"2";"3";"9";"72";"45989"
"94";"50";"44";"9";"72";"45996"
"1";"1";"0";"9";"72";"45998"
"1";"0";"1";"9";"72";"46007"
"3";"1";"2";"9";"72";"46009"
"5";"2";"3";"9";"72";"46010"
"1";"1";"0";"9";"72";"46012"
"2";"1";"1";"9";"72";"46029"
"8";"2";"6";"9";"72";"46033"
"5";"0";"5";"9";"72";"46034"
"4";"1";"3";"9";"72";"46044"
"1";"1";"0";"9";"72";"46047"
"13";"5";"8";"9";"72";"46048"
"2";"1";"1";"9";"72";"46049"
"2";"0";"2";"9";"72";"46052"
"2";"1";"1";"9";"72";"46056"
"4";"2";"2";"9";"72";"46062"
"1";"1";"0";"9";"72";"46074"
"17";"3";"14";"9";"72";"46076"
"1";"0";"1";"9";"72";"46079"
"2";"0";"2";"9";"72";"46085"
"2";"0";"2";"9";"72";"46088"
"31";"25";"6";"9";"72";"46090"
"6";"1";"5";"9";"72";"46097"
"4";"2";"2";"9";"72";"46098"
"1";"0";"1";"9";"72";"46102"
"1";"0";"1";"9";"72";"46103"
"6";"4";"2";"9";"72";"46106"
"4";"1";"3";"9";"72";"46110"
"2";"0";"2";"9";"72";"46111"
"1";"0";"1";"9";"72";"46113"
"4";"1";"3";"9";"72";"46114"
"2";"1";"1";"9";"72";"46116"
"1";"0";"1";"9";"72";"46120"
"3";"1";"2";"9";"72";"46122"
"6";"0";"6";"9";"72";"46126"
"2";"1";"1";"9";"72";"46130"
"4";"2";"2";"9";"72";"46132"
"2";"1";"1";"9";"72";"46134"
"2";"1";"1";"9";"72";"46135"
"12";"4";"8";"9";"72";"46137"
"5";"1";"4";"9";"72";"46138"
"1";"0";"1";"9";"72";"46142"
"7";"2";"5";"9";"72";"46146"
"1";"1";"0";"9";"72";"46147"
"5";"2";"3";"9";"72";"46148"
"1";"0";"1";"9";"72";"46149"
"6";"1";"5";"9";"72";"46150"
"1";"0";"1";"9";"72";"46151"
"1";"1";"0";"9";"72";"46152"
"1";"0";"1";"9";"72";"46154"
"2";"0";"2";"9";"72";"46156"
"5";"1";"4";"9";"72";"46158"
"3";"1";"2";"9";"72";"46161"
"4";"1";"3";"9";"72";"46165"
"1";"1";"0";"9";"72";"46173"
"3";"3";"0";"9";"72";"46183"
"3";"2";"1";"9";"72";"46186"
"1";"0";"1";"9";"72";"46189"
"3";"2";"1";"9";"72";"46199"
"1";"1";"0";"9";"72";"46202"
"1";"0";"1";"9";"72";"46207"
"5";"1";"4";"9";"72";"46217"
"1";"1";"0";"9";"72";"46221"
"3";"1";"2";"9";"72";"46223"
"6";"2";"4";"9";"72";"46227"
"3";"1";"2";"9";"72";"46230"
"5";"2";"3";"9";"72";"46233"
"1";"1";"0";"9";"72";"46238"
"1";"1";"0";"9";"72";"46239"
"1";"0";"1";"9";"72";"46241"
"1";"0";"1";"9";"72";"46243"
"6";"2";"4";"9";"72";"46244"
"2";"0";"2";"9";"72";"46248"
"8";"4";"4";"9";"72";"46255"
"1";"1";"0";"9";"72";"46263"
"2";"1";"1";"9";"72";"46266"
"2";"1";"1";"9";"72";"46268"
"2";"0";"2";"9";"72";"46269"
"20";"6";"14";"9";"72";"46272"
"5";"1";"4";"9";"72";"46273"
"2";"1";"1";"9";"72";"46282"
"1";"1";"0";"9";"72";"46283"
"21";"5";"16";"9";"72";"46285"
"2";"0";"2";"9";"72";"46293"
"7";"4";"3";"9";"72";"46294"
"10";"1";"9";"9";"72";"46295"
"7";"3";"4";"9";"72";"46297"
"2";"0";"2";"9";"72";"46301"
"3";"1";"2";"9";"72";"46302"
"10";"3";"7";"9";"72";"46304"
"9";"2";"7";"9";"72";"46306"
"2";"1";"1";"9";"72";"46309"
"6";"1";"5";"9";"72";"46314"
"1";"1";"0";"9";"72";"46318"
"1";"1";"0";"9";"72";"46319"
"1";"1";"0";"9";"72";"46322"
"6";"1";"5";"9";"72";"46325"
"1";"1";"0";"9";"72";"46326"
"5";"1";"4";"9";"72";"46328"
"1";"1";"0";"9";"72";"46335"
"1";"1";"0";"9";"72";"46339"
"1";"0";"1";"9";"72";"46352"
"1";"1";"0";"9";"72";"46354"
"3";"1";"2";"9";"72";"46362"
"2";"0";"2";"9";"72";"46374"
"1";"1";"0";"9";"72";"46375"
"1";"1";"0";"9";"72";"46376"
"2";"1";"1";"9";"72";"46384"
"6";"6";"0";"9";"72";"46392"
"6";"1";"5";"9";"72";"46394"
"3";"0";"3";"9";"72";"46395"
"6";"3";"3";"9";"72";"46397"
"7";"2";"5";"9";"72";"46399"
"3";"0";"3";"9";"72";"46405"
"1";"1";"0";"9";"72";"46410"
"6";"3";"3";"9";"72";"46414"
"4";"0";"4";"9";"72";"46420"
"3";"1";"2";"9";"72";"46427"
"3";"0";"3";"9";"72";"46428"
"2";"0";"2";"9";"72";"46429"
"7";"2";"5";"9";"72";"46443"
"9";"2";"7";"9";"72";"46445"
"5";"3";"2";"9";"72";"46446"
"1";"1";"0";"9";"72";"46447"
"3";"0";"3";"9";"72";"46448"
"3";"0";"3";"9";"72";"46449"
"23";"16";"7";"9";"72";"46451"
"2";"1";"1";"9";"72";"46452"
"1";"1";"0";"9";"72";"46454"
"2";"0";"2";"9";"72";"46462"
"2";"1";"1";"9";"72";"46463"
"2";"1";"1";"9";"72";"46464"
"3";"1";"2";"9";"72";"46465"
"1";"1";"0";"9";"72";"46466"
"7";"1";"6";"9";"72";"46468"
"1";"1";"0";"9";"72";"46469"
"1";"0";"1";"9";"72";"46474"
"2";"1";"1";"9";"72";"46485"
"3";"1";"2";"9";"72";"46486"
"3";"1";"2";"9";"72";"46487"
"1";"0";"1";"9";"72";"46491"
"1";"0";"1";"9";"72";"46492"
"5";"1";"4";"9";"72";"46496"
"3";"1";"2";"9";"72";"46507"
"5";"0";"5";"9";"72";"46508"
"4";"2";"2";"9";"72";"46510"
"7";"1";"6";"9";"72";"46518"
"1";"0";"1";"9";"72";"46521"
"2";"1";"1";"9";"72";"46524"
"6";"2";"4";"9";"72";"46528"
"6";"1";"5";"9";"72";"46530"
"6";"1";"5";"9";"72";"46545"
"9";"4";"5";"9";"72";"46549"
"3";"1";"2";"9";"72";"46550"
"6";"2";"4";"9";"72";"46551"
"3";"1";"2";"9";"72";"46552"
"5";"2";"3";"9";"72";"46554"
"2";"0";"2";"9";"72";"46557"
"6";"3";"3";"9";"72";"46561"
"7";"0";"7";"9";"72";"46566"
"1";"1";"0";"9";"72";"46567"
"9";"1";"8";"9";"72";"46568"
"2";"1";"1";"9";"72";"46579"
"1";"0";"1";"9";"72";"46580"
"1";"0";"1";"9";"72";"46583"
"6";"1";"5";"9";"72";"46593"
"2";"1";"1";"9";"72";"46598"
"2";"0";"2";"9";"72";"46599"
"2";"1";"1";"9";"72";"46601"
"2";"1";"1";"9";"72";"46602"
"3";"1";"2";"9";"72";"46604"
"8";"1";"7";"9";"72";"46605"
"2";"1";"1";"9";"72";"46608"
"1";"1";"0";"9";"72";"46610"
"5";"1";"4";"9";"72";"46612"
"6";"1";"5";"9";"72";"46621"
"2";"0";"2";"9";"72";"46625"
"2";"1";"1";"9";"72";"46627"
"5";"1";"4";"9";"72";"46628"
"3";"1";"2";"9";"72";"46630"
"14";"5";"9";"9";"72";"46643"
"3";"3";"0";"9";"72";"46644"
"3";"1";"2";"9";"72";"46648"
"1";"0";"1";"9";"72";"46649"
"3";"3";"0";"9";"72";"46652"
"7";"1";"6";"9";"72";"46654"
"8";"1";"7";"9";"72";"46655"
"2";"1";"1";"9";"72";"46662"
"2";"1";"1";"9";"72";"46665"
"2";"2";"0";"9";"72";"46667"
"1";"1";"0";"9";"72";"46674"
"12";"2";"10";"9";"72";"46692"
"2";"1";"1";"9";"72";"46693"
"2";"0";"2";"9";"72";"46695"
"4";"1";"3";"9";"72";"46696"
"3";"1";"2";"9";"72";"46699"
"1";"0";"1";"9";"72";"46706"
"7";"1";"6";"9";"72";"46707"
"2";"0";"2";"9";"72";"46712"
"5";"2";"3";"9";"72";"46716"
"2";"0";"2";"9";"72";"46720"
"7";"1";"6";"9";"72";"46722"
"3";"1";"2";"9";"72";"46727"
"1";"0";"1";"9";"72";"46731"
"8";"1";"7";"9";"72";"46733"
"5";"2";"3";"9";"72";"46736"
"2";"0";"2";"9";"72";"46737"
"1";"0";"1";"9";"72";"46746"
"2";"0";"2";"9";"72";"46748"
"1";"0";"1";"9";"72";"46755"
"1";"1";"0";"9";"72";"46763"
"4";"3";"1";"9";"72";"46770"
"5";"2";"3";"9";"72";"46773"
"6";"2";"4";"9";"72";"46781"
"1";"0";"1";"9";"72";"46783"
"2";"0";"2";"9";"72";"46790"
"1";"0";"1";"9";"72";"46792"
"1";"0";"1";"9";"72";"46793"
"2";"0";"2";"9";"72";"46794"
"1";"0";"1";"9";"72";"46795"
"3";"1";"2";"9";"72";"46797"
"3";"1";"2";"9";"72";"46803"
"3";"0";"3";"9";"72";"46804"
"7";"3";"4";"9";"72";"46806"
"2";"0";"2";"9";"72";"46807"
"7";"3";"4";"9";"72";"46808"
"11";"2";"9";"9";"72";"46810"
"46";"32";"14";"9";"72";"46830"
"4";"1";"3";"9";"72";"46832"
"2";"1";"1";"9";"72";"46836"
"5";"2";"3";"9";"72";"46849"
"11";"2";"9";"9";"72";"46852"
"2";"1";"1";"9";"72";"46863"
"17";"6";"11";"9";"72";"46871"
"2";"1";"1";"9";"72";"46872"
"3";"0";"3";"9";"72";"46876"
"3";"0";"3";"9";"72";"46882"
"2";"0";"2";"9";"72";"46884"
"3";"1";"2";"9";"72";"46891"
"1";"0";"1";"9";"72";"46892"
"1";"0";"1";"9";"72";"46893"
"6";"0";"6";"9";"72";"46896"
"4";"1";"3";"9";"72";"46901"
"1";"0";"1";"9";"72";"46902"
"36";"24";"12";"9";"72";"46903"
"1";"0";"1";"9";"72";"46906"
"3";"1";"2";"9";"72";"46909"
"8";"1";"7";"9";"72";"46910"
"1";"0";"1";"9";"72";"46914"
"8";"2";"6";"9";"72";"46915"
"6";"2";"4";"9";"72";"46916"
"5";"2";"3";"9";"72";"46922"
"4";"2";"2";"9";"72";"46924"
"5";"3";"2";"9";"72";"46927"
"1";"0";"1";"9";"72";"46932"
"2";"2";"0";"9";"72";"46935"
"2";"1";"1";"9";"72";"46945"
"8";"3";"5";"9";"72";"46948"
"1";"0";"1";"9";"72";"46955"
"3";"1";"2";"9";"72";"46963"
"5";"3";"2";"9";"72";"46966"
"1";"1";"0";"9";"72";"46967"
"2";"1";"1";"9";"72";"46968"
"18";"5";"13";"9";"72";"46971"
"8";"1";"7";"9";"72";"46973"
"2";"0";"2";"9";"72";"46979"
"2";"1";"1";"9";"72";"46982"
"2";"0";"2";"9";"72";"46983"
"5";"2";"3";"9";"72";"46988"
"3";"0";"3";"9";"72";"46989"
"1";"0";"1";"9";"72";"46990"
"3";"1";"2";"9";"72";"46994"
"5";"1";"4";"9";"72";"46997"
"4";"1";"3";"9";"72";"47001"
"3";"2";"1";"9";"72";"47002"
"4";"2";"2";"9";"72";"47006"
"2";"0";"2";"9";"72";"47007"
"3";"0";"3";"9";"72";"47012"
"4";"1";"3";"9";"72";"47013"
"1";"0";"1";"9";"72";"47015"
"13";"7";"6";"9";"72";"47019"
"3";"3";"0";"9";"72";"47025"
"4";"2";"2";"9";"72";"47028"
"2";"0";"2";"9";"72";"47031"
"2";"0";"2";"9";"72";"47042"
"2";"1";"1";"9";"72";"47047"
"2";"0";"2";"9";"72";"47049"
"3";"0";"3";"9";"72";"47055"
"3";"2";"1";"9";"72";"47057"
"4";"0";"4";"9";"72";"47058"
"6";"3";"3";"9";"72";"47059"
"4";"1";"3";"9";"72";"47064"
"3";"1";"2";"9";"72";"47068"
"3";"0";"3";"9";"72";"47071"
"4";"4";"0";"9";"72";"47080"
"3";"1";"2";"9";"72";"47081"
"2";"1";"1";"9";"72";"47084"
"2";"0";"2";"9";"72";"47091"
"4";"1";"3";"9";"72";"47092"
"9";"1";"8";"9";"72";"47100"
"2";"1";"1";"9";"72";"47103"
"1";"1";"0";"9";"72";"47113"
"7";"1";"6";"9";"72";"47119"
"2";"1";"1";"9";"72";"47120"
"5";"1";"4";"9";"72";"47121"
"2";"1";"1";"9";"72";"47126"
"2";"1";"1";"9";"72";"47128"
"2";"0";"2";"9";"72";"47133"
"6";"0";"6";"9";"72";"47138"
"2";"0";"2";"9";"72";"47146"
"1";"1";"0";"9";"72";"47148"
"7";"1";"6";"9";"72";"47150"
"2";"0";"2";"9";"72";"47157"
"37";"21";"16";"9";"72";"47160"
"6";"2";"4";"9";"72";"47165"
"3";"0";"3";"9";"72";"47168"
"6";"1";"5";"9";"72";"47174"
"4";"1";"3";"9";"72";"47179"
"5";"2";"3";"9";"72";"47180"
"1";"0";"1";"9";"72";"47182"
"2";"0";"2";"9";"72";"47184"
"1";"1";"0";"9";"72";"47187"
"4";"1";"3";"9";"72";"47190"
"1";"0";"1";"9";"72";"47191"
"6";"0";"6";"9";"72";"47192"
"4";"1";"3";"9";"72";"47195"
"4";"1";"3";"9";"72";"47199"
"6";"1";"5";"9";"72";"47210"
"1";"1";"0";"9";"72";"47212"
"1";"1";"0";"9";"72";"47214"
"1";"0";"1";"9";"72";"47216"
"1";"1";"0";"9";"72";"47219"
"1";"1";"0";"9";"72";"47224"
"4";"1";"3";"9";"72";"47228"
"7";"1";"6";"9";"72";"47231"
"1";"0";"1";"9";"72";"47243"
"7";"6";"1";"9";"72";"47245"
"5";"0";"5";"9";"72";"47246"
"1";"1";"0";"9";"72";"47253"
"1";"1";"0";"9";"72";"47264"
"1";"1";"0";"9";"72";"47269"
"4";"3";"1";"9";"72";"47276"
"2";"0";"2";"9";"72";"47278"
"1";"0";"1";"9";"72";"47282"
"4";"1";"3";"9";"72";"47286"
"13";"2";"11";"9";"72";"47291"
"2";"0";"2";"9";"72";"47292"
"7";"2";"5";"9";"72";"47293"
"2";"1";"1";"9";"72";"47302"
"2";"0";"2";"9";"72";"47305"
"5";"1";"4";"9";"72";"47315"
"2";"1";"1";"9";"72";"47321"
"49";"38";"11";"9";"72";"47322"
"2";"1";"1";"9";"72";"47326"
"2";"0";"2";"9";"72";"47327"
"4";"1";"3";"9";"72";"47330"
"5";"2";"3";"9";"72";"47340"
"25";"6";"19";"9";"72";"47345"
"3";"0";"3";"9";"72";"47349"
"1";"1";"0";"9";"72";"47351"
"1";"1";"0";"9";"72";"47352"
"38";"17";"21";"9";"72";"47355"
"1";"1";"0";"9";"72";"47356"
"3";"0";"3";"9";"72";"47376"
"1";"1";"0";"9";"72";"47377"
"1";"0";"1";"9";"72";"47380"
"4";"2";"2";"9";"72";"47388"
"1";"0";"1";"9";"72";"47390"
"6";"3";"3";"9";"72";"47411"
"4";"0";"4";"9";"72";"47412"
"1";"0";"1";"9";"72";"47414"
"5";"1";"4";"9";"72";"47416"
"2";"1";"1";"9";"72";"47419"
"6";"1";"5";"9";"72";"47422"
"16";"2";"14";"9";"72";"47423"
"2";"0";"2";"9";"72";"47425"
"6";"3";"3";"9";"72";"47427"
"7";"2";"5";"9";"72";"47428"
"1";"1";"0";"9";"72";"47432"
"7";"1";"6";"9";"72";"47433"
"2";"0";"2";"9";"72";"47436"
"2";"1";"1";"9";"72";"47437"
"5";"1";"4";"9";"72";"47441"
"2";"1";"1";"9";"72";"47452"
"9";"1";"8";"9";"72";"47455"
"17";"4";"13";"9";"72";"47465"
"4";"1";"3";"9";"72";"47468"
"2";"0";"2";"9";"72";"47472"
"1";"1";"0";"9";"72";"47475"
"4";"4";"0";"9";"72";"47476"
"7";"2";"5";"9";"72";"47478"
"2";"0";"2";"9";"72";"47482"
"4";"1";"3";"9";"72";"47496"
"2";"1";"1";"9";"72";"47497"
"1";"1";"0";"9";"72";"47499"
"3";"1";"2";"9";"72";"47501"
"8";"2";"6";"9";"72";"47504"
"2";"2";"0";"9";"72";"47507"
"10";"1";"9";"9";"72";"47508"
"3";"1";"2";"9";"72";"47510"
"1";"0";"1";"9";"72";"47513"
"8";"3";"5";"9";"72";"47514"
"15";"2";"13";"9";"72";"47522"
"4";"2";"2";"9";"72";"47523"
"1";"0";"1";"9";"72";"47524"
"2";"0";"2";"9";"72";"47527"
"9";"1";"8";"9";"72";"47531"
"112";"84";"28";"9";"72";"47535"
"5";"1";"4";"9";"72";"47536"
"1";"1";"0";"9";"72";"47542"
"4";"1";"3";"9";"72";"47543"
"1";"1";"0";"9";"72";"47545"
"3";"1";"2";"9";"72";"47546"
"44";"26";"18";"9";"72";"47548"
"2";"1";"1";"9";"72";"47551"
"2";"1";"1";"9";"72";"47554"
"4";"2";"2";"9";"72";"47555"
"2";"1";"1";"9";"72";"47561"
"5";"1";"4";"9";"72";"47569"
"58";"36";"22";"9";"72";"47571"
"3";"0";"3";"9";"72";"47574"
"11";"1";"10";"9";"72";"47575"
"4";"1";"3";"9";"72";"47579"
"19";"10";"9";"9";"72";"47581"
"6";"1";"5";"9";"72";"47584"
"4";"1";"3";"9";"72";"47588"
"1";"0";"1";"9";"72";"47593"
"4";"3";"1";"9";"72";"47595"
"2";"0";"2";"9";"72";"47596"
"3";"0";"3";"9";"72";"47602"
"13";"5";"8";"9";"72";"47613"
"2";"0";"2";"9";"72";"47618"
"6";"1";"5";"9";"72";"47625"
"6";"0";"6";"9";"72";"47627"
"1";"1";"0";"9";"72";"47631"
"6";"1";"5";"9";"72";"47634"
"2";"0";"2";"9";"72";"47637"
"3";"0";"3";"9";"72";"47642"
"1";"0";"1";"9";"72";"47645"
"23";"3";"20";"9";"72";"47654"
"1";"0";"1";"9";"72";"47657"
"1";"1";"0";"9";"72";"47661"
"4";"0";"4";"9";"72";"47662"
"3";"1";"2";"9";"72";"47667"
"3";"0";"3";"9";"72";"47668"
"1";"1";"0";"9";"72";"47671"
"3";"1";"2";"9";"72";"47672"
"1";"0";"1";"9";"72";"47675"
"1";"0";"1";"9";"72";"47676"
"1";"0";"1";"9";"72";"47678"
"6";"1";"5";"9";"72";"47679"
"3";"1";"2";"9";"72";"47680"
"1";"0";"1";"9";"72";"47683"
"15";"3";"12";"9";"72";"47688"
"4";"2";"2";"9";"72";"47689"
"1";"0";"1";"9";"72";"47691"
"3";"1";"2";"9";"72";"47693"
"1";"0";"1";"9";"72";"47697"
"5";"1";"4";"9";"72";"47701"
"5";"1";"4";"9";"72";"47704"
"4";"2";"2";"9";"72";"47708"
"2";"0";"2";"9";"72";"47713"
"8";"1";"7";"9";"72";"47715"
"2";"0";"2";"9";"72";"47722"
"2";"0";"2";"9";"72";"47728"
"7";"2";"5";"9";"72";"47736"
"4";"1";"3";"9";"72";"47737"
"3";"1";"2";"9";"72";"47740"
"4";"2";"2";"9";"72";"47746"
"1";"1";"0";"9";"72";"47747"
"7";"1";"6";"9";"72";"47748"
"3";"1";"2";"9";"72";"47754"
"39";"28";"11";"9";"72";"47757"
"1";"0";"1";"9";"72";"47759"
"2";"1";"1";"9";"72";"47760"
"5";"1";"4";"9";"72";"47767"
"6";"1";"5";"9";"72";"47771"
"11";"3";"8";"9";"72";"47777"
"2";"1";"1";"9";"72";"47779"
"3";"1";"2";"9";"72";"47780"
"4";"2";"2";"9";"72";"47781"
"7";"1";"6";"9";"72";"47787"
"7";"4";"3";"9";"72";"47796"
"1";"1";"0";"9";"72";"47800"
"2";"1";"1";"9";"72";"47804"
"2";"0";"2";"9";"72";"47815"
"3";"0";"3";"9";"72";"47820"
"3";"0";"3";"9";"72";"47821"
"3";"1";"2";"9";"72";"47830"
"2";"1";"1";"9";"72";"47833"
"2";"0";"2";"9";"72";"47836"
"2";"0";"2";"9";"72";"47837"
"2";"1";"1";"9";"72";"47839"
"1";"1";"0";"9";"72";"47845"
"2";"0";"2";"9";"72";"47853"
"6";"1";"5";"9";"72";"47854"
"12";"3";"9";"9";"72";"47856"
"5";"1";"4";"9";"72";"47864"
"1";"0";"1";"9";"72";"47870"
"3";"3";"0";"9";"72";"47873"
"8";"5";"3";"9";"72";"47877"
"3";"0";"3";"9";"72";"47879"
"2";"0";"2";"9";"72";"47881"
"1";"1";"0";"9";"72";"47884"
"3";"1";"2";"9";"72";"47887"
"1";"0";"1";"9";"72";"47896"
"12";"2";"10";"9";"72";"47902"
"1";"0";"1";"9";"72";"47909"
"2";"0";"2";"9";"72";"47912"
"1";"1";"0";"9";"72";"47914"
"1";"1";"0";"9";"72";"47917"
"4";"0";"4";"9";"72";"47920"
"2";"0";"2";"9";"72";"47925"
"7";"1";"6";"9";"72";"47956"
"2";"0";"2";"9";"72";"47964"
"16";"5";"11";"9";"72";"47967"
"3";"0";"3";"9";"72";"47974"
"16";"5";"11";"9";"72";"47990"
"4";"1";"3";"9";"72";"47995"
"2";"1";"1";"9";"72";"47996"
"1";"1";"0";"9";"72";"47997"
"4";"1";"3";"9";"72";"47998"
"5";"2";"3";"9";"72";"48004"
"1";"0";"1";"9";"72";"48010"
"7";"2";"5";"9";"72";"48012"
"3";"0";"3";"9";"72";"48027"
"2";"1";"1";"9";"72";"48028"
"6";"0";"6";"9";"72";"48029"
"2";"0";"2";"9";"72";"48030"
"5";"1";"4";"9";"72";"48041"
"1";"0";"1";"9";"72";"48045"
"4";"0";"4";"9";"72";"48046"
"1";"0";"1";"9";"72";"48047"
"7";"2";"5";"9";"72";"48050"
"1";"0";"1";"9";"72";"48051"
"2";"0";"2";"9";"72";"48053"
"2";"0";"2";"9";"72";"48056"
"4";"0";"4";"9";"72";"48057"
"2";"1";"1";"9";"72";"48066"
"3";"0";"3";"9";"72";"48067"
"2";"1";"1";"9";"72";"48074"
"5";"1";"4";"9";"72";"48078"
"9";"1";"8";"9";"72";"48083"
"1";"1";"0";"9";"72";"48087"
"5";"1";"4";"9";"72";"48091"
"14";"5";"9";"9";"72";"48101"
"5";"1";"4";"9";"72";"48104"
"3";"1";"2";"9";"72";"48106"
"1";"1";"0";"9";"72";"48107"
"3";"0";"3";"9";"72";"48113"
"4";"1";"3";"9";"72";"48116"
"4";"1";"3";"9";"72";"48117"
"2";"0";"2";"9";"72";"48118"
"2";"1";"1";"9";"72";"48121"
"1";"0";"1";"9";"72";"48123"
"4";"2";"2";"9";"72";"48126"
"1";"0";"1";"9";"72";"48142"
"4";"4";"0";"9";"72";"48143"
"1";"1";"0";"9";"72";"48147"
"3";"0";"3";"9";"72";"48154"
"5";"2";"3";"9";"72";"48156"
"10";"1";"9";"9";"72";"48157"
"1";"0";"1";"9";"72";"48158"
"2";"0";"2";"9";"72";"48159"
"3";"0";"3";"9";"72";"48165"
"2";"0";"2";"9";"72";"48172"
"2";"0";"2";"9";"72";"48181"
"1";"0";"1";"9";"72";"48182"
"1";"0";"1";"9";"72";"48195"
"2";"0";"2";"9";"72";"48210"
"2";"0";"2";"9";"72";"48218"
"1";"1";"0";"9";"72";"48219"
"5";"2";"3";"9";"72";"48222"
"2";"1";"1";"9";"72";"48230"
"7";"2";"5";"9";"72";"48231"
"3";"0";"3";"9";"72";"48232"
"20";"7";"13";"9";"72";"48244"
"4";"2";"2";"9";"72";"48261"
"3";"1";"2";"9";"72";"48265"
"1";"0";"1";"9";"72";"48267"
"6";"1";"5";"9";"72";"48270"
"1";"0";"1";"9";"72";"48275"
"4";"0";"4";"9";"72";"48284"
"1";"1";"0";"9";"72";"48291"
"1";"1";"0";"9";"72";"48295"
"8";"2";"6";"9";"72";"48296"
"5";"1";"4";"9";"72";"48300"
"5";"0";"5";"9";"72";"48301"
"3";"0";"3";"9";"72";"48304"
"4";"1";"3";"9";"72";"48315"
"2";"1";"1";"9";"72";"48318"
"1";"1";"0";"9";"72";"48323"
"5";"2";"3";"9";"72";"48324"
"3";"0";"3";"9";"72";"48326"
"22";"17";"5";"9";"72";"48330"
"38";"29";"9";"9";"72";"48339"
"3";"1";"2";"9";"72";"48340"
"4";"1";"3";"9";"72";"48343"
"3";"1";"2";"9";"72";"48345"
"8";"4";"4";"9";"72";"48351"
"2";"1";"1";"9";"72";"48352"
"1";"1";"0";"9";"72";"48362"
"2";"1";"1";"9";"72";"48370"
"4";"0";"4";"9";"72";"48371"
"1";"1";"0";"9";"72";"48373"
"1";"0";"1";"9";"72";"48375"
"15";"1";"14";"9";"72";"48376"
"2";"0";"2";"9";"72";"48378"
"2";"1";"1";"9";"72";"48380"
"9";"8";"1";"9";"72";"48382"
"2";"1";"1";"9";"72";"48383"
"1";"0";"1";"9";"72";"48386"
"3";"2";"1";"9";"72";"48390"
"5";"1";"4";"9";"72";"48392"
"1";"1";"0";"9";"72";"48396"
"2";"0";"2";"9";"72";"48400"
"1";"0";"1";"9";"72";"48405"
"5";"1";"4";"9";"72";"48409"
"2";"1";"1";"9";"72";"48413"
"2";"0";"2";"9";"72";"48414"
"1";"1";"0";"9";"72";"48416"
"5";"1";"4";"9";"72";"48424"
"5";"1";"4";"9";"72";"48429"
"1";"1";"0";"9";"72";"48433"
"2";"1";"1";"9";"72";"48434"
"4";"1";"3";"9";"72";"48436"
"3";"1";"2";"9";"72";"48438"
"7";"3";"4";"9";"72";"48450"
"1";"1";"0";"9";"72";"48451"
"1";"1";"0";"9";"72";"48456"
"2";"0";"2";"9";"72";"48463"
"4";"2";"2";"9";"72";"48466"
"3";"0";"3";"9";"72";"48477"
"6";"1";"5";"9";"72";"48478"
"1";"0";"1";"9";"72";"48480"
"7";"4";"3";"9";"72";"48483"
"7";"1";"6";"9";"72";"48491"
"2";"0";"2";"9";"72";"48492"
"4";"1";"3";"9";"72";"48495"
"3";"0";"3";"9";"72";"48496"
"8";"2";"6";"9";"72";"48506"
"12";"2";"10";"9";"72";"48513"
"2";"1";"1";"9";"72";"48515"
"1";"1";"0";"9";"72";"48524"
"4";"1";"3";"9";"72";"48527"
"2";"1";"1";"9";"72";"48528"
"19";"11";"8";"9";"72";"48529"
"11";"3";"8";"9";"72";"48531"
"3";"2";"1";"9";"72";"48532"
"3";"1";"2";"9";"72";"48533"
"2";"2";"0";"9";"72";"48535"
"7";"0";"7";"9";"72";"48536"
"1";"1";"0";"9";"72";"48537"
"1";"1";"0";"9";"72";"48541"
"5";"2";"3";"9";"72";"48542"
"1";"0";"1";"9";"72";"48554"
"7";"2";"5";"9";"72";"48556"
"20";"10";"10";"9";"72";"48569"
"6";"0";"6";"9";"72";"48570"
"2";"0";"2";"9";"72";"48572"
"4";"0";"4";"9";"72";"48576"
"2";"0";"2";"9";"72";"48581"
"1";"1";"0";"9";"72";"48588"
"1";"1";"0";"9";"72";"48592"
"4";"2";"2";"9";"72";"48595"
"5";"1";"4";"9";"72";"48599"
"2";"2";"0";"9";"72";"48603"
"1";"0";"1";"9";"72";"48604"
"5";"1";"4";"9";"72";"48605"
"2";"1";"1";"9";"72";"48608"
"8";"4";"4";"9";"72";"48609"
"1";"1";"0";"9";"72";"48610"
"1";"1";"0";"9";"72";"48612"
"8";"4";"4";"9";"72";"48615"
"1";"0";"1";"9";"72";"48618"
"3";"0";"3";"9";"72";"48622"
"2";"0";"2";"9";"72";"48631"
"1";"1";"0";"9";"72";"48636"
"2";"0";"2";"9";"72";"48637"
"3";"0";"3";"9";"72";"48640"
"2";"0";"2";"9";"72";"48646"
"10";"3";"7";"9";"72";"48651"
"1";"1";"0";"9";"72";"48652"
"1";"1";"0";"9";"72";"48656"
"1";"1";"0";"9";"72";"48664"
"4";"0";"4";"9";"72";"48673"
"4";"1";"3";"9";"72";"48676"
"5";"2";"3";"9";"72";"48679"
"4";"0";"4";"9";"72";"48682"
"3";"1";"2";"9";"72";"48691"
"1";"0";"1";"9";"72";"48692"
"10";"1";"9";"9";"72";"48702"
"2";"2";"0";"9";"72";"48704"
"4";"1";"3";"9";"72";"48705"
"11";"3";"8";"9";"72";"48707"
"2";"1";"1";"9";"72";"48713"
"2";"0";"2";"9";"72";"48718"
"5";"2";"3";"9";"72";"48719"
"4";"0";"4";"9";"72";"48720"
"2";"0";"2";"9";"72";"48725"
"1";"0";"1";"9";"72";"48726"
"1";"0";"1";"9";"72";"48727"
"1";"1";"0";"9";"72";"48728"
"3";"0";"3";"9";"72";"48729"
"1";"1";"0";"9";"72";"48731"
"6";"2";"4";"9";"72";"48733"
"1";"0";"1";"9";"72";"48735"
"4";"3";"1";"9";"72";"48736"
"3";"0";"3";"9";"72";"48738"
"1";"1";"0";"9";"72";"48742"
"5";"1";"4";"9";"72";"48743"
"4";"1";"3";"9";"72";"48745"
"3";"0";"3";"9";"72";"48752"
"15";"6";"9";"9";"72";"48755"
"3";"1";"2";"9";"72";"48756"
"3";"0";"3";"9";"72";"48762"
"5";"1";"4";"9";"72";"48763"
"4";"1";"3";"9";"72";"48768"
"13";"3";"10";"9";"72";"48771"
"1";"1";"0";"9";"72";"48773"
"1";"0";"1";"9";"72";"48778"
"2";"0";"2";"9";"72";"48784"
"3";"1";"2";"9";"72";"48796"
"5";"1";"4";"9";"72";"48800"
"2";"1";"1";"9";"72";"48801"
"1";"1";"0";"9";"72";"48806"
"3";"0";"3";"9";"72";"48809"
"4";"1";"3";"9";"72";"48819"
"2";"1";"1";"9";"72";"48821"
"3";"1";"2";"9";"72";"48826"
"2";"0";"2";"9";"72";"48831"
"1";"0";"1";"9";"72";"48833"
"4";"0";"4";"9";"72";"48837"
"3";"1";"2";"9";"72";"48844"
"3";"1";"2";"9";"72";"48845"
"3";"1";"2";"9";"72";"48846"
"1";"0";"1";"9";"72";"48847"
"4";"1";"3";"9";"72";"48848"
"1";"1";"0";"9";"72";"48849"
"3";"1";"2";"9";"72";"48855"
"4";"0";"4";"9";"72";"48857"
"3";"1";"2";"9";"72";"48862"
"4";"1";"3";"9";"72";"48863"
"3";"1";"2";"9";"72";"48865"
"3";"1";"2";"9";"72";"48866"
"5";"0";"5";"9";"72";"48867"
"3";"1";"2";"9";"72";"48868"
"1";"1";"0";"9";"72";"48870"
"1";"1";"0";"9";"72";"48875"
"8";"5";"3";"9";"72";"48877"
"1";"1";"0";"9";"72";"48879"
"7";"1";"6";"9";"72";"48883"
"3";"0";"3";"9";"72";"48885"
"5";"1";"4";"9";"72";"48888"
"2";"0";"2";"9";"72";"48889"
"4";"2";"2";"9";"72";"48890"
"5";"2";"3";"9";"72";"48897"
"5";"1";"4";"9";"72";"48898"
"4";"1";"3";"9";"72";"48899"
"3";"0";"3";"9";"72";"48902"
"1";"1";"0";"9";"72";"48904"
"47";"35";"12";"9";"72";"48905"
"5";"2";"3";"9";"72";"48910"
"1";"1";"0";"9";"72";"48912"
"5";"0";"5";"9";"72";"48917"
"10";"0";"10";"9";"72";"48918"
"2";"0";"2";"9";"72";"48921"
"4";"2";"2";"9";"72";"48932"
"1";"1";"0";"9";"72";"48933"
"2";"0";"2";"9";"72";"48938"
"4";"1";"3";"9";"72";"48940"
"2";"1";"1";"9";"72";"48943"
"12";"5";"7";"9";"72";"48944"
"2";"1";"1";"9";"72";"48947"
"1";"0";"1";"9";"72";"48951"
"8";"0";"8";"9";"72";"48958"
"2";"0";"2";"9";"72";"48963"
"2";"0";"2";"9";"72";"48967"
"6";"1";"5";"9";"72";"48970"
"4";"0";"4";"9";"72";"48971"
"4";"0";"4";"9";"72";"48974"
"1";"1";"0";"9";"72";"48975"
"1";"1";"0";"9";"72";"48977"
"3";"1";"2";"9";"72";"48978"
"6";"2";"4";"9";"72";"48979"
"5";"1";"4";"9";"72";"48980"
"3";"1";"2";"9";"72";"48981"
"3";"0";"3";"9";"72";"48983"
"3";"0";"3";"9";"72";"48985"
"2";"0";"2";"9";"72";"48987"
"3";"0";"3";"9";"72";"48990"
"1";"0";"1";"9";"72";"48993"
"14";"2";"12";"9";"72";"48994"
"8";"1";"7";"9";"72";"48999"
"3";"1";"2";"9";"72";"49003"
"13";"1";"12";"9";"72";"49011"
"8";"2";"6";"9";"72";"49018"
"1";"0";"1";"9";"72";"49025"
"4";"0";"4";"9";"72";"49037"
"4";"2";"2";"9";"72";"49038"
"4";"1";"3";"9";"72";"49039"
"1";"0";"1";"9";"72";"49040"
"7";"1";"6";"9";"72";"49042"
"4";"1";"3";"9";"72";"49043"
"1";"1";"0";"9";"72";"49044"
"2";"1";"1";"9";"72";"49045"
"1";"0";"1";"9";"72";"49048"
"3";"0";"3";"9";"72";"49054"
"2";"1";"1";"9";"72";"49057"
"6";"1";"5";"9";"72";"49059"
"1";"1";"0";"9";"72";"49068"
"1";"0";"1";"9";"72";"49072"
"6";"2";"4";"9";"72";"49080"
"1";"1";"0";"9";"72";"49081"
"4";"1";"3";"9";"72";"49082"
"1";"0";"1";"9";"72";"49088"
"2";"2";"0";"9";"72";"49089"
"1";"0";"1";"9";"72";"49090"
"6";"0";"6";"9";"72";"49093"
"4";"1";"3";"9";"72";"49103"
"2";"0";"2";"9";"72";"49104"
"4";"1";"3";"9";"72";"49105"
"6";"1";"5";"9";"72";"49106"
"2";"0";"2";"9";"72";"49107"
"4";"0";"4";"9";"72";"49113"
"3";"0";"3";"9";"72";"49118"
"3";"3";"0";"9";"72";"49121"
"5";"2";"3";"9";"72";"49122"
"1";"0";"1";"9";"72";"49132"
"7";"2";"5";"9";"72";"49133"
"2";"0";"2";"9";"72";"49140"
"6";"1";"5";"9";"72";"49147"
"4";"1";"3";"9";"72";"49150"
"1";"1";"0";"9";"72";"49153"
"1";"0";"1";"9";"72";"49157"
"7";"1";"6";"9";"72";"49158"
"5";"1";"4";"9";"72";"49159"
"3";"1";"2";"9";"72";"49161"
"3";"1";"2";"9";"72";"49164"
"13";"2";"11";"9";"72";"49165"
"3";"0";"3";"9";"72";"49169"
"1";"1";"0";"9";"72";"49177"
"4";"1";"3";"9";"72";"49179"
"1";"0";"1";"9";"72";"49180"
"2";"0";"2";"9";"72";"49182"
"1";"1";"0";"9";"72";"49183"
"4";"2";"2";"9";"72";"49187"
"2";"0";"2";"9";"72";"49189"
"2";"1";"1";"9";"72";"49201"
"3";"0";"3";"9";"72";"49202"
"2";"1";"1";"9";"72";"49205"
"6";"2";"4";"9";"72";"49206"
"7";"2";"5";"9";"72";"49207"
"4";"0";"4";"9";"72";"49208"
"5";"2";"3";"9";"72";"49212"
"5";"1";"4";"9";"72";"49231"
"1";"1";"0";"9";"72";"49233"
"1";"0";"1";"9";"72";"49234"
"3";"0";"3";"9";"72";"49236"
"2";"1";"1";"9";"72";"49240"
"4";"4";"0";"9";"72";"49243"
"1";"0";"1";"9";"72";"49246"
"1";"0";"1";"9";"72";"49252"
"4";"1";"3";"9";"72";"49257"
"4";"1";"3";"9";"72";"49258"
"8";"3";"5";"9";"72";"49259"
"2";"1";"1";"9";"72";"49267"
"3";"1";"2";"9";"72";"49270"
"4";"1";"3";"9";"72";"49271"
"4";"0";"4";"9";"72";"49272"
"3";"1";"2";"9";"72";"49273"
"3";"1";"2";"9";"72";"49276"
"2";"2";"0";"9";"72";"49278"
"2";"0";"2";"9";"72";"49279"
"6";"2";"4";"9";"72";"49280"
"1";"1";"0";"9";"72";"49281"
"2";"0";"2";"9";"72";"49283"
"4";"0";"4";"9";"72";"49286"
"2";"0";"2";"9";"72";"49290"
"6";"4";"2";"9";"72";"49291"
"12";"2";"10";"9";"72";"49295"
"7";"2";"5";"9";"72";"49307"
"2";"1";"1";"9";"72";"49318"
"1";"0";"1";"9";"72";"49320"
"11";"1";"10";"9";"72";"49324"
"9";"1";"8";"9";"72";"49331"
"7";"1";"6";"9";"72";"49335"
"2";"1";"1";"9";"72";"49340"
"4";"1";"3";"9";"72";"49343"
"1";"1";"0";"9";"72";"49347"
"1";"1";"0";"9";"72";"49350"
"2";"0";"2";"9";"72";"49352"
"2";"0";"2";"9";"72";"49355"
"1";"0";"1";"9";"72";"49360"
"2";"0";"2";"9";"72";"49362"
"3";"1";"2";"9";"72";"49367"
"1";"0";"1";"9";"72";"49374"
"1";"0";"1";"9";"72";"49384"
"2";"0";"2";"9";"72";"49386"
"2";"1";"1";"9";"72";"49390"
"4";"0";"4";"9";"72";"49392"
"4";"1";"3";"9";"72";"49397"
"5";"1";"4";"9";"72";"49406"
"6";"0";"6";"9";"72";"49411"
"3";"1";"2";"9";"72";"49413"
"2";"1";"1";"9";"72";"49416"
"3";"0";"3";"9";"72";"49417"
"2";"0";"2";"9";"72";"49420"
"1";"0";"1";"9";"72";"49423"
"4";"2";"2";"9";"72";"49424"
"4";"2";"2";"9";"72";"49426"
"3";"2";"1";"9";"72";"49429"
"6";"1";"5";"9";"72";"49430"
"1";"0";"1";"9";"72";"49431"
"3";"0";"3";"9";"72";"49432"
"1";"0";"1";"9";"72";"49433"
"1";"0";"1";"9";"72";"49435"
"2";"0";"2";"9";"72";"49437"
"1";"1";"0";"9";"72";"49439"
"4";"1";"3";"9";"72";"49444"
"3";"1";"2";"9";"72";"49446"
"1";"0";"1";"9";"72";"49449"
"1";"0";"1";"9";"72";"49451"
"3";"1";"2";"9";"72";"49452"
"3";"1";"2";"9";"72";"49454"
"5";"2";"3";"9";"72";"49456"
"3";"0";"3";"9";"72";"49459"
"1";"0";"1";"9";"72";"49461"
"3";"1";"2";"9";"72";"49468"
"2";"0";"2";"9";"72";"49474"
"6";"2";"4";"9";"72";"49483"
"2";"1";"1";"9";"72";"49484"
"6";"1";"5";"9";"72";"49487"
"2";"0";"2";"9";"72";"49490"
"1";"1";"0";"9";"72";"49491"
"3";"1";"2";"9";"72";"49492"
"4";"1";"3";"9";"72";"49498"
"9";"2";"7";"9";"72";"49500"
"2";"1";"1";"9";"72";"49503"
"2";"0";"2";"9";"72";"49506"
"2";"0";"2";"9";"72";"49508"
"3";"1";"2";"9";"72";"49509"
"2";"0";"2";"9";"72";"49510"
"1";"1";"0";"9";"72";"49511"
"22";"16";"6";"9";"72";"49514"
"4";"0";"4";"9";"72";"49515"
"2";"0";"2";"9";"72";"49518"
"15";"9";"6";"9";"72";"49520"
"2";"1";"1";"9";"72";"49521"
"2";"0";"2";"9";"72";"49525"
"17";"5";"12";"9";"72";"49526"
"1";"1";"0";"9";"72";"49531"
"1";"1";"0";"9";"72";"49532"
"3";"0";"3";"9";"72";"49552"
"4";"1";"3";"9";"72";"49553"
"2";"1";"1";"9";"72";"49554"
"2";"1";"1";"9";"72";"49557"
"1";"0";"1";"9";"72";"49562"
"3";"0";"3";"9";"72";"49571"
"8";"1";"7";"9";"72";"49572"
"5";"1";"4";"9";"72";"49577"
"2";"1";"1";"9";"72";"49579"
"1";"1";"0";"9";"72";"49583"
"1";"1";"0";"9";"72";"49584"
"1";"1";"0";"9";"72";"49589"
"2";"1";"1";"9";"72";"49598"
"2";"0";"2";"9";"72";"49600"
"8";"2";"6";"9";"72";"49603"
"4";"0";"4";"9";"72";"49605"
"1";"0";"1";"9";"72";"49606"
"1";"0";"1";"9";"72";"49613"
"4";"0";"4";"9";"72";"49615"
"3";"1";"2";"9";"72";"49620"
"1";"1";"0";"9";"72";"49624"
"1";"1";"0";"9";"72";"49626"
"1";"1";"0";"9";"72";"49627"
"11";"1";"10";"9";"72";"49630"
"1";"0";"1";"9";"72";"49631"
"1";"0";"1";"9";"72";"49632"
"1";"0";"1";"9";"72";"49633"
"4";"1";"3";"9";"72";"49636"
"2";"0";"2";"9";"72";"49649"
"2";"0";"2";"9";"72";"49655"
"1";"0";"1";"9";"72";"49659"
"2";"0";"2";"9";"72";"49661"
"9";"1";"8";"9";"72";"49675"
"1";"0";"1";"9";"72";"49684"
"4";"0";"4";"9";"72";"49685"
"3";"0";"3";"9";"72";"49686"
"3";"1";"2";"9";"72";"49687"
"3";"0";"3";"9";"72";"49690"
"2";"0";"2";"9";"72";"49691"
"6";"1";"5";"9";"72";"49693"
"1";"1";"0";"9";"72";"49696"
"2";"1";"1";"9";"72";"49698"
"3";"1";"2";"9";"72";"49711"
"5";"2";"3";"9";"72";"49722"
"2";"0";"2";"9";"72";"49727"
"1";"1";"0";"9";"72";"49730"
"7";"1";"6";"9";"72";"49731"
"2";"0";"2";"9";"72";"49732"
"3";"1";"2";"9";"72";"49737"
"4";"1";"3";"9";"72";"49738"
"1";"1";"0";"9";"72";"49739"
"2";"1";"1";"9";"72";"49740"
"1";"1";"0";"9";"72";"49741"
"3";"1";"2";"9";"72";"49744"
"2";"1";"1";"9";"72";"49746"
"2";"0";"2";"9";"72";"49747"
"1";"0";"1";"9";"72";"49748"
"3";"0";"3";"9";"72";"49762"
"1";"1";"0";"9";"72";"49764"
"3";"1";"2";"9";"72";"49767"
"3";"1";"2";"9";"72";"49770"
"32";"26";"6";"9";"72";"49783"
"1";"1";"0";"9";"72";"49784"
"2";"1";"1";"9";"72";"49785"
"3";"0";"3";"9";"72";"49787"
"3";"1";"2";"9";"72";"49788"
"5";"1";"4";"9";"72";"49802"
"3";"0";"3";"9";"72";"49809"
"2";"0";"2";"9";"72";"49815"
"5";"2";"3";"9";"72";"49816"
"1";"0";"1";"9";"72";"49819"
"3";"2";"1";"9";"72";"49820"
"3";"1";"2";"9";"72";"49821"
"3";"1";"2";"9";"72";"49824"
"1";"0";"1";"9";"72";"49827"
"3";"1";"2";"9";"72";"49829"
"1";"1";"0";"9";"72";"49830"
"1";"0";"1";"9";"72";"49832"
"9";"3";"6";"9";"72";"49833"
"1";"0";"1";"9";"72";"49834"
"1";"1";"0";"9";"72";"49838"
"4";"2";"2";"9";"72";"49839"
"3";"1";"2";"9";"72";"49842"
"1";"0";"1";"9";"72";"49847"
"1";"0";"1";"9";"72";"49850"
"6";"1";"5";"9";"72";"49854"
"2";"1";"1";"9";"72";"49855"
"2";"1";"1";"9";"72";"49856"
"3";"0";"3";"9";"72";"49857"
"3";"1";"2";"9";"72";"49858"
"2";"0";"2";"9";"72";"49862"
"1";"1";"0";"9";"72";"49866"
"4";"1";"3";"9";"72";"49868"
"4";"1";"3";"9";"72";"49869"
"1";"0";"1";"9";"72";"49875"
"1";"1";"0";"9";"72";"49880"
"1";"0";"1";"9";"72";"49882"
"5";"2";"3";"9";"72";"49883"
"5";"2";"3";"9";"72";"49884"
"2";"1";"1";"9";"72";"49886"
"2";"0";"2";"9";"72";"49888"
"2";"0";"2";"9";"72";"49889"
"2";"1";"1";"9";"72";"49891"
"1";"1";"0";"9";"72";"49893"
"9";"3";"6";"9";"72";"49894"
"5";"3";"2";"9";"72";"49896"
"1";"1";"0";"9";"72";"49898"
"5";"2";"3";"9";"72";"49899"
"2";"1";"1";"9";"72";"49903"
"4";"2";"2";"9";"72";"49907"
"1";"0";"1";"9";"72";"49909"
"3";"1";"2";"9";"72";"49915"
"2";"1";"1";"9";"72";"49916"
"1";"0";"1";"9";"72";"49929"
"3";"0";"3";"9";"72";"49934"
"5";"2";"3";"9";"72";"49937"
"1";"1";"0";"9";"72";"49939"
"1";"1";"0";"9";"72";"49940"
"6";"2";"4";"9";"72";"49946"
"2";"1";"1";"9";"72";"49950"
"1";"0";"1";"9";"72";"49952"
"1";"1";"0";"9";"72";"49953"
"4";"0";"4";"9";"72";"49957"
"3";"2";"1";"9";"72";"49959"
"3";"0";"3";"9";"72";"49961"
"4";"1";"3";"9";"72";"49963"
"3";"1";"2";"9";"72";"49964"
"2";"1";"1";"9";"72";"49966"
"7";"1";"6";"9";"72";"49968"
"3";"1";"2";"9";"72";"49969"
"5";"1";"4";"9";"72";"49975"
"8";"4";"4";"9";"72";"49976"
"3";"1";"2";"9";"72";"49979"
"4";"1";"3";"9";"72";"49981"
"4";"0";"4";"9";"72";"49982"
"1";"1";"0";"9";"72";"49987"
"1";"0";"1";"9";"72";"49988"
"2";"1";"1";"9";"72";"49989"
"4";"1";"3";"9";"72";"49991"
"4";"1";"3";"9";"72";"49992"
"10";"3";"7";"9";"72";"49993"
"3";"1";"2";"9";"72";"50000"
"2";"1";"1";"9";"72";"50005"
"1";"0";"1";"9";"72";"50006"
"3";"0";"3";"9";"72";"50014"
"1";"0";"1";"9";"72";"50019"
"2";"0";"2";"9";"72";"50023"
"4";"1";"3";"9";"72";"50025"
"3";"1";"2";"9";"72";"50028"
"6";"1";"5";"9";"72";"50036"
"2";"0";"2";"9";"72";"50037"
"3";"0";"3";"9";"72";"50041"
"4";"1";"3";"9";"72";"50044"
"2";"1";"1";"9";"72";"50045"
"3";"0";"3";"9";"72";"50046"
"1";"0";"1";"9";"72";"50047"
"2";"0";"2";"9";"72";"50051"
"2";"2";"0";"9";"72";"50052"
"2";"1";"1";"9";"72";"50058"
"2";"1";"1";"9";"72";"50063"
"1";"0";"1";"9";"72";"50065"
"1";"1";"0";"9";"72";"50066"
"5";"2";"3";"9";"72";"50067"
"1";"1";"0";"9";"72";"50069"
"2";"0";"2";"9";"72";"50071"
"1";"1";"0";"9";"72";"50077"
"1";"0";"1";"9";"72";"50078"
"8";"4";"4";"9";"72";"50079"
"2";"1";"1";"9";"72";"50082"
"5";"1";"4";"9";"72";"50083"
"2";"0";"2";"9";"72";"50084"
"1";"0";"1";"9";"72";"50088"
"3";"0";"3";"9";"72";"50100"
"2";"0";"2";"9";"72";"50103"
"2";"0";"2";"9";"72";"50107"
"1";"1";"0";"9";"72";"50110"
"1";"0";"1";"9";"72";"50111"
"2";"1";"1";"9";"72";"50119"
"2";"0";"2";"9";"72";"50120"
"4";"1";"3";"9";"72";"50121"
"2";"1";"1";"9";"72";"50123"
"1";"1";"0";"9";"72";"50124"
"1";"0";"1";"9";"72";"50125"
"2";"1";"1";"9";"72";"50131"
"1";"0";"1";"9";"72";"50132"
"4";"1";"3";"9";"72";"50134"
"2";"0";"2";"9";"72";"50137"
"2";"0";"2";"9";"72";"50140"
"1";"0";"1";"9";"72";"50142"
"2";"1";"1";"9";"72";"50145"
"2";"0";"2";"9";"72";"50146"
"3";"0";"3";"9";"72";"50151"
"4";"0";"4";"9";"72";"50152"
"4";"2";"2";"9";"72";"50155"
"1";"0";"1";"9";"72";"50156"
"4";"1";"3";"9";"72";"50157"
"2";"0";"2";"9";"72";"50158"
"3";"0";"3";"9";"72";"50159"
"1";"0";"1";"9";"72";"50166"
"2";"1";"1";"9";"72";"50167"
"5";"0";"5";"9";"72";"50168"
"1";"0";"1";"9";"72";"50170"
"3";"1";"2";"9";"72";"50172"
"1";"0";"1";"9";"72";"50174"
"1";"1";"0";"9";"72";"50177"
