"degree";"indegree";"outdegree";"id_community";"period";"id_user"
"120";"69";"51";"10";"63";"50181"
"14";"7";"7";"10";"63";"50184"
"44";"26";"18";"10";"63";"50185"
"24";"9";"15";"10";"63";"50186"
"194";"149";"45";"10";"63";"50188"
"10";"1";"9";"10";"63";"50190"
"3";"0";"3";"10";"63";"50191"
"4";"2";"2";"10";"63";"50192"
"11";"6";"5";"10";"63";"50195"
"279";"187";"92";"10";"63";"50196"
"26";"6";"20";"10";"63";"50197"
"4";"2";"2";"10";"63";"50198"
"43";"25";"18";"10";"63";"50199"
"6";"0";"6";"10";"63";"50203"
"319";"190";"129";"10";"63";"50204"
"1";"1";"0";"10";"63";"50205"
"48";"34";"14";"10";"63";"50206"
"11";"3";"8";"10";"63";"50208"
"18";"7";"11";"10";"63";"50209"
"8";"0";"8";"10";"63";"50210"
"2";"1";"1";"10";"63";"50212"
"177";"134";"43";"10";"63";"50213"
"11";"6";"5";"10";"63";"50216"
"20";"6";"14";"10";"63";"50217"
"4";"3";"1";"10";"63";"50219"
"32";"10";"22";"10";"63";"50221"
"21";"6";"15";"10";"63";"50224"
"2";"0";"2";"10";"63";"50226"
"15";"0";"15";"10";"63";"50227"
"3";"1";"2";"10";"63";"50228"
"37";"10";"27";"10";"63";"50231"
"6";"3";"3";"10";"63";"50234"
"22";"20";"2";"10";"63";"50235"
"25";"12";"13";"10";"63";"50238"
"5";"5";"0";"10";"63";"50239"
"5";"3";"2";"10";"63";"50240"
"3";"0";"3";"10";"63";"50241"
"385";"352";"33";"10";"63";"50247"
"29";"6";"23";"10";"63";"50248"
"71";"55";"16";"10";"63";"50252"
"1";"1";"0";"10";"63";"50253"
"503";"409";"94";"10";"63";"50255"
"4";"1";"3";"10";"63";"50256"
"35";"15";"20";"10";"63";"50257"
"178";"112";"66";"10";"63";"50258"
"6";"0";"6";"10";"63";"50259"
"4";"2";"2";"10";"63";"50261"
"10";"2";"8";"10";"63";"50264"
"15";"6";"9";"10";"63";"50265"
"12";"3";"9";"10";"63";"50266"
"1";"0";"1";"10";"63";"50267"
"2";"0";"2";"10";"63";"50268"
"15";"4";"11";"10";"63";"50270"
"25";"9";"16";"10";"63";"50275"
"4";"4";"0";"10";"63";"50277"
"143";"132";"11";"10";"63";"50278"
"4";"0";"4";"10";"63";"50279"
"19";"11";"8";"10";"63";"50280"
"9";"0";"9";"10";"63";"50283"
"8";"4";"4";"10";"63";"50284"
"96";"44";"52";"10";"63";"50287"
"6";"1";"5";"10";"63";"50288"
"15";"4";"11";"10";"63";"50291"
"69";"33";"36";"10";"63";"50294"
"31";"10";"21";"10";"63";"50297"
"1";"1";"0";"10";"63";"50298"
"7";"6";"1";"10";"63";"50301"
"3";"1";"2";"10";"63";"50303"
"61";"28";"33";"10";"63";"50306"
"3";"3";"0";"10";"63";"50309"
"100";"76";"24";"10";"63";"50310"
"84";"46";"38";"10";"63";"50312"
"2";"0";"2";"10";"63";"50313"
"11";"1";"10";"10";"63";"50316"
"26";"9";"17";"10";"63";"50317"
"35";"6";"29";"10";"63";"50318"
"58";"23";"35";"10";"63";"50321"
"7";"2";"5";"10";"63";"50324"
"4";"1";"3";"10";"63";"50325"
"6";"1";"5";"10";"63";"50327"
"70";"53";"17";"10";"63";"50332"
"2";"2";"0";"10";"63";"50337"
"7";"1";"6";"10";"63";"50339"
"2";"1";"1";"10";"63";"50340"
"4";"1";"3";"10";"63";"50342"
"1";"1";"0";"10";"63";"50343"
"1";"1";"0";"10";"63";"50345"
"6";"3";"3";"10";"63";"50348"
"2";"1";"1";"10";"63";"50351"
"344";"226";"118";"10";"63";"50357"
"1";"1";"0";"10";"63";"50359"
"394";"319";"75";"10";"63";"50360"
"154";"119";"35";"10";"63";"50365"
"3";"0";"3";"10";"63";"50367"
"1";"0";"1";"10";"63";"50369"
"5";"1";"4";"10";"63";"50370"
"3";"0";"3";"10";"63";"50381"
"24";"1";"23";"10";"63";"50387"
"1";"1";"0";"10";"63";"50390"
"4";"1";"3";"10";"63";"50391"
"7";"1";"6";"10";"63";"50392"
"6";"0";"6";"10";"63";"50393"
"1";"1";"0";"10";"63";"50396"
"9";"2";"7";"10";"63";"50399"
"6";"4";"2";"10";"63";"50400"
"1";"1";"0";"10";"63";"50401"
"1";"1";"0";"10";"63";"50402"
"2";"0";"2";"10";"63";"50403"
"2";"1";"1";"10";"63";"50405"
"2";"1";"1";"10";"63";"50406"
"1";"1";"0";"10";"63";"50407"
"3";"0";"3";"10";"63";"50409"
"31";"25";"6";"10";"63";"50412"
"11";"1";"10";"10";"63";"50415"
"33";"23";"10";"10";"63";"50418"
"2";"0";"2";"10";"63";"50420"
"10";"2";"8";"10";"63";"50422"
"20";"3";"17";"10";"63";"50423"
"13";"4";"9";"10";"63";"50425"
"2";"1";"1";"10";"63";"50426"
"6";"3";"3";"10";"63";"50428"
"51";"43";"8";"10";"63";"50430"
"5";"5";"0";"10";"63";"50432"
"6";"0";"6";"10";"63";"50433"
"2";"0";"2";"10";"63";"50436"
"10";"2";"8";"10";"63";"50437"
"6";"2";"4";"10";"63";"50439"
"5";"2";"3";"10";"63";"50440"
"1099";"838";"261";"10";"63";"50441"
"3";"0";"3";"10";"63";"50443"
"4";"2";"2";"10";"63";"50447"
"63";"51";"12";"10";"63";"50449"
"2";"0";"2";"10";"63";"50450"
"12";"4";"8";"10";"63";"50454"
"13";"5";"8";"10";"63";"50457"
"14";"11";"3";"10";"63";"50461"
"10";"2";"8";"10";"63";"50464"
"5";"1";"4";"10";"63";"50465"
"3";"0";"3";"10";"63";"50466"
"21";"6";"15";"10";"63";"50467"
"217";"153";"64";"10";"63";"50469"
"6";"4";"2";"10";"63";"50473"
"2";"0";"2";"10";"63";"50477"
"4";"1";"3";"10";"63";"50479"
"5";"1";"4";"10";"63";"50482"
"7";"4";"3";"10";"63";"50483"
"4";"2";"2";"10";"63";"50484"
"51";"30";"21";"10";"63";"50486"
"12";"8";"4";"10";"63";"50487"
"8";"1";"7";"10";"63";"50488"
"64";"42";"22";"10";"63";"50490"
"2";"0";"2";"10";"63";"50491"
"5";"1";"4";"10";"63";"50494"
"10";"2";"8";"10";"63";"50496"
"8";"2";"6";"10";"63";"50499"
"4";"0";"4";"10";"63";"50502"
"7";"3";"4";"10";"63";"50503"
"14";"6";"8";"10";"63";"50504"
"4";"4";"0";"10";"63";"50505"
"3";"1";"2";"10";"63";"50506"
"21";"13";"8";"10";"63";"50507"
"17";"7";"10";"10";"63";"50508"
"1";"0";"1";"10";"63";"50509"
"13";"4";"9";"10";"63";"50510"
"18";"2";"16";"10";"63";"50513"
"2";"0";"2";"10";"63";"50514"
"3";"0";"3";"10";"63";"50516"
"2";"0";"2";"10";"63";"50517"
"118";"63";"55";"10";"63";"50518"
"1";"0";"1";"10";"63";"50520"
"10";"1";"9";"10";"63";"50521"
"15";"3";"12";"10";"63";"50522"
"2";"0";"2";"10";"63";"50529"
"4";"0";"4";"10";"63";"50530"
"6";"2";"4";"10";"63";"50531"
"25";"4";"21";"10";"63";"50532"
"17";"4";"13";"10";"63";"50533"
"4";"1";"3";"10";"63";"50536"
"18";"9";"9";"10";"63";"50537"
"21";"11";"10";"10";"63";"50538"
"8";"7";"1";"10";"63";"50543"
"2";"0";"2";"10";"63";"50545"
"5";"1";"4";"10";"63";"50547"
"121";"48";"73";"10";"63";"50548"
"2";"2";"0";"10";"63";"50549"
"2";"0";"2";"10";"63";"50551"
"10";"2";"8";"10";"63";"50553"
"9";"1";"8";"10";"63";"50554"
"2";"0";"2";"10";"63";"50556"
"2";"0";"2";"10";"63";"50558"
"18";"3";"15";"10";"63";"50560"
"14";"9";"5";"10";"63";"50561"
"1318";"986";"332";"10";"63";"50562"
"1";"1";"0";"10";"63";"50564"
"5";"1";"4";"10";"63";"50565"
"1";"0";"1";"10";"63";"50566"
"5";"0";"5";"10";"63";"50567"
"6";"3";"3";"10";"63";"50574"
"5";"0";"5";"10";"63";"50575"
"49";"36";"13";"10";"63";"50582"
"11";"4";"7";"10";"63";"50583"
"6";"2";"4";"10";"63";"50586"
"23";"14";"9";"10";"63";"50587"
"2";"0";"2";"10";"63";"50589"
"4";"1";"3";"10";"63";"50592"
"5";"2";"3";"10";"63";"50597"
"8";"2";"6";"10";"63";"50598"
"2";"0";"2";"10";"63";"50599"
"6";"3";"3";"10";"63";"50600"
"7";"2";"5";"10";"63";"50604"
"184";"117";"67";"10";"63";"50605"
"6";"6";"0";"10";"63";"50606"
"1";"1";"0";"10";"63";"50608"
"20";"13";"7";"10";"63";"50611"
"2";"0";"2";"10";"63";"50612"
"3";"0";"3";"10";"63";"50613"
"6";"2";"4";"10";"63";"50614"
"12";"3";"9";"10";"63";"50615"
"3";"2";"1";"10";"63";"50618"
"1";"0";"1";"10";"63";"50620"
"770";"648";"122";"10";"63";"50621"
"2";"1";"1";"10";"63";"50622"
"18";"4";"14";"10";"63";"50623"
"4";"0";"4";"10";"63";"50624"
"1";"1";"0";"10";"63";"50625"
"3";"3";"0";"10";"63";"50626"
"1";"0";"1";"10";"63";"50627"
"6";"0";"6";"10";"63";"50629"
"6";"1";"5";"10";"63";"50630"
"5";"2";"3";"10";"63";"50632"
"1";"1";"0";"10";"63";"50635"
"13";"12";"1";"10";"63";"50638"
"11";"4";"7";"10";"63";"50639"
"3";"0";"3";"10";"63";"50640"
"1";"1";"0";"10";"63";"50642"
"6";"2";"4";"10";"63";"50644"
"20";"15";"5";"10";"63";"50647"
"1";"1";"0";"10";"63";"50648"
"1";"0";"1";"10";"63";"50649"
"1";"0";"1";"10";"63";"50651"
"5";"1";"4";"10";"63";"50652"
"6";"2";"4";"10";"63";"50653"
"8";"1";"7";"10";"63";"50654"
"1";"0";"1";"10";"63";"50655"
"1";"1";"0";"10";"63";"50658"
"7";"2";"5";"10";"63";"50660"
"2";"0";"2";"10";"63";"50661"
"6";"1";"5";"10";"63";"50664"
"62";"43";"19";"10";"63";"50666"
"4";"0";"4";"10";"63";"50667"
"5";"1";"4";"10";"63";"50670"
"22";"7";"15";"10";"63";"50672"
"6";"1";"5";"10";"63";"50673"
"1";"0";"1";"10";"63";"50674"
"21";"3";"18";"10";"63";"50676"
"13";"13";"0";"10";"63";"50681"
"2";"0";"2";"10";"63";"50682"
"2";"0";"2";"10";"63";"50685"
"4";"0";"4";"10";"63";"50686"
"2";"2";"0";"10";"63";"50687"
"2";"1";"1";"10";"63";"50690"
"2";"0";"2";"10";"63";"50691"
"6";"1";"5";"10";"63";"50695"
"10";"1";"9";"10";"63";"50698"
"3";"0";"3";"10";"63";"50700"
"71";"38";"33";"10";"63";"50701"
"3";"1";"2";"10";"63";"50702"
"7";"1";"6";"10";"63";"50704"
"16";"4";"12";"10";"63";"50705"
"1";"1";"0";"10";"63";"50707"
"5";"0";"5";"10";"63";"50708"
"4";"1";"3";"10";"63";"50709"
"1";"0";"1";"10";"63";"50711"
"1";"1";"0";"10";"63";"50712"
"28";"10";"18";"10";"63";"50713"
"10";"4";"6";"10";"63";"50714"
"7";"1";"6";"10";"63";"50715"
"1";"1";"0";"10";"63";"50717"
"5";"1";"4";"10";"63";"50718"
"2";"1";"1";"10";"63";"50719"
"28";"22";"6";"10";"63";"50720"
"2";"1";"1";"10";"63";"50723"
"9";"0";"9";"10";"63";"50725"
"3";"1";"2";"10";"63";"50727"
"14";"0";"14";"10";"63";"50728"
"8";"5";"3";"10";"63";"50730"
"61";"42";"19";"10";"63";"50733"
"1";"0";"1";"10";"63";"50735"
"9";"4";"5";"10";"63";"50736"
"8";"1";"7";"10";"63";"50738"
"3";"1";"2";"10";"63";"50740"
"12";"4";"8";"10";"63";"50741"
"5";"2";"3";"10";"63";"50743"
"3";"1";"2";"10";"63";"50744"
"5";"2";"3";"10";"63";"50745"
"12";"0";"12";"10";"63";"50751"
"2";"2";"0";"10";"63";"50752"
"8";"3";"5";"10";"63";"50753"
"7";"0";"7";"10";"63";"50754"
"13";"10";"3";"10";"63";"50757"
"5";"1";"4";"10";"63";"50758"
"23";"4";"19";"10";"63";"50760"
"12";"8";"4";"10";"63";"50762"
"4";"0";"4";"10";"63";"50763"
"9";"1";"8";"10";"63";"50766"
"3";"0";"3";"10";"63";"50767"
"11";"2";"9";"10";"63";"50768"
"24";"10";"14";"10";"63";"50771"
"101";"71";"30";"10";"63";"50775"
"6";"3";"3";"10";"63";"50776"
"5";"1";"4";"10";"63";"50777"
"3";"1";"2";"10";"63";"50778"
"2";"0";"2";"10";"63";"50779"
"3";"0";"3";"10";"63";"50780"
"1";"0";"1";"10";"63";"50781"
"2";"0";"2";"10";"63";"50783"
"6";"1";"5";"10";"63";"50784"
"5";"2";"3";"10";"63";"50785"
"2";"1";"1";"10";"63";"50786"
"5";"2";"3";"10";"63";"50788"
"4";"0";"4";"10";"63";"50789"
"2";"1";"1";"10";"63";"50790"
"15";"8";"7";"10";"63";"50793"
"5";"3";"2";"10";"63";"50795"
"6";"0";"6";"10";"63";"50796"
"13";"9";"4";"10";"63";"50797"
"2";"1";"1";"10";"63";"50801"
"58";"44";"14";"10";"63";"50803"
"10";"2";"8";"10";"63";"50805"
"3";"1";"2";"10";"63";"50806"
"2";"0";"2";"10";"63";"50808"
"18";"6";"12";"10";"63";"50810"
"5";"1";"4";"10";"63";"50812"
"3";"0";"3";"10";"63";"50814"
"2";"1";"1";"10";"63";"50815"
"2";"0";"2";"10";"63";"50817"
"2";"0";"2";"10";"63";"50818"
"2";"0";"2";"10";"63";"50819"
"6";"1";"5";"10";"63";"50823"
"1";"0";"1";"10";"63";"50824"
"18";"15";"3";"10";"63";"50825"
"63";"12";"51";"10";"63";"50828"
"4";"0";"4";"10";"63";"50829"
"2";"0";"2";"10";"63";"50830"
"6";"0";"6";"10";"63";"50831"
"1";"0";"1";"10";"63";"50832"
"6";"1";"5";"10";"63";"50834"
"13";"5";"8";"10";"63";"50835"
"3";"1";"2";"10";"63";"50837"
"2";"0";"2";"10";"63";"50838"
"6";"2";"4";"10";"63";"50841"
"2";"0";"2";"10";"63";"50843"
"8";"2";"6";"10";"63";"50844"
"18";"7";"11";"10";"63";"50845"
"1";"1";"0";"10";"63";"50848"
"4";"0";"4";"10";"63";"50851"
"3";"1";"2";"10";"63";"50853"
"39";"7";"32";"10";"63";"50854"
"2";"0";"2";"10";"63";"50855"
"19";"12";"7";"10";"63";"50856"
"2";"0";"2";"10";"63";"50858"
"4";"2";"2";"10";"63";"50859"
"4";"0";"4";"10";"63";"50860"
"2";"1";"1";"10";"63";"50862"
"4";"1";"3";"10";"63";"50865"
"2";"1";"1";"10";"63";"50867"
"12";"8";"4";"10";"63";"50869"
"12";"3";"9";"10";"63";"50870"
"7";"2";"5";"10";"63";"50872"
"1";"1";"0";"10";"63";"50873"
"33";"13";"20";"10";"63";"50875"
"3";"2";"1";"10";"63";"50876"
"1";"1";"0";"10";"63";"50878"
"2";"0";"2";"10";"63";"50879"
"2";"1";"1";"10";"63";"50880"
"2";"0";"2";"10";"63";"50881"
"9";"3";"6";"10";"63";"50882"
"7";"1";"6";"10";"63";"50883"
"9";"4";"5";"10";"63";"50884"
"5";"2";"3";"10";"63";"50885"
"8";"4";"4";"10";"63";"50886"
"19";"13";"6";"10";"63";"50888"
"4";"1";"3";"10";"63";"50891"
"2";"0";"2";"10";"63";"50892"
"4";"0";"4";"10";"63";"50893"
"24";"5";"19";"10";"63";"50896"
"14";"0";"14";"10";"63";"50899"
"3";"0";"3";"10";"63";"50900"
"1";"1";"0";"10";"63";"50901"
"5";"0";"5";"10";"63";"50902"
"3";"0";"3";"10";"63";"50904"
"2";"0";"2";"10";"63";"50907"
"1";"1";"0";"10";"63";"50909"
"4";"0";"4";"10";"63";"50910"
"4";"1";"3";"10";"63";"50916"
"7";"1";"6";"10";"63";"50920"
"1";"0";"1";"10";"63";"50923"
"1";"1";"0";"10";"63";"50925"
"4";"2";"2";"10";"63";"50929"
"4";"0";"4";"10";"63";"50932"
"2";"0";"2";"10";"63";"50933"
"2";"0";"2";"10";"63";"50935"
"10";"1";"9";"10";"63";"50936"
"2";"1";"1";"10";"63";"50937"
"4";"1";"3";"10";"63";"50938"
"482";"411";"71";"10";"63";"50939"
"5";"0";"5";"10";"63";"50940"
"3";"2";"1";"10";"63";"50943"
"5";"1";"4";"10";"63";"50945"
"6";"2";"4";"10";"63";"50946"
"64";"14";"50";"10";"63";"50947"
"4";"0";"4";"10";"63";"50948"
"3";"2";"1";"10";"63";"50949"
"2";"0";"2";"10";"63";"50953"
"5";"1";"4";"10";"63";"50955"
"1";"0";"1";"10";"63";"50957"
"6";"1";"5";"10";"63";"50959"
"2";"0";"2";"10";"63";"50962"
"3";"1";"2";"10";"63";"50963"
"3";"1";"2";"10";"63";"50964"
"4";"1";"3";"10";"63";"50966"
"32";"19";"13";"10";"63";"50968"
"12";"3";"9";"10";"63";"50969"
"2";"0";"2";"10";"63";"50971"
"11";"1";"10";"10";"63";"50973"
"2";"0";"2";"10";"63";"50974"
"4";"0";"4";"10";"63";"50975"
"6";"0";"6";"10";"63";"50980"
"1";"1";"0";"10";"63";"50982"
"8";"7";"1";"10";"63";"50983"
"2";"1";"1";"10";"63";"50984"
"4";"1";"3";"10";"63";"50985"
"3";"0";"3";"10";"63";"50987"
"7";"2";"5";"10";"63";"50988"
"2";"1";"1";"10";"63";"50989"
"6";"1";"5";"10";"63";"50992"
"3";"1";"2";"10";"63";"50993"
"5";"1";"4";"10";"63";"50995"
"7";"5";"2";"10";"63";"50996"
"1";"1";"0";"10";"63";"50997"
"1";"0";"1";"10";"63";"50999"
"4";"0";"4";"10";"63";"51000"
"3";"0";"3";"10";"63";"51001"
"1";"1";"0";"10";"63";"51005"
"2";"0";"2";"10";"63";"51006"
"1";"1";"0";"10";"63";"51007"
"2";"1";"1";"10";"63";"51012"
"3";"1";"2";"10";"63";"51014"
"13";"2";"11";"10";"63";"51015"
"21";"17";"4";"10";"63";"51017"
"5";"1";"4";"10";"63";"51019"
"30";"10";"20";"10";"63";"51024"
"7";"3";"4";"10";"63";"51026"
"4";"2";"2";"10";"63";"51030"
"2";"0";"2";"10";"63";"51031"
"4";"2";"2";"10";"63";"51032"
"13";"5";"8";"10";"63";"51035"
"5";"2";"3";"10";"63";"51039"
"4";"1";"3";"10";"63";"51040"
"2";"2";"0";"10";"63";"51041"
"2";"2";"0";"10";"63";"51042"
"7";"0";"7";"10";"63";"51043"
"4";"0";"4";"10";"63";"51044"
"1";"0";"1";"10";"63";"51048"
"6";"2";"4";"10";"63";"51054"
"6";"2";"4";"10";"63";"51058"
"3";"1";"2";"10";"63";"51060"
"2";"1";"1";"10";"63";"51061"
"19";"15";"4";"10";"63";"51065"
"3";"1";"2";"10";"63";"51067"
"1";"0";"1";"10";"63";"51072"
"4";"0";"4";"10";"63";"51075"
"8";"3";"5";"10";"63";"51076"
"5";"0";"5";"10";"63";"51077"
"31";"8";"23";"10";"63";"51078"
"7";"2";"5";"10";"63";"51079"
"1";"0";"1";"10";"63";"51082"
"1";"0";"1";"10";"63";"51083"
"1";"1";"0";"10";"63";"51084"
"1";"1";"0";"10";"63";"51086"
"6";"3";"3";"10";"63";"51087"
"2";"0";"2";"10";"63";"51088"
"1";"0";"1";"10";"63";"51089"
"2";"0";"2";"10";"63";"51091"
"2";"0";"2";"10";"63";"51092"
"5";"1";"4";"10";"63";"51093"
"6";"1";"5";"10";"63";"51094"
"25";"12";"13";"10";"63";"51098"
"2";"0";"2";"10";"63";"51099"
"1";"0";"1";"10";"63";"51100"
"23";"23";"0";"10";"63";"51102"
"15";"3";"12";"10";"63";"51104"
"2";"2";"0";"10";"63";"51105"
"13";"4";"9";"10";"63";"51108"
"11";"2";"9";"10";"63";"51109"
"2";"1";"1";"10";"63";"51110"
"21";"16";"5";"10";"63";"51111"
"8";"0";"8";"10";"63";"51112"
"12";"2";"10";"10";"63";"51113"
"17";"2";"15";"10";"63";"51115"
"5";"1";"4";"10";"63";"51121"
"6";"3";"3";"10";"63";"51122"
"8";"3";"5";"10";"63";"51124"
"4";"2";"2";"10";"63";"51126"
"3";"0";"3";"10";"63";"51127"
"1";"1";"0";"10";"63";"51130"
"5";"4";"1";"10";"63";"51134"
"2";"0";"2";"10";"63";"51135"
"2";"0";"2";"10";"63";"51139"
"4";"1";"3";"10";"63";"51140"
"4";"1";"3";"10";"63";"51145"
"20";"16";"4";"10";"63";"51146"
"2";"0";"2";"10";"63";"51147"
"4";"1";"3";"10";"63";"51149"
"1";"1";"0";"10";"63";"51152"
"1";"1";"0";"10";"63";"51153"
"2";"0";"2";"10";"63";"51154"
"8";"0";"8";"10";"63";"51157"
"2";"0";"2";"10";"63";"51159"
"5";"0";"5";"10";"63";"51162"
"3";"0";"3";"10";"63";"51163"
"2";"0";"2";"10";"63";"51168"
"1";"0";"1";"10";"63";"51169"
"2";"0";"2";"10";"63";"51170"
"5";"1";"4";"10";"63";"51171"
"3";"1";"2";"10";"63";"51172"
"1";"1";"0";"10";"63";"51175"
"2";"0";"2";"10";"63";"51177"
"3";"1";"2";"10";"63";"51178"
"7";"0";"7";"10";"63";"51179"
"1";"0";"1";"10";"63";"51181"
"4";"0";"4";"10";"63";"51182"
"6";"0";"6";"10";"63";"51183"
"3";"2";"1";"10";"63";"51184"
"6";"0";"6";"10";"63";"51187"
"9";"6";"3";"10";"63";"51190"
"2";"1";"1";"10";"63";"51192"
"3";"0";"3";"10";"63";"51194"
"20";"7";"13";"10";"63";"51195"
"96";"67";"29";"10";"63";"51196"
"4";"2";"2";"10";"63";"51198"
"8";"2";"6";"10";"63";"51204"
"5";"2";"3";"10";"63";"51206"
"4";"2";"2";"10";"63";"51207"
"1";"0";"1";"10";"63";"51208"
"18";"10";"8";"10";"63";"51210"
"3";"0";"3";"10";"63";"51213"
"2";"0";"2";"10";"63";"51214"
"1";"0";"1";"10";"63";"51215"
"1";"0";"1";"10";"63";"51219"
"1";"1";"0";"10";"63";"51220"
"3";"0";"3";"10";"63";"51221"
"1";"0";"1";"10";"63";"51227"
"6";"2";"4";"10";"63";"51231"
"1";"1";"0";"10";"63";"51232"
"6";"2";"4";"10";"63";"51233"
"5";"1";"4";"10";"63";"51234"
"4";"4";"0";"10";"63";"51235"
"4";"1";"3";"10";"63";"51236"
"1";"1";"0";"10";"63";"51237"
"3";"1";"2";"10";"63";"51238"
"8";"7";"1";"10";"63";"51239"
"24";"12";"12";"10";"63";"51242"
"2";"0";"2";"10";"63";"51244"
"2";"0";"2";"10";"63";"51247"
"5";"2";"3";"10";"63";"51249"
"11";"4";"7";"10";"63";"51250"
"4";"0";"4";"10";"63";"51251"
"3";"1";"2";"10";"63";"51252"
"7";"1";"6";"10";"63";"51253"
"8";"2";"6";"10";"63";"51254"
"1";"1";"0";"10";"63";"51256"
"6";"5";"1";"10";"63";"51259"
"2";"2";"0";"10";"63";"51262"
"57";"14";"43";"10";"63";"51264"
"10";"3";"7";"10";"63";"51266"
"2";"0";"2";"10";"63";"51268"
"3";"1";"2";"10";"63";"51271"
"8";"2";"6";"10";"63";"51272"
"2";"1";"1";"10";"63";"51273"
"2";"1";"1";"10";"63";"51276"
"3";"0";"3";"10";"63";"51277"
"7";"0";"7";"10";"63";"51280"
"4";"1";"3";"10";"63";"51281"
"6";"1";"5";"10";"63";"51282"
"1";"0";"1";"10";"63";"51284"
"10";"2";"8";"10";"63";"51288"
"11";"4";"7";"10";"63";"51290"
"1";"0";"1";"10";"63";"51291"
"2";"0";"2";"10";"63";"51292"
"11";"1";"10";"10";"63";"51293"
"1";"1";"0";"10";"63";"51294"
"2";"0";"2";"10";"63";"51295"
"6";"1";"5";"10";"63";"51297"
"1";"1";"0";"10";"63";"51300"
"3";"1";"2";"10";"63";"51301"
"1";"1";"0";"10";"63";"51302"
"4";"1";"3";"10";"63";"51303"
"13";"3";"10";"10";"63";"51304"
"1";"0";"1";"10";"63";"51305"
"350";"275";"75";"10";"63";"51307"
"1";"1";"0";"10";"63";"51310"
"1";"0";"1";"10";"63";"51311"
"6";"0";"6";"10";"63";"51312"
"5";"1";"4";"10";"63";"51313"
"1";"1";"0";"10";"63";"51315"
"4";"2";"2";"10";"63";"51321"
"64";"47";"17";"10";"63";"51322"
"2";"1";"1";"10";"63";"51323"
"3";"0";"3";"10";"63";"51324"
"6";"2";"4";"10";"63";"51326"
"2";"2";"0";"10";"63";"51327"
"2";"0";"2";"10";"63";"51328"
"11";"2";"9";"10";"63";"51330"
"2";"0";"2";"10";"63";"51331"
"6";"2";"4";"10";"63";"51332"
"12";"2";"10";"10";"63";"51333"
"11";"3";"8";"10";"63";"51334"
"3";"1";"2";"10";"63";"51336"
"4";"0";"4";"10";"63";"51337"
"4";"1";"3";"10";"63";"51339"
"1";"0";"1";"10";"63";"51341"
"68";"46";"22";"10";"63";"51342"
"14";"4";"10";"10";"63";"51344"
"5";"0";"5";"10";"63";"51345"
"2";"2";"0";"10";"63";"51346"
"9";"2";"7";"10";"63";"51347"
"1";"0";"1";"10";"63";"51348"
"1";"1";"0";"10";"63";"51351"
"5";"1";"4";"10";"63";"51355"
"5";"1";"4";"10";"63";"51356"
"2";"0";"2";"10";"63";"51358"
"1";"0";"1";"10";"63";"51359"
"3";"1";"2";"10";"63";"51360"
"42";"29";"13";"10";"63";"51361"
"32";"10";"22";"10";"63";"51362"
"15";"2";"13";"10";"63";"51363"
"1";"0";"1";"10";"63";"51364"
"6";"0";"6";"10";"63";"51366"
"10";"3";"7";"10";"63";"51367"
"7";"0";"7";"10";"63";"51371"
"2";"0";"2";"10";"63";"51373"
"3";"1";"2";"10";"63";"51374"
"3";"1";"2";"10";"63";"51375"
"36";"13";"23";"10";"63";"51377"
"1";"1";"0";"10";"63";"51378"
"198";"132";"66";"10";"63";"51381"
"5";"2";"3";"10";"63";"51384"
"2";"1";"1";"10";"63";"51385"
"4";"1";"3";"10";"63";"51391"
"2";"0";"2";"10";"63";"51395"
"7";"2";"5";"10";"63";"51397"
"4";"0";"4";"10";"63";"51399"
"2";"0";"2";"10";"63";"51404"
"4";"0";"4";"10";"63";"51405"
"1";"0";"1";"10";"63";"51406"
"68";"47";"21";"10";"63";"51407"
"9";"7";"2";"10";"63";"51408"
"1";"1";"0";"10";"63";"51410"
"1";"0";"1";"10";"63";"51411"
"7";"2";"5";"10";"63";"51412"
"4";"1";"3";"10";"63";"51413"
"8";"1";"7";"10";"63";"51414"
"2";"0";"2";"10";"63";"51415"
"2";"0";"2";"10";"63";"51416"
"5";"0";"5";"10";"63";"51417"
"5";"1";"4";"10";"63";"51420"
"7";"3";"4";"10";"63";"51421"
"2";"0";"2";"10";"63";"51424"
"5";"1";"4";"10";"63";"51425"
"60";"37";"23";"10";"63";"51426"
"7";"1";"6";"10";"63";"51428"
"8";"4";"4";"10";"63";"51430"
"4";"0";"4";"10";"63";"51431"
"2";"1";"1";"10";"63";"51432"
"1";"1";"0";"10";"63";"51435"
"1";"0";"1";"10";"63";"51436"
"10";"1";"9";"10";"63";"51441"
"8";"2";"6";"10";"63";"51443"
"6";"0";"6";"10";"63";"51444"
"8";"3";"5";"10";"63";"51445"
"165";"97";"68";"10";"63";"51446"
"7";"1";"6";"10";"63";"51448"
"44";"23";"21";"10";"63";"51449"
"3";"1";"2";"10";"63";"51451"
"1";"0";"1";"10";"63";"51453"
"3";"1";"2";"10";"63";"51457"
"4";"1";"3";"10";"63";"51459"
"1";"0";"1";"10";"63";"51461"
"6";"2";"4";"10";"63";"51463"
"2";"0";"2";"10";"63";"51464"
"2";"1";"1";"10";"63";"51465"
"3";"3";"0";"10";"63";"51466"
"9";"2";"7";"10";"63";"51468"
"2";"1";"1";"10";"63";"51471"
"1";"1";"0";"10";"63";"51472"
"12";"1";"11";"10";"63";"51474"
"1";"0";"1";"10";"63";"51476"
"8";"1";"7";"10";"63";"51477"
"22";"13";"9";"10";"63";"51478"
"2";"0";"2";"10";"63";"51480"
"8";"2";"6";"10";"63";"51481"
"1";"0";"1";"10";"63";"51483"
"2";"0";"2";"10";"63";"51486"
"5";"1";"4";"10";"63";"51490"
"3";"1";"2";"10";"63";"51491"
"5";"1";"4";"10";"63";"51492"
"4";"0";"4";"10";"63";"51494"
"4";"0";"4";"10";"63";"51496"
"1";"0";"1";"10";"63";"51498"
"5";"5";"0";"10";"63";"51499"
"5";"2";"3";"10";"63";"51500"
"660";"548";"112";"10";"63";"51502"
"3";"0";"3";"10";"63";"51503"
"9";"6";"3";"10";"63";"51505"
"2";"0";"2";"10";"63";"51508"
"7";"2";"5";"10";"63";"51511"
"2";"1";"1";"10";"63";"51512"
"1";"0";"1";"10";"63";"51513"
"2";"0";"2";"10";"63";"51514"
"11";"2";"9";"10";"63";"51515"
"1";"1";"0";"10";"63";"51519"
"1";"0";"1";"10";"63";"51521"
"4";"2";"2";"10";"63";"51522"
"4";"1";"3";"10";"63";"51524"
"4";"2";"2";"10";"63";"51525"
"14";"2";"12";"10";"63";"51527"
"1";"1";"0";"10";"63";"51529"
"1";"1";"0";"10";"63";"51531"
"31";"15";"16";"10";"63";"51532"
"4";"1";"3";"10";"63";"51534"
"4";"2";"2";"10";"63";"51537"
"5";"1";"4";"10";"63";"51538"
"1";"0";"1";"10";"63";"51540"
"2";"0";"2";"10";"63";"51541"
"1";"0";"1";"10";"63";"51542"
"6";"2";"4";"10";"63";"51543"
"5";"2";"3";"10";"63";"51545"
"32";"16";"16";"10";"63";"51546"
"5";"1";"4";"10";"63";"51547"
"4";"1";"3";"10";"63";"51548"
"4";"1";"3";"10";"63";"51549"
"2";"0";"2";"10";"63";"51550"
"17";"5";"12";"10";"63";"51551"
"2";"2";"0";"10";"63";"51553"
"1";"1";"0";"10";"63";"51555"
"1";"1";"0";"10";"63";"51558"
"2";"0";"2";"10";"63";"51560"
"7";"2";"5";"10";"63";"51564"
"1";"0";"1";"10";"63";"51565"
"171";"136";"35";"10";"63";"51567"
"1";"1";"0";"10";"63";"51569"
"1";"0";"1";"10";"63";"51571"
"117";"79";"38";"10";"63";"51579"
"5";"0";"5";"10";"63";"51580"
"5";"1";"4";"10";"63";"51582"
"1";"0";"1";"10";"63";"51584"
"2";"0";"2";"10";"63";"51586"
"2";"0";"2";"10";"63";"51588"
"5";"1";"4";"10";"63";"51592"
"11";"2";"9";"10";"63";"51595"
"1";"0";"1";"10";"63";"51597"
"1";"0";"1";"10";"63";"51598"
"6";"3";"3";"10";"63";"51601"
"5";"1";"4";"10";"63";"51602"
"2";"1";"1";"10";"63";"51603"
"3";"2";"1";"10";"63";"51604"
"11";"1";"10";"10";"63";"51605"
"3";"1";"2";"10";"63";"51606"
"3";"0";"3";"10";"63";"51607"
"2";"1";"1";"10";"63";"51610"
"6";"0";"6";"10";"63";"51617"
"2";"0";"2";"10";"63";"51620"
"5";"1";"4";"10";"63";"51625"
"1";"1";"0";"10";"63";"51626"
"5";"0";"5";"10";"63";"51627"
"4";"1";"3";"10";"63";"51628"
"2";"0";"2";"10";"63";"51629"
"5";"2";"3";"10";"63";"51632"
"2";"0";"2";"10";"63";"51633"
"1";"0";"1";"10";"63";"51635"
"4";"0";"4";"10";"63";"51637"
"1";"1";"0";"10";"63";"51640"
"6";"3";"3";"10";"63";"51641"
"24";"9";"15";"10";"63";"51647"
"11";"2";"9";"10";"63";"51649"
"5";"2";"3";"10";"63";"51650"
"1";"0";"1";"10";"63";"51651"
"4";"1";"3";"10";"63";"51652"
"29";"9";"20";"10";"63";"51654"
"103";"38";"65";"10";"63";"51655"
"17";"4";"13";"10";"63";"51657"
"2";"1";"1";"10";"63";"51658"
"6";"1";"5";"10";"63";"51660"
"1";"0";"1";"10";"63";"51661"
"14";"10";"4";"10";"63";"51664"
"3";"0";"3";"10";"63";"51665"
"5";"1";"4";"10";"63";"51666"
"22";"7";"15";"10";"63";"51670"
"2";"0";"2";"10";"63";"51672"
"5";"0";"5";"10";"63";"51674"
"6";"1";"5";"10";"63";"51675"
"5";"0";"5";"10";"63";"51678"
"3";"0";"3";"10";"63";"51682"
"3";"1";"2";"10";"63";"51684"
"8";"2";"6";"10";"63";"51685"
"5";"2";"3";"10";"63";"51686"
"24";"10";"14";"10";"63";"51688"
"2";"0";"2";"10";"63";"51689"
"6";"2";"4";"10";"63";"51690"
"7";"1";"6";"10";"63";"51691"
"3";"1";"2";"10";"63";"51692"
"2";"1";"1";"10";"63";"51696"
"7";"2";"5";"10";"63";"51697"
"3";"0";"3";"10";"63";"51699"
"4";"1";"3";"10";"63";"51700"
"5";"2";"3";"10";"63";"51701"
"7";"3";"4";"10";"63";"51702"
"6";"1";"5";"10";"63";"51703"
"4";"1";"3";"10";"63";"51704"
"3";"0";"3";"10";"63";"51706"
"8";"2";"6";"10";"63";"51707"
"9";"3";"6";"10";"63";"51708"
"12";"1";"11";"10";"63";"51709"
"4";"0";"4";"10";"63";"51714"
"2";"0";"2";"10";"63";"51716"
"1";"1";"0";"10";"63";"51717"
"5";"1";"4";"10";"63";"51719"
"14";"3";"11";"10";"63";"51720"
"4";"2";"2";"10";"63";"51722"
"22";"3";"19";"10";"63";"51723"
"3";"2";"1";"10";"63";"51724"
"7";"0";"7";"10";"63";"51727"
"2";"1";"1";"10";"63";"51728"
"11";"3";"8";"10";"63";"51729"
"2";"0";"2";"10";"63";"51732"
"1";"0";"1";"10";"63";"51734"
"6";"1";"5";"10";"63";"51735"
"5";"0";"5";"10";"63";"51737"
"21";"14";"7";"10";"63";"51738"
"2";"0";"2";"10";"63";"51739"
"7";"3";"4";"10";"63";"51742"
"321";"240";"81";"10";"63";"51743"
"7";"2";"5";"10";"63";"51745"
"17";"6";"11";"10";"63";"51746"
"3";"1";"2";"10";"63";"51747"
"1";"0";"1";"10";"63";"51748"
"5";"5";"0";"10";"63";"51749"
"4";"1";"3";"10";"63";"51750"
"7";"0";"7";"10";"63";"51752"
"3";"1";"2";"10";"63";"51754"
"7";"3";"4";"10";"63";"51755"
"2";"2";"0";"10";"63";"51756"
"10";"2";"8";"10";"63";"51758"
"2";"1";"1";"10";"63";"51761"
"2";"0";"2";"10";"63";"51762"
"1";"1";"0";"10";"63";"51763"
"5";"2";"3";"10";"63";"51765"
"4";"1";"3";"10";"63";"51766"
"3";"0";"3";"10";"63";"51767"
"5";"2";"3";"10";"63";"51769"
"3";"0";"3";"10";"63";"51773"
"16";"1";"15";"10";"63";"51775"
"3";"0";"3";"10";"63";"51776"
"12";"6";"6";"10";"63";"51778"
"5";"1";"4";"10";"63";"51780"
"10";"2";"8";"10";"63";"51782"
"8";"1";"7";"10";"63";"51788"
"1";"0";"1";"10";"63";"51789"
"1";"1";"0";"10";"63";"51790"
"2";"0";"2";"10";"63";"51793"
"25";"4";"21";"10";"63";"51797"
"3";"0";"3";"10";"63";"51798"
"2";"0";"2";"10";"63";"51799"
"2";"0";"2";"10";"63";"51800"
"1";"0";"1";"10";"63";"51801"
"14";"0";"14";"10";"63";"51803"
"17";"3";"14";"10";"63";"51804"
"3";"2";"1";"10";"63";"51806"
"7";"1";"6";"10";"63";"51808"
"6";"0";"6";"10";"63";"51810"
"3";"1";"2";"10";"63";"51812"
"2";"1";"1";"10";"63";"51813"
"2";"0";"2";"10";"63";"51815"
"2";"1";"1";"10";"63";"51816"
"98";"70";"28";"10";"63";"51818"
"3";"0";"3";"10";"63";"51820"
"8";"1";"7";"10";"63";"51822"
"7";"1";"6";"10";"63";"51823"
"13";"5";"8";"10";"63";"51824"
"10";"2";"8";"10";"63";"51825"
"207";"134";"73";"10";"63";"51826"
"87";"13";"74";"10";"63";"51827"
"11";"9";"2";"10";"63";"51828"
"2";"1";"1";"10";"63";"51831"
"1";"1";"0";"10";"63";"51833"
"1";"1";"0";"10";"63";"51834"
"12";"1";"11";"10";"63";"51835"
"9";"3";"6";"10";"63";"51838"
"1";"0";"1";"10";"63";"51845"
"9";"1";"8";"10";"63";"51847"
"4";"1";"3";"10";"63";"51848"
"1";"1";"0";"10";"63";"51850"
"2";"2";"0";"10";"63";"51851"
"8";"4";"4";"10";"63";"51852"
"6";"4";"2";"10";"63";"51854"
"2";"0";"2";"10";"63";"51855"
"2";"0";"2";"10";"63";"51863"
"1";"1";"0";"10";"63";"51864"
"3";"3";"0";"10";"63";"51865"
"2";"1";"1";"10";"63";"51867"
"25";"7";"18";"10";"63";"51871"
"9";"2";"7";"10";"63";"51872"
"1";"1";"0";"10";"63";"51873"
"14";"8";"6";"10";"63";"51874"
"3";"0";"3";"10";"63";"51875"
"2";"1";"1";"10";"63";"51877"
"5";"0";"5";"10";"63";"51878"
"30";"8";"22";"10";"63";"51879"
"5";"3";"2";"10";"63";"51880"
"1";"0";"1";"10";"63";"51886"
"8";"3";"5";"10";"63";"51887"
"4";"0";"4";"10";"63";"51890"
"11";"3";"8";"10";"63";"51892"
"9";"3";"6";"10";"63";"51897"
"10";"1";"9";"10";"63";"51899"
"3";"0";"3";"10";"63";"51900"
"12";"2";"10";"10";"63";"51902"
"1";"0";"1";"10";"63";"51903"
"2";"0";"2";"10";"63";"51904"
"2";"0";"2";"10";"63";"51906"
"16";"14";"2";"10";"63";"51908"
"6";"2";"4";"10";"63";"51909"
"10";"3";"7";"10";"63";"51910"
"13";"2";"11";"10";"63";"51913"
"1";"0";"1";"10";"63";"51915"
"3";"1";"2";"10";"63";"51918"
"2";"0";"2";"10";"63";"51919"
"1";"0";"1";"10";"63";"51920"
"2";"0";"2";"10";"63";"51922"
"7";"1";"6";"10";"63";"51923"
"5";"1";"4";"10";"63";"51924"
"3";"1";"2";"10";"63";"51925"
"21";"16";"5";"10";"63";"51928"
"1";"1";"0";"10";"63";"51930"
"2";"0";"2";"10";"63";"51931"
"6";"4";"2";"10";"63";"51932"
"1";"1";"0";"10";"63";"51934"
"5";"1";"4";"10";"63";"51936"
"18";"6";"12";"10";"63";"51937"
"1";"0";"1";"10";"63";"51938"
"6";"1";"5";"10";"63";"51939"
"7";"2";"5";"10";"63";"51942"
"5";"2";"3";"10";"63";"51944"
"2";"1";"1";"10";"63";"51946"
"4";"0";"4";"10";"63";"51949"
"2";"1";"1";"10";"63";"51953"
"1";"0";"1";"10";"63";"51954"
"2";"0";"2";"10";"63";"51960"
"5";"1";"4";"10";"63";"51964"
"5";"1";"4";"10";"63";"51965"
"25";"14";"11";"10";"63";"51968"
"2";"1";"1";"10";"63";"51970"
"2";"1";"1";"10";"63";"51972"
"9";"5";"4";"10";"63";"51975"
"6";"2";"4";"10";"63";"51977"
"2";"1";"1";"10";"63";"51978"
"8";"0";"8";"10";"63";"51980"
"2";"0";"2";"10";"63";"51984"
"2";"1";"1";"10";"63";"51985"
"1";"0";"1";"10";"63";"51986"
"6";"0";"6";"10";"63";"51988"
"4";"2";"2";"10";"63";"51989"
"1";"1";"0";"10";"63";"51990"
"7";"0";"7";"10";"63";"51991"
"5";"1";"4";"10";"63";"51992"
"1";"1";"0";"10";"63";"51993"
"145";"114";"31";"10";"63";"51994"
"1";"0";"1";"10";"63";"51997"
"71";"49";"22";"10";"63";"52000"
"254";"190";"64";"10";"63";"52001"
"31";"25";"6";"10";"63";"52002"
"1";"0";"1";"10";"63";"52003"
"9";"5";"4";"10";"63";"52004"
"3";"3";"0";"10";"63";"52007"
"3";"0";"3";"10";"63";"52008"
"1";"1";"0";"10";"63";"52010"
"1";"1";"0";"10";"63";"52011"
"5";"3";"2";"10";"63";"52012"
"3";"1";"2";"10";"63";"52013"
"60";"12";"48";"10";"63";"52014"
"16";"10";"6";"10";"63";"52015"
"2";"0";"2";"10";"63";"52017"
"1";"0";"1";"10";"63";"52019"
"28";"9";"19";"10";"63";"52021"
"89";"49";"40";"10";"63";"52022"
"6";"1";"5";"10";"63";"52023"
"27";"5";"22";"10";"63";"52024"
"3";"0";"3";"10";"63";"52026"
"4";"1";"3";"10";"63";"52032"
"2";"0";"2";"10";"63";"52033"
"7";"2";"5";"10";"63";"52035"
"21";"12";"9";"10";"63";"52036"
"6";"0";"6";"10";"63";"52037"
"8";"2";"6";"10";"63";"52039"
"81";"23";"58";"10";"63";"52044"
"8";"2";"6";"10";"63";"52045"
"5";"0";"5";"10";"63";"52048"
"2";"1";"1";"10";"63";"52049"
"15";"6";"9";"10";"63";"52051"
"5";"2";"3";"10";"63";"52052"
"4";"0";"4";"10";"63";"52053"
"2";"1";"1";"10";"63";"52054"
"1";"1";"0";"10";"63";"52057"
"2";"0";"2";"10";"63";"52058"
"10";"2";"8";"10";"63";"52059"
"1";"0";"1";"10";"63";"52060"
"1";"1";"0";"10";"63";"52061"
"2";"1";"1";"10";"63";"52062"
"12";"3";"9";"10";"63";"52064"
"17";"17";"0";"10";"63";"52068"
"16";"3";"13";"10";"63";"52071"
"17";"11";"6";"10";"63";"52073"
"6";"2";"4";"10";"63";"52078"
"2";"1";"1";"10";"63";"52079"
"2";"0";"2";"10";"63";"52082"
"2";"1";"1";"10";"63";"52083"
"3";"0";"3";"10";"63";"52085"
"5";"2";"3";"10";"63";"52086"
"37";"19";"18";"10";"63";"52087"
"2";"1";"1";"10";"63";"52089"
"65";"6";"59";"10";"63";"52092"
"3";"0";"3";"10";"63";"52093"
"2";"0";"2";"10";"63";"52099"
"4";"2";"2";"10";"63";"52100"
"5";"0";"5";"10";"63";"52105"
"6";"2";"4";"10";"63";"52110"
"2";"0";"2";"10";"63";"52113"
"11";"5";"6";"10";"63";"52116"
"6";"1";"5";"10";"63";"52117"
"6";"0";"6";"10";"63";"52118"
"2";"1";"1";"10";"63";"52119"
"8";"3";"5";"10";"63";"52120"
"12";"2";"10";"10";"63";"52123"
"23";"3";"20";"10";"63";"52126"
"3";"1";"2";"10";"63";"52127"
"2";"0";"2";"10";"63";"52128"
"1";"1";"0";"10";"63";"52129"
"2";"1";"1";"10";"63";"52130"
"4";"2";"2";"10";"63";"52131"
"4";"1";"3";"10";"63";"52133"
"3";"0";"3";"10";"63";"52136"
"6";"1";"5";"10";"63";"52137"
"2";"1";"1";"10";"63";"52139"
"2";"1";"1";"10";"63";"52143"
"3";"0";"3";"10";"63";"52144"
"3";"1";"2";"10";"63";"52149"
"4";"2";"2";"10";"63";"52150"
"2";"0";"2";"10";"63";"52152"
"3";"1";"2";"10";"63";"52157"
"11";"3";"8";"10";"63";"52158"
"2";"0";"2";"10";"63";"52159"
"11";"1";"10";"10";"63";"52162"
"1";"0";"1";"10";"63";"52164"
"13";"3";"10";"10";"63";"52169"
"1";"0";"1";"10";"63";"52171"
"6";"2";"4";"10";"63";"52174"
"1";"0";"1";"10";"63";"52176"
"3";"1";"2";"10";"63";"52178"
"6";"0";"6";"10";"63";"52180"
"4";"0";"4";"10";"63";"52181"
"4";"1";"3";"10";"63";"52183"
"14";"5";"9";"10";"63";"52184"
"11";"5";"6";"10";"63";"52187"
"19";"2";"17";"10";"63";"52188"
"3";"1";"2";"10";"63";"52189"
"112";"45";"67";"10";"63";"52190"
"2";"0";"2";"10";"63";"52191"
"5";"1";"4";"10";"63";"52193"
"1";"1";"0";"10";"63";"52197"
"5";"2";"3";"10";"63";"52198"
"1";"1";"0";"10";"63";"52199"
"8";"3";"5";"10";"63";"52200"
"1";"0";"1";"10";"63";"52201"
"5";"0";"5";"10";"63";"52202"
"3";"1";"2";"10";"63";"52203"
"4";"0";"4";"10";"63";"52204"
"4";"2";"2";"10";"63";"52206"
"5";"2";"3";"10";"63";"52208"
"5";"1";"4";"10";"63";"52209"
"2";"0";"2";"10";"63";"52214"
"3";"0";"3";"10";"63";"52215"
"12";"2";"10";"10";"63";"52216"
"2";"1";"1";"10";"63";"52218"
"46";"39";"7";"10";"63";"52219"
"4";"0";"4";"10";"63";"52222"
"3";"3";"0";"10";"63";"52224"
"16";"4";"12";"10";"63";"52226"
"2";"0";"2";"10";"63";"52232"
"13";"2";"11";"10";"63";"52233"
"1";"1";"0";"10";"63";"52234"
"1";"0";"1";"10";"63";"52235"
"230";"187";"43";"10";"63";"52236"
"10";"1";"9";"10";"63";"52237"
"3";"0";"3";"10";"63";"52240"
"10";"4";"6";"10";"63";"52241"
"6";"3";"3";"10";"63";"52242"
"1";"0";"1";"10";"63";"52244"
"2";"0";"2";"10";"63";"52245"
"17";"6";"11";"10";"63";"52249"
"2";"1";"1";"10";"63";"52250"
"4";"0";"4";"10";"63";"52251"
"1";"1";"0";"10";"63";"52253"
"1";"1";"0";"10";"63";"52259"
"4";"0";"4";"10";"63";"52260"
"2";"1";"1";"10";"63";"52262"
"1";"0";"1";"10";"63";"52266"
"1";"1";"0";"10";"63";"52267"
"4";"2";"2";"10";"63";"52270"
"4";"1";"3";"10";"63";"52272"
"5";"0";"5";"10";"63";"52274"
"1";"0";"1";"10";"63";"52276"
"1";"0";"1";"10";"63";"52277"
"2";"0";"2";"10";"63";"52279"
"1";"0";"1";"10";"63";"52280"
"8";"0";"8";"10";"63";"52281"
"6";"2";"4";"10";"63";"52282"
"1";"0";"1";"10";"63";"52284"
"4";"0";"4";"10";"63";"52285"
"3";"0";"3";"10";"63";"52286"
"6";"1";"5";"10";"63";"52287"
"3";"0";"3";"10";"63";"52288"
"3";"1";"2";"10";"63";"52290"
"9";"3";"6";"10";"63";"52291"
"2";"1";"1";"10";"63";"52292"
"2";"1";"1";"10";"63";"52293"
"6";"1";"5";"10";"63";"52294"
"1";"0";"1";"10";"63";"52295"
"5";"1";"4";"10";"63";"52298"
"3";"1";"2";"10";"63";"52299"
"263";"189";"74";"10";"63";"52303"
"4";"0";"4";"10";"63";"52304"
"6";"4";"2";"10";"63";"52309"
"10";"8";"2";"10";"63";"52310"
"7";"2";"5";"10";"63";"52311"
"6";"1";"5";"10";"63";"52315"
"6";"1";"5";"10";"63";"52317"
"1";"1";"0";"10";"63";"52320"
"3";"1";"2";"10";"63";"52325"
"5";"2";"3";"10";"63";"52326"
"2";"0";"2";"10";"63";"52327"
"8";"2";"6";"10";"63";"52328"
"3";"0";"3";"10";"63";"52329"
"8";"1";"7";"10";"63";"52331"
"3";"2";"1";"10";"63";"52332"
"3";"0";"3";"10";"63";"52334"
"12";"0";"12";"10";"63";"52335"
"3";"1";"2";"10";"63";"52336"
"2";"0";"2";"10";"63";"52337"
"1";"0";"1";"10";"63";"52339"
"4";"0";"4";"10";"63";"52341"
"2";"2";"0";"10";"63";"52342"
"2";"0";"2";"10";"63";"52343"
"2";"0";"2";"10";"63";"52344"
"10";"3";"7";"10";"63";"52346"
"7";"0";"7";"10";"63";"52349"
"3";"1";"2";"10";"63";"52350"
"16";"12";"4";"10";"63";"52352"
"6";"0";"6";"10";"63";"52353"
"7";"4";"3";"10";"63";"52355"
"2";"0";"2";"10";"63";"52357"
"2";"2";"0";"10";"63";"52359"
"2";"0";"2";"10";"63";"52360"
"3";"1";"2";"10";"63";"52361"
"4";"4";"0";"10";"63";"52362"
"3";"0";"3";"10";"63";"52363"
"1";"1";"0";"10";"63";"52364"
"7";"1";"6";"10";"63";"52365"
"2";"0";"2";"10";"63";"52366"
"8";"1";"7";"10";"63";"52368"
"2";"0";"2";"10";"63";"52369"
"5";"1";"4";"10";"63";"52370"
"49";"29";"20";"10";"63";"52374"
"3";"0";"3";"10";"63";"52376"
"3";"1";"2";"10";"63";"52377"
"2";"0";"2";"10";"63";"52378"
"2";"0";"2";"10";"63";"52379"
"12";"2";"10";"10";"63";"52381"
"5";"0";"5";"10";"63";"52382"
"5";"1";"4";"10";"63";"52386"
"3";"0";"3";"10";"63";"52387"
"7";"2";"5";"10";"63";"52388"
"2";"0";"2";"10";"63";"52389"
"39";"26";"13";"10";"63";"52390"
"119";"111";"8";"10";"63";"52393"
"1";"0";"1";"10";"63";"52395"
"2";"1";"1";"10";"63";"52396"
"2";"0";"2";"10";"63";"52397"
"25";"7";"18";"10";"63";"52398"
"25";"4";"21";"10";"63";"52399"
"1";"0";"1";"10";"63";"52400"
"2";"1";"1";"10";"63";"52403"
"2";"0";"2";"10";"63";"52404"
"9";"0";"9";"10";"63";"52405"
"57";"10";"47";"10";"63";"52406"
"6";"0";"6";"10";"63";"52407"
"2";"1";"1";"10";"63";"52408"
"15";"9";"6";"10";"63";"52410"
"4";"1";"3";"10";"63";"52411"
"3";"0";"3";"10";"63";"52412"
"2";"1";"1";"10";"63";"52415"
"5";"3";"2";"10";"63";"52417"
"15";"3";"12";"10";"63";"52420"
"4";"0";"4";"10";"63";"52421"
"18";"1";"17";"10";"63";"52423"
"2";"1";"1";"10";"63";"52424"
"1";"1";"0";"10";"63";"52425"
"2";"0";"2";"10";"63";"52430"
"56";"44";"12";"10";"63";"52432"
"7";"4";"3";"10";"63";"52433"
"5";"1";"4";"10";"63";"52434"
"1";"0";"1";"10";"63";"52436"
"5";"1";"4";"10";"63";"52438"
"2";"0";"2";"10";"63";"52439"
"2";"1";"1";"10";"63";"52440"
"3";"0";"3";"10";"63";"52441"
"1";"0";"1";"10";"63";"52442"
"15";"3";"12";"10";"63";"52444"
"6";"2";"4";"10";"63";"52447"
"6";"2";"4";"10";"63";"52448"
"3";"0";"3";"10";"63";"52450"
"1";"0";"1";"10";"63";"52452"
"13";"2";"11";"10";"63";"52453"
"2";"0";"2";"10";"63";"52456"
"6";"3";"3";"10";"63";"52457"
"1";"1";"0";"10";"63";"52458"
"7";"2";"5";"10";"63";"52459"
"4";"1";"3";"10";"63";"52460"
"3";"0";"3";"10";"63";"52461"
"17";"13";"4";"10";"63";"52462"
"3";"1";"2";"10";"63";"52464"
"7";"3";"4";"10";"63";"52465"
"1";"0";"1";"10";"63";"52466"
"6";"2";"4";"10";"63";"52468"
"2";"0";"2";"10";"63";"52471"
"2";"0";"2";"10";"63";"52473"
"7";"4";"3";"10";"63";"52474"
"1";"0";"1";"10";"63";"52475"
"5";"1";"4";"10";"63";"52476"
"10";"2";"8";"10";"63";"52477"
"7";"2";"5";"10";"63";"52478"
"4";"0";"4";"10";"63";"52480"
"2";"0";"2";"10";"63";"52481"
"5";"0";"5";"10";"63";"52482"
"2";"1";"1";"10";"63";"52484"
"4";"0";"4";"10";"63";"52485"
"5";"0";"5";"10";"63";"52486"
"67";"50";"17";"10";"63";"52491"
"1";"0";"1";"10";"63";"52493"
"2";"0";"2";"10";"63";"52494"
"4";"1";"3";"10";"63";"52495"
"2";"0";"2";"10";"63";"52496"
"3";"0";"3";"10";"63";"52497"
"4";"2";"2";"10";"63";"52499"
"1";"0";"1";"10";"63";"52502"
"23";"5";"18";"10";"63";"52503"
"6";"3";"3";"10";"63";"52506"
"38";"28";"10";"10";"63";"52507"
"2";"0";"2";"10";"63";"52508"
"2";"1";"1";"10";"63";"52511"
"5";"1";"4";"10";"63";"52512"
"5";"1";"4";"10";"63";"52513"
"3";"1";"2";"10";"63";"52514"
"1";"1";"0";"10";"63";"52515"
"96";"63";"33";"10";"63";"52516"
"6";"0";"6";"10";"63";"52517"
"1";"1";"0";"10";"63";"52521"
"6";"1";"5";"10";"63";"52522"
"17";"4";"13";"10";"63";"52523"
"1";"1";"0";"10";"63";"52524"
"47";"10";"37";"10";"63";"52527"
"2";"2";"0";"10";"63";"52528"
"1";"1";"0";"10";"63";"52530"
"2";"0";"2";"10";"63";"52534"
"2";"0";"2";"10";"63";"52537"
"4";"0";"4";"10";"63";"52538"
"4";"0";"4";"10";"63";"52539"
"9";"3";"6";"10";"63";"52541"
"4";"1";"3";"10";"63";"52542"
"2";"0";"2";"10";"63";"52545"
"1";"0";"1";"10";"63";"52546"
"43";"17";"26";"10";"63";"52547"
"1";"0";"1";"10";"63";"52550"
"1";"0";"1";"10";"63";"52551"
"1";"0";"1";"10";"63";"52552"
"3";"0";"3";"10";"63";"52555"
"3";"0";"3";"10";"63";"52556"
"5";"0";"5";"10";"63";"52558"
"7";"1";"6";"10";"63";"52560"
"2";"0";"2";"10";"63";"52561"
"2";"1";"1";"10";"63";"52562"
"36";"20";"16";"10";"63";"52564"
"35";"22";"13";"10";"63";"52565"
"13";"4";"9";"10";"63";"52569"
"5";"1";"4";"10";"63";"52571"
"14";"1";"13";"10";"63";"52572"
"4";"0";"4";"10";"63";"52573"
"9";"3";"6";"10";"63";"52574"
"1";"1";"0";"10";"63";"52577"
"2";"2";"0";"10";"63";"52578"
"2";"0";"2";"10";"63";"52580"
"4";"1";"3";"10";"63";"52581"
"6";"1";"5";"10";"63";"52582"
"17";"5";"12";"10";"63";"52583"
"4";"0";"4";"10";"63";"52585"
"15";"4";"11";"10";"63";"52593"
"6";"3";"3";"10";"63";"52594"
"7";"1";"6";"10";"63";"52595"
"13";"1";"12";"10";"63";"52596"
"1";"1";"0";"10";"63";"52597"
"287";"202";"85";"10";"63";"52599"
"4";"1";"3";"10";"63";"52602"
"3";"1";"2";"10";"63";"52603"
"2";"0";"2";"10";"63";"52604"
"1";"1";"0";"10";"63";"52606"
"17";"5";"12";"10";"63";"52607"
"6";"1";"5";"10";"63";"52609"
"7";"1";"6";"10";"63";"52611"
"16";"5";"11";"10";"63";"52612"
"6";"1";"5";"10";"63";"52614"
"69";"49";"20";"10";"63";"52616"
"1";"1";"0";"10";"63";"52618"
"5";"5";"0";"10";"63";"52619"
"6";"2";"4";"10";"63";"52620"
"2";"1";"1";"10";"63";"52621"
"3";"0";"3";"10";"63";"52622"
"3";"0";"3";"10";"63";"52623"
"48";"36";"12";"10";"63";"52624"
"2";"1";"1";"10";"63";"52626"
"5";"1";"4";"10";"63";"52629"
"5";"0";"5";"10";"63";"52631"
"1";"0";"1";"10";"63";"52632"
"6";"1";"5";"10";"63";"52633"
"2";"1";"1";"10";"63";"52635"
"4";"2";"2";"10";"63";"52636"
"18";"4";"14";"10";"63";"52638"
"1";"0";"1";"10";"63";"52639"
"3";"0";"3";"10";"63";"52640"
"10";"2";"8";"10";"63";"52641"
"3";"1";"2";"10";"63";"52642"
"1";"0";"1";"10";"63";"52643"
"3";"0";"3";"10";"63";"52644"
"3";"2";"1";"10";"63";"52647"
"1";"1";"0";"10";"63";"52648"
"2";"1";"1";"10";"63";"52649"
"1";"0";"1";"10";"63";"52650"
"7";"1";"6";"10";"63";"52651"
"14";"3";"11";"10";"63";"52652"
"1";"1";"0";"10";"63";"52653"
"1";"0";"1";"10";"63";"52655"
"34";"11";"23";"10";"63";"52658"
"43";"22";"21";"10";"63";"52659"
"2";"1";"1";"10";"63";"52660"
"4";"1";"3";"10";"63";"52661"
"3";"0";"3";"10";"63";"52662"
"3";"1";"2";"10";"63";"52664"
"1";"0";"1";"10";"63";"52665"
"2";"2";"0";"10";"63";"52668"
"6";"1";"5";"10";"63";"52669"
"39";"18";"21";"10";"63";"52671"
"6";"3";"3";"10";"63";"52672"
"3";"1";"2";"10";"63";"52673"
"3";"0";"3";"10";"63";"52674"
"1";"0";"1";"10";"63";"52675"
"4";"1";"3";"10";"63";"52676"
"11";"2";"9";"10";"63";"52680"
"2";"0";"2";"10";"63";"52681"
"5";"1";"4";"10";"63";"52683"
"3";"1";"2";"10";"63";"52684"
"1";"1";"0";"10";"63";"52686"
"8";"1";"7";"10";"63";"52689"
"4";"2";"2";"10";"63";"52690"
"2";"0";"2";"10";"63";"52693"
"5";"2";"3";"10";"63";"52694"
"19";"5";"14";"10";"63";"52695"
"4";"4";"0";"10";"63";"52696"
"19";"10";"9";"10";"63";"52697"
"2";"1";"1";"10";"63";"52698"
"2";"1";"1";"10";"63";"52701"
"209";"153";"56";"10";"63";"52703"
"5";"1";"4";"10";"63";"52704"
"3";"0";"3";"10";"63";"52705"
"3";"0";"3";"10";"63";"52709"
"2";"1";"1";"10";"63";"52713"
"2";"0";"2";"10";"63";"52714"
"3";"1";"2";"10";"63";"52716"
"17";"4";"13";"10";"63";"52719"
"5";"2";"3";"10";"63";"52721"
"5";"1";"4";"10";"63";"52722"
"4";"0";"4";"10";"63";"52723"
"22";"2";"20";"10";"63";"52727"
"10";"6";"4";"10";"63";"52728"
"1";"0";"1";"10";"63";"52730"
"3";"2";"1";"10";"63";"52732"
"9";"6";"3";"10";"63";"52736"
"2";"1";"1";"10";"63";"52738"
"3";"1";"2";"10";"63";"52742"
"8";"1";"7";"10";"63";"52744"
"3";"1";"2";"10";"63";"52746"
"1";"1";"0";"10";"63";"52747"
"16";"4";"12";"10";"63";"52748"
"3";"0";"3";"10";"63";"52752"
"7";"2";"5";"10";"63";"52753"
"3";"1";"2";"10";"63";"52754"
"3";"0";"3";"10";"63";"52755"
"3";"0";"3";"10";"63";"52757"
"1";"1";"0";"10";"63";"52760"
"3";"0";"3";"10";"63";"52762"
"5";"2";"3";"10";"63";"52765"
"9";"3";"6";"10";"63";"52769"
"7";"0";"7";"10";"63";"52770"
"6";"0";"6";"10";"63";"52771"
"2";"1";"1";"10";"63";"52774"
"4";"0";"4";"10";"63";"52777"
"9";"1";"8";"10";"63";"52778"
"5";"1";"4";"10";"63";"52781"
"1";"1";"0";"10";"63";"52785"
"6";"0";"6";"10";"63";"52786"
"23";"2";"21";"10";"63";"52787"
"2";"1";"1";"10";"63";"52789"
"2";"0";"2";"10";"63";"52790"
"3";"1";"2";"10";"63";"52793"
"2";"0";"2";"10";"63";"52794"
"1";"1";"0";"10";"63";"52796"
"3";"1";"2";"10";"63";"52798"
"33";"9";"24";"10";"63";"52799"
"110";"73";"37";"10";"63";"52803"
"21";"7";"14";"10";"63";"52807"
"18";"2";"16";"10";"63";"52809"
"6";"0";"6";"10";"63";"52810"
"2";"2";"0";"10";"63";"52811"
"9";"1";"8";"10";"63";"52816"
"7";"3";"4";"10";"63";"52817"
"1";"0";"1";"10";"63";"52818"
"3";"1";"2";"10";"63";"52819"
"4";"0";"4";"10";"63";"52820"
"24";"2";"22";"10";"63";"52822"
"5";"1";"4";"10";"63";"52823"
"3";"0";"3";"10";"63";"52824"
"2";"1";"1";"10";"63";"52826"
"2";"1";"1";"10";"63";"52827"
"3";"0";"3";"10";"63";"52829"
"6";"0";"6";"10";"63";"52830"
"2";"0";"2";"10";"63";"52833"
"3";"0";"3";"10";"63";"52834"
"2";"1";"1";"10";"63";"52835"
"6";"4";"2";"10";"63";"52837"
"12";"1";"11";"10";"63";"52838"
"1";"0";"1";"10";"63";"52839"
"9";"0";"9";"10";"63";"52842"
"24";"10";"14";"10";"63";"52843"
"10";"4";"6";"10";"63";"52844"
"8";"3";"5";"10";"63";"52846"
"1";"0";"1";"10";"63";"52848"
"2";"0";"2";"10";"63";"52850"
"15";"1";"14";"10";"63";"52852"
"2";"0";"2";"10";"63";"52853"
"31";"12";"19";"10";"63";"52855"
"7";"1";"6";"10";"63";"52857"
"5";"1";"4";"10";"63";"52858"
"1";"0";"1";"10";"63";"52860"
"2";"1";"1";"10";"63";"52861"
"3";"1";"2";"10";"63";"52862"
"4";"0";"4";"10";"63";"52865"
"1";"0";"1";"10";"63";"52867"
"5";"1";"4";"10";"63";"52869"
"8";"3";"5";"10";"63";"52872"
"3";"1";"2";"10";"63";"52873"
"4";"1";"3";"10";"63";"52875"
"2";"1";"1";"10";"63";"52877"
"4";"1";"3";"10";"63";"52878"
"2";"0";"2";"10";"63";"52879"
"1";"1";"0";"10";"63";"52881"
"4";"1";"3";"10";"63";"52884"
"1";"0";"1";"10";"63";"52885"
"5";"1";"4";"10";"63";"52886"
"7";"2";"5";"10";"63";"52887"
"1";"0";"1";"10";"63";"52889"
"3";"0";"3";"10";"63";"52890"
"2";"0";"2";"10";"63";"52891"
"6";"6";"0";"10";"63";"52892"
"6";"2";"4";"10";"63";"52893"
"1";"0";"1";"10";"63";"52895"
"1";"0";"1";"10";"63";"52896"
"2";"0";"2";"10";"63";"52897"
"1";"1";"0";"10";"63";"52903"
"3";"0";"3";"10";"63";"52905"
"2";"1";"1";"10";"63";"52906"
"46";"29";"17";"10";"63";"52907"
"2";"0";"2";"10";"63";"52908"
"1";"0";"1";"10";"63";"52909"
"4";"0";"4";"10";"63";"52910"
"7";"1";"6";"10";"63";"52911"
"4";"0";"4";"10";"63";"52913"
"909";"625";"284";"10";"63";"52914"
"2";"1";"1";"10";"63";"52916"
"4";"0";"4";"10";"63";"52917"
"2";"0";"2";"10";"63";"52919"
"7";"2";"5";"10";"63";"52920"
"1";"0";"1";"10";"63";"52921"
"2";"1";"1";"10";"63";"52924"
"5";"1";"4";"10";"63";"52926"
"6";"1";"5";"10";"63";"52928"
"20";"4";"16";"10";"63";"52930"
"6";"1";"5";"10";"63";"52932"
"2";"1";"1";"10";"63";"52933"
"1";"0";"1";"10";"63";"52935"
"8";"1";"7";"10";"63";"52936"
"9";"2";"7";"10";"63";"52938"
"2";"0";"2";"10";"63";"52939"
"5";"0";"5";"10";"63";"52940"
"1";"1";"0";"10";"63";"52942"
"10";"3";"7";"10";"63";"52943"
"1";"1";"0";"10";"63";"52944"
"1";"0";"1";"10";"63";"52950"
"3";"0";"3";"10";"63";"52952"
"5";"0";"5";"10";"63";"52954"
"405";"302";"103";"10";"63";"52957"
"6";"3";"3";"10";"63";"52959"
"2";"1";"1";"10";"63";"52960"
"5";"1";"4";"10";"63";"52961"
"9";"1";"8";"10";"63";"52963"
"8";"1";"7";"10";"63";"52964"
"10";"4";"6";"10";"63";"52967"
"1";"0";"1";"10";"63";"52968"
"4";"1";"3";"10";"63";"52969"
"3";"1";"2";"10";"63";"52970"
"2";"0";"2";"10";"63";"52971"
"1";"0";"1";"10";"63";"52976"
"353";"303";"50";"10";"63";"52978"
"2";"1";"1";"10";"63";"52979"
"7";"3";"4";"10";"63";"52983"
"2";"0";"2";"10";"63";"52984"
"1";"1";"0";"10";"63";"52985"
"2";"1";"1";"10";"63";"52986"
"1";"1";"0";"10";"63";"52987"
"11";"3";"8";"10";"63";"52989"
"3";"1";"2";"10";"63";"52992"
"2";"0";"2";"10";"63";"52993"
"1";"1";"0";"10";"63";"52996"
"1";"0";"1";"10";"63";"52997"
"132";"82";"50";"10";"63";"52998"
"7";"1";"6";"10";"63";"52999"
"11";"1";"10";"10";"63";"53000"
"4";"2";"2";"10";"63";"53001"
"3";"0";"3";"10";"63";"53002"
"22";"4";"18";"10";"63";"53004"
"8";"1";"7";"10";"63";"53006"
"1";"0";"1";"10";"63";"53010"
"3";"0";"3";"10";"63";"53011"
"3";"0";"3";"10";"63";"53014"
"3";"0";"3";"10";"63";"53015"
"5";"0";"5";"10";"63";"53016"
"13";"4";"9";"10";"63";"53021"
"10";"5";"5";"10";"63";"53023"
"3";"1";"2";"10";"63";"53025"
"3";"0";"3";"10";"63";"53027"
"3";"1";"2";"10";"63";"53028"
"1";"0";"1";"10";"63";"53030"
"2";"2";"0";"10";"63";"53034"
"5";"0";"5";"10";"63";"53038"
"3";"1";"2";"10";"63";"53040"
"6";"2";"4";"10";"63";"53042"
"3";"0";"3";"10";"63";"53045"
"1";"0";"1";"10";"63";"53046"
"3";"0";"3";"10";"63";"53047"
"2";"1";"1";"10";"63";"53048"
"9";"2";"7";"10";"63";"53049"
"10";"1";"9";"10";"63";"53051"
"5";"0";"5";"10";"63";"53052"
"1";"0";"1";"10";"63";"53053"
"6";"3";"3";"10";"63";"53056"
"2";"0";"2";"10";"63";"53057"
"7";"0";"7";"10";"63";"53059"
"7";"1";"6";"10";"63";"53060"
"1";"1";"0";"10";"63";"53061"
"21";"3";"18";"10";"63";"53062"
"3";"1";"2";"10";"63";"53063"
"5";"2";"3";"10";"63";"53064"
"3";"0";"3";"10";"63";"53065"
"15";"11";"4";"10";"63";"53068"
"2";"1";"1";"10";"63";"53069"
"2";"0";"2";"10";"63";"53070"
"12";"3";"9";"10";"63";"53071"
"8";"2";"6";"10";"63";"53072"
"5";"1";"4";"10";"63";"53075"
"2";"1";"1";"10";"63";"53078"
"5";"2";"3";"10";"63";"53079"
"2";"0";"2";"10";"63";"53080"
"8";"1";"7";"10";"63";"53086"
"12";"2";"10";"10";"63";"53087"
"3";"0";"3";"10";"63";"53088"
"4";"1";"3";"10";"63";"53089"
"20";"2";"18";"10";"63";"53090"
"1";"0";"1";"10";"63";"53091"
"1";"0";"1";"10";"63";"53092"
"1";"0";"1";"10";"63";"53093"
"6";"0";"6";"10";"63";"53096"
"10";"1";"9";"10";"63";"53098"
"5";"2";"3";"10";"63";"53099"
"3";"1";"2";"10";"63";"53100"
"11";"4";"7";"10";"63";"53103"
"3";"1";"2";"10";"63";"53105"
"4";"1";"3";"10";"63";"53107"
"12";"3";"9";"10";"63";"53113"
"1";"0";"1";"10";"63";"53114"
"5";"2";"3";"10";"63";"53116"
"9";"1";"8";"10";"63";"53117"
"1";"0";"1";"10";"63";"53118"
"2";"0";"2";"10";"63";"53119"
"13";"3";"10";"10";"63";"53121"
"2";"0";"2";"10";"63";"53125"
"1";"0";"1";"10";"63";"53126"
"2";"0";"2";"10";"63";"53127"
"2";"1";"1";"10";"63";"53128"
"1";"1";"0";"10";"63";"53129"
"9";"3";"6";"10";"63";"53130"
"43";"16";"27";"10";"63";"53132"
"4";"0";"4";"10";"63";"53133"
"3";"0";"3";"10";"63";"53136"
"2";"0";"2";"10";"63";"53139"
"5";"2";"3";"10";"63";"53140"
"3";"1";"2";"10";"63";"53144"
"13";"6";"7";"10";"63";"53145"
"2";"1";"1";"10";"63";"53146"
"1";"0";"1";"10";"63";"53148"
"2";"0";"2";"10";"63";"53149"
"3";"0";"3";"10";"63";"53150"
"1";"1";"0";"10";"63";"53151"
"2";"1";"1";"10";"63";"53153"
"3";"1";"2";"10";"63";"53156"
"3";"1";"2";"10";"63";"53159"
"3";"1";"2";"10";"63";"53162"
"1";"0";"1";"10";"63";"53166"
"5";"0";"5";"10";"63";"53169"
"4";"0";"4";"10";"63";"53170"
"5";"2";"3";"10";"63";"53172"
"1";"1";"0";"10";"63";"53173"
"15";"0";"15";"10";"63";"53176"
"3";"3";"0";"10";"63";"53178"
"5";"0";"5";"10";"63";"53180"
"28";"13";"15";"10";"63";"53181"
"29";"4";"25";"10";"63";"53182"
"85";"57";"28";"10";"63";"53183"
"14";"10";"4";"10";"63";"53184"
"2";"0";"2";"10";"63";"53185"
"35";"16";"19";"10";"63";"53187"
"24";"2";"22";"10";"63";"53189"
"5";"2";"3";"10";"63";"53190"
"2";"1";"1";"10";"63";"53191"
"1";"1";"0";"10";"63";"53194"
"5";"1";"4";"10";"63";"53195"
"34";"12";"22";"10";"63";"53196"
"1";"0";"1";"10";"63";"53197"
"2";"0";"2";"10";"63";"53199"
"1";"0";"1";"10";"63";"53200"
"4";"1";"3";"10";"63";"53203"
"3";"1";"2";"10";"63";"53204"
"3";"0";"3";"10";"63";"53205"
"1";"0";"1";"10";"63";"53206"
"15";"4";"11";"10";"63";"53207"
"6";"1";"5";"10";"63";"53208"
"1";"0";"1";"10";"63";"53209"
"6";"3";"3";"10";"63";"53210"
"8";"2";"6";"10";"63";"53212"
"2";"0";"2";"10";"63";"53215"
"19";"6";"13";"10";"63";"53218"
"5";"1";"4";"10";"63";"53220"
"1";"0";"1";"10";"63";"53221"
"39";"7";"32";"10";"63";"53222"
"6";"0";"6";"10";"63";"53224"
"20";"11";"9";"10";"63";"53225"
"2";"0";"2";"10";"63";"53227"
"10";"1";"9";"10";"63";"53229"
"3";"0";"3";"10";"63";"53231"
"43";"25";"18";"10";"63";"53233"
"1";"0";"1";"10";"63";"53235"
"4";"1";"3";"10";"63";"53236"
"6";"1";"5";"10";"63";"53237"
"4";"0";"4";"10";"63";"53238"
"55";"44";"11";"10";"63";"53240"
"2";"0";"2";"10";"63";"53241"
"2";"0";"2";"10";"63";"53242"
"6";"4";"2";"10";"63";"53243"
"8";"4";"4";"10";"63";"53244"
"2";"0";"2";"10";"63";"53247"
"4";"1";"3";"10";"63";"53250"
"10";"4";"6";"10";"63";"53251"
"11";"3";"8";"10";"63";"53253"
"1";"0";"1";"10";"63";"53254"
"7";"1";"6";"10";"63";"53255"
"12";"4";"8";"10";"63";"53259"
"4";"1";"3";"10";"63";"53260"
"9";"3";"6";"10";"63";"53265"
"8";"4";"4";"10";"63";"53266"
"10";"1";"9";"10";"63";"53268"
"2";"0";"2";"10";"63";"53272"
"6";"1";"5";"10";"63";"53274"
"1";"0";"1";"10";"63";"53275"
"1";"0";"1";"10";"63";"53276"
"9";"4";"5";"10";"63";"53279"
"1";"1";"0";"10";"63";"53280"
"2";"0";"2";"10";"63";"53281"
"4";"1";"3";"10";"63";"53282"
"2";"0";"2";"10";"63";"53284"
"2";"0";"2";"10";"63";"53285"
"10";"4";"6";"10";"63";"53286"
"3";"1";"2";"10";"63";"53287"
"1";"0";"1";"10";"63";"53289"
"1";"1";"0";"10";"63";"53290"
"2";"0";"2";"10";"63";"53292"
"2";"0";"2";"10";"63";"53293"
"2";"2";"0";"10";"63";"53294"
"36";"14";"22";"10";"63";"53297"
"1";"0";"1";"10";"63";"53300"
"2";"1";"1";"10";"63";"53301"
"4";"1";"3";"10";"63";"53304"
"26";"11";"15";"10";"63";"53311"
"1";"1";"0";"10";"63";"53312"
"1";"1";"0";"10";"63";"53313"
"60";"26";"34";"10";"63";"53314"
"1";"1";"0";"10";"63";"53316"
"1";"1";"0";"10";"63";"53322"
"3";"1";"2";"10";"63";"53323"
"1";"1";"0";"10";"63";"53324"
"1";"1";"0";"10";"63";"53325"
"3";"1";"2";"10";"63";"53326"
"2";"0";"2";"10";"63";"53328"
"33";"12";"21";"10";"63";"53334"
"3";"1";"2";"10";"63";"53335"
"4";"0";"4";"10";"63";"53338"
"2";"1";"1";"10";"63";"53339"
"4";"0";"4";"10";"63";"53340"
"5";"1";"4";"10";"63";"53342"
"3";"1";"2";"10";"63";"53346"
"3";"0";"3";"10";"63";"53348"
"1";"1";"0";"10";"63";"53349"
"2";"1";"1";"10";"63";"53352"
"3";"0";"3";"10";"63";"53354"
"8";"1";"7";"10";"63";"53355"
"11";"3";"8";"10";"63";"53356"
"3";"0";"3";"10";"63";"53358"
"17";"4";"13";"10";"63";"53361"
"23";"16";"7";"10";"63";"53363"
"2";"0";"2";"10";"63";"53364"
"5";"2";"3";"10";"63";"53365"
"3";"0";"3";"10";"63";"53366"
"1";"0";"1";"10";"63";"53367"
"2";"0";"2";"10";"63";"53369"
"6";"1";"5";"10";"63";"53370"
"2";"0";"2";"10";"63";"53372"
"5";"1";"4";"10";"63";"53374"
"6";"1";"5";"10";"63";"53376"
"12";"2";"10";"10";"63";"53377"
"4";"1";"3";"10";"63";"53378"
"26";"12";"14";"10";"63";"53380"
"22";"4";"18";"10";"63";"53381"
"22";"4";"18";"10";"63";"53382"
"6";"2";"4";"10";"63";"53384"
"4";"0";"4";"10";"63";"53385"
"1";"0";"1";"10";"63";"53388"
"2";"1";"1";"10";"63";"53389"
"1";"0";"1";"10";"63";"53390"
"3";"1";"2";"10";"63";"53391"
"1";"0";"1";"10";"63";"53392"
"3";"1";"2";"10";"63";"53393"
"24";"7";"17";"10";"63";"53394"
"7";"2";"5";"10";"63";"53395"
"18";"3";"15";"10";"63";"53396"
"2";"0";"2";"10";"63";"53398"
"2";"0";"2";"10";"63";"53400"
"10";"5";"5";"10";"63";"53401"
"2";"1";"1";"10";"63";"53404"
"5";"1";"4";"10";"63";"53406"
"8";"4";"4";"10";"63";"53409"
"6";"2";"4";"10";"63";"53411"
"1";"0";"1";"10";"63";"53413"
"3";"1";"2";"10";"63";"53419"
"1";"1";"0";"10";"63";"53422"
"24";"10";"14";"10";"63";"53423"
"2";"1";"1";"10";"63";"53425"
"6";"2";"4";"10";"63";"53427"
"2";"0";"2";"10";"63";"53429"
"9";"2";"7";"10";"63";"53430"
"1";"1";"0";"10";"63";"53431"
"2";"0";"2";"10";"63";"53437"
"34";"9";"25";"10";"63";"53438"
"2";"0";"2";"10";"63";"53441"
"2";"1";"1";"10";"63";"53443"
"1";"0";"1";"10";"63";"53445"
"30";"25";"5";"10";"63";"53446"
"4";"2";"2";"10";"63";"53447"
"5";"2";"3";"10";"63";"53448"
"3";"3";"0";"10";"63";"53449"
"4";"0";"4";"10";"63";"53450"
"3";"2";"1";"10";"63";"53451"
"2";"2";"0";"10";"63";"53453"
"1";"1";"0";"10";"63";"53456"
"437";"338";"99";"10";"63";"53459"
"3";"0";"3";"10";"63";"53461"
"9";"2";"7";"10";"63";"53464"
"5";"2";"3";"10";"63";"53466"
"1377";"1209";"168";"10";"63";"53468"
"1";"1";"0";"10";"63";"53473"
"2";"1";"1";"10";"63";"53474"
"4";"0";"4";"10";"63";"53478"
"2";"0";"2";"10";"63";"53481"
"1";"1";"0";"10";"63";"53483"
"1";"1";"0";"10";"63";"53484"
"2";"1";"1";"10";"63";"53485"
"1";"0";"1";"10";"63";"53486"
"29";"19";"10";"10";"63";"53487"
"4";"1";"3";"10";"63";"53490"
"2";"1";"1";"10";"63";"53493"
"2";"0";"2";"10";"63";"53495"
"3";"1";"2";"10";"63";"53496"
"3";"1";"2";"10";"63";"53497"
"39";"7";"32";"10";"63";"53498"
"1";"0";"1";"10";"63";"53499"
"3";"3";"0";"10";"63";"53501"
"3";"0";"3";"10";"63";"53502"
"3";"3";"0";"10";"63";"53503"
"2";"0";"2";"10";"63";"53504"
"1";"0";"1";"10";"63";"53505"
"4";"1";"3";"10";"63";"53507"
"9";"1";"8";"10";"63";"53508"
"2";"0";"2";"10";"63";"53511"
"2";"0";"2";"10";"63";"53514"
"5";"1";"4";"10";"63";"53515"
"2";"1";"1";"10";"63";"53516"
"4";"1";"3";"10";"63";"53518"
"5";"2";"3";"10";"63";"53519"
"1";"1";"0";"10";"63";"53521"
"1";"1";"0";"10";"63";"53525"
"162";"133";"29";"10";"63";"53528"
"512";"371";"141";"10";"63";"53529"
"6";"2";"4";"10";"63";"53530"
"3";"1";"2";"10";"63";"53531"
"1";"0";"1";"10";"63";"53532"
"10";"3";"7";"10";"63";"53533"
"12";"3";"9";"10";"63";"53534"
"3";"1";"2";"10";"63";"53535"
"34";"9";"25";"10";"63";"53537"
"1";"0";"1";"10";"63";"53540"
"2";"0";"2";"10";"63";"53541"
"6";"0";"6";"10";"63";"53543"
"4";"1";"3";"10";"63";"53544"
"7";"2";"5";"10";"63";"53545"
"2";"0";"2";"10";"63";"53546"
"3";"0";"3";"10";"63";"53548"
"1";"1";"0";"10";"63";"53550"
"4";"1";"3";"10";"63";"53551"
"2";"0";"2";"10";"63";"53552"
"3";"1";"2";"10";"63";"53553"
"2";"1";"1";"10";"63";"53554"
"7";"2";"5";"10";"63";"53556"
"5";"0";"5";"10";"63";"53559"
"2";"0";"2";"10";"63";"53563"
"1";"1";"0";"10";"63";"53564"
"115";"28";"87";"10";"63";"53565"
"3";"1";"2";"10";"63";"53570"
"1";"1";"0";"10";"63";"53573"
"22";"16";"6";"10";"63";"53575"
"6";"2";"4";"10";"63";"53576"
"2";"0";"2";"10";"63";"53577"
"19";"11";"8";"10";"63";"53578"
"10";"6";"4";"10";"63";"53580"
"4";"1";"3";"10";"63";"53582"
"472";"256";"216";"10";"63";"53584"
"14";"6";"8";"10";"63";"53586"
"1";"0";"1";"10";"63";"53588"
"8";"1";"7";"10";"63";"53591"
"2";"0";"2";"10";"63";"53592"
"4";"2";"2";"10";"63";"53593"
"6";"2";"4";"10";"63";"53595"
"5";"2";"3";"10";"63";"53596"
"3";"0";"3";"10";"63";"53597"
"18";"4";"14";"10";"63";"53598"
"7";"2";"5";"10";"63";"53599"
"7";"0";"7";"10";"63";"53606"
"5";"0";"5";"10";"63";"53607"
"9";"3";"6";"10";"63";"53608"
"7";"1";"6";"10";"63";"53609"
"15";"4";"11";"10";"63";"53610"
"4";"2";"2";"10";"63";"53612"
"3";"1";"2";"10";"63";"53613"
"1";"1";"0";"10";"63";"53614"
"5";"2";"3";"10";"63";"53617"
"3";"0";"3";"10";"63";"53620"
"2";"1";"1";"10";"63";"53622"
"2";"2";"0";"10";"63";"53623"
"11";"5";"6";"10";"63";"53624"
"29";"11";"18";"10";"63";"53626"
"12";"2";"10";"10";"63";"53627"
"2";"0";"2";"10";"63";"53628"
"4";"1";"3";"10";"63";"53629"
"2";"0";"2";"10";"63";"53631"
"3";"0";"3";"10";"63";"53633"
"4";"2";"2";"10";"63";"53634"
"1";"1";"0";"10";"63";"53635"
"2";"0";"2";"10";"63";"53636"
"1";"0";"1";"10";"63";"53638"
"8";"1";"7";"10";"63";"53640"
"1";"0";"1";"10";"63";"53641"
"1";"1";"0";"10";"63";"53642"
"797";"550";"247";"10";"63";"53643"
"4";"0";"4";"10";"63";"53644"
"6";"2";"4";"10";"63";"53645"
"5";"1";"4";"10";"63";"53647"
"3";"0";"3";"10";"63";"53648"
"2";"1";"1";"10";"63";"53649"
"8";"1";"7";"10";"63";"53652"
"356";"307";"49";"10";"63";"53653"
"8";"2";"6";"10";"63";"53654"
"8";"2";"6";"10";"63";"53656"
"1";"1";"0";"10";"63";"53657"
"7";"1";"6";"10";"63";"53658"
"7";"2";"5";"10";"63";"53659"
"12";"8";"4";"10";"63";"53660"
"29";"3";"26";"10";"63";"53662"
"2";"1";"1";"10";"63";"53663"
"4";"0";"4";"10";"63";"53664"
"2";"0";"2";"10";"63";"53666"
"11";"7";"4";"10";"63";"53667"
"5";"1";"4";"10";"63";"53668"
"8";"0";"8";"10";"63";"53669"
"2";"0";"2";"10";"63";"53671"
"1";"0";"1";"10";"63";"53672"
"2";"0";"2";"10";"63";"53675"
"3";"0";"3";"10";"63";"53678"
"6";"1";"5";"10";"63";"53679"
"2";"0";"2";"10";"63";"53680"
"6";"3";"3";"10";"63";"53681"
"3";"1";"2";"10";"63";"53683"
"1";"0";"1";"10";"63";"53684"
"4";"1";"3";"10";"63";"53686"
"3";"1";"2";"10";"63";"53687"
"1";"1";"0";"10";"63";"53689"
"12";"2";"10";"10";"63";"53692"
"1";"1";"0";"10";"63";"53694"
"50";"41";"9";"10";"63";"53695"
"13";"1";"12";"10";"63";"53699"
"16";"3";"13";"10";"63";"53700"
"5";"5";"0";"10";"63";"53705"
"26";"23";"3";"10";"63";"53706"
"7";"3";"4";"10";"63";"53709"
"2";"0";"2";"10";"63";"53710"
"6";"0";"6";"10";"63";"53711"
"4";"1";"3";"10";"63";"53712"
"19";"3";"16";"10";"63";"53714"
"6";"1";"5";"10";"63";"53716"
"1";"0";"1";"10";"63";"53717"
"5";"2";"3";"10";"63";"53718"
"9";"3";"6";"10";"63";"53720"
"4";"0";"4";"10";"63";"53726"
"1";"1";"0";"10";"63";"53729"
"2";"0";"2";"10";"63";"53730"
"5";"1";"4";"10";"63";"53731"
"2";"0";"2";"10";"63";"53732"
"11";"4";"7";"10";"63";"53733"
"4";"0";"4";"10";"63";"53734"
"7";"1";"6";"10";"63";"53735"
"9";"1";"8";"10";"63";"53736"
"14";"4";"10";"10";"63";"53737"
"4";"2";"2";"10";"63";"53739"
"1";"0";"1";"10";"63";"53741"
"5";"2";"3";"10";"63";"53745"
"5";"2";"3";"10";"63";"53747"
"2";"1";"1";"10";"63";"53748"
"4";"0";"4";"10";"63";"53749"
"2";"1";"1";"10";"63";"53752"
"1";"1";"0";"10";"63";"53753"
"58";"48";"10";"10";"63";"53754"
"4";"1";"3";"10";"63";"53755"
"1";"0";"1";"10";"63";"53756"
"14";"7";"7";"10";"63";"53757"
"11";"7";"4";"10";"63";"53758"
"2";"0";"2";"10";"63";"53760"
"5";"1";"4";"10";"63";"53761"
"4";"1";"3";"10";"63";"53766"
"1";"0";"1";"10";"63";"53769"
"27";"17";"10";"10";"63";"53771"
"2";"0";"2";"10";"63";"53774"
"6";"1";"5";"10";"63";"53775"
"3";"0";"3";"10";"63";"53776"
"2";"0";"2";"10";"63";"53777"
"6";"3";"3";"10";"63";"53778"
"1";"1";"0";"10";"63";"53779"
"4";"1";"3";"10";"63";"53781"
"136";"56";"80";"10";"63";"53786"
"5";"1";"4";"10";"63";"53787"
"3";"0";"3";"10";"63";"53788"
"1";"1";"0";"10";"63";"53789"
"4";"0";"4";"10";"63";"53790"
"2";"0";"2";"10";"63";"53791"
"3";"0";"3";"10";"63";"53793"
"6";"2";"4";"10";"63";"53794"
"1";"0";"1";"10";"63";"53795"
"6";"1";"5";"10";"63";"53796"
"1";"0";"1";"10";"63";"53800"
"6";"1";"5";"10";"63";"53801"
"1";"1";"0";"10";"63";"53802"
"89";"38";"51";"10";"63";"53803"
"2";"0";"2";"10";"63";"53805"
"2";"0";"2";"10";"63";"53807"
"2";"0";"2";"10";"63";"53808"
"15";"4";"11";"10";"63";"53810"
"19";"8";"11";"10";"63";"53813"
"7";"1";"6";"10";"63";"53814"
"13";"2";"11";"10";"63";"53815"
"2";"1";"1";"10";"63";"53818"
"1";"0";"1";"10";"63";"53819"
"3";"1";"2";"10";"63";"53820"
"1";"0";"1";"10";"63";"53821"
"2";"1";"1";"10";"63";"53822"
"7";"2";"5";"10";"63";"53823"
"1";"0";"1";"10";"63";"53824"
"5";"1";"4";"10";"63";"53826"
"4";"0";"4";"10";"63";"53827"
"7";"1";"6";"10";"63";"53828"
"17";"9";"8";"10";"63";"53829"
"1";"1";"0";"10";"63";"53830"
"1";"1";"0";"10";"63";"53831"
"3";"0";"3";"10";"63";"53832"
"10";"6";"4";"10";"63";"53833"
"1";"0";"1";"10";"63";"53835"
"1";"0";"1";"10";"63";"53836"
"2";"1";"1";"10";"63";"53837"
"15";"7";"8";"10";"63";"53838"
"1";"1";"0";"10";"63";"53840"
"6";"5";"1";"10";"63";"53841"
"7";"1";"6";"10";"63";"53842"
"17";"4";"13";"10";"63";"53843"
"1";"1";"0";"10";"63";"53844"
"3";"0";"3";"10";"63";"53845"
"18";"4";"14";"10";"63";"53848"
"6";"1";"5";"10";"63";"53850"
"7";"1";"6";"10";"63";"53851"
"15";"12";"3";"10";"63";"53855"
"7";"0";"7";"10";"63";"53856"
"3";"0";"3";"10";"63";"53857"
"2";"1";"1";"10";"63";"53860"
"7";"1";"6";"10";"63";"53862"
"27";"3";"24";"10";"63";"53863"
"87";"53";"34";"10";"63";"53864"
"9";"1";"8";"10";"63";"53866"
"5";"1";"4";"10";"63";"53867"
"7";"3";"4";"10";"63";"53868"
"5";"1";"4";"10";"63";"53872"
"11";"2";"9";"10";"63";"53873"
"2";"1";"1";"10";"63";"53874"
"23";"9";"14";"10";"63";"53877"
"7";"1";"6";"10";"63";"53881"
"4";"2";"2";"10";"63";"53882"
"8";"2";"6";"10";"63";"53884"
"212";"129";"83";"10";"63";"53888"
"4";"2";"2";"10";"63";"53889"
"1";"0";"1";"10";"63";"53890"
"3";"0";"3";"10";"63";"53891"
"1";"0";"1";"10";"63";"53892"
"2";"1";"1";"10";"63";"53894"
"2";"1";"1";"10";"63";"53895"
"10";"1";"9";"10";"63";"53897"
"1";"1";"0";"10";"63";"53899"
"1";"1";"0";"10";"63";"53900"
"4";"0";"4";"10";"63";"53901"
"4";"0";"4";"10";"63";"53902"
"6";"2";"4";"10";"63";"53905"
"2";"0";"2";"10";"63";"53906"
"4";"3";"1";"10";"63";"53908"
"1";"0";"1";"10";"63";"53909"
"1";"0";"1";"10";"63";"53910"
"8";"3";"5";"10";"63";"53913"
"7";"0";"7";"10";"63";"53914"
"3";"0";"3";"10";"63";"53915"
"2";"1";"1";"10";"63";"53916"
"1";"1";"0";"10";"63";"53917"
"3";"1";"2";"10";"63";"53918"
"16";"2";"14";"10";"63";"53920"
"9";"4";"5";"10";"63";"53923"
"2";"1";"1";"10";"63";"53927"
"2";"0";"2";"10";"63";"53928"
"2";"0";"2";"10";"63";"53929"
"3";"0";"3";"10";"63";"53930"
"1";"1";"0";"10";"63";"53931"
"5";"1";"4";"10";"63";"53932"
"1";"0";"1";"10";"63";"53933"
"2";"0";"2";"10";"63";"53936"
"2";"1";"1";"10";"63";"53937"
"10";"2";"8";"10";"63";"53939"
"3";"1";"2";"10";"63";"53940"
"2";"1";"1";"10";"63";"53941"
"6";"2";"4";"10";"63";"53943"
"7";"3";"4";"10";"63";"53946"
"1";"0";"1";"10";"63";"53947"
"197";"131";"66";"10";"63";"53948"
"3";"0";"3";"10";"63";"53950"
"1";"1";"0";"10";"63";"53951"
"10";"4";"6";"10";"63";"53952"
"89";"66";"23";"10";"63";"53953"
"11";"3";"8";"10";"63";"53954"
"3";"0";"3";"10";"63";"53956"
"3";"1";"2";"10";"63";"53957"
"4";"2";"2";"10";"63";"53958"
"8";"3";"5";"10";"63";"53959"
"3";"0";"3";"10";"63";"53960"
"2";"0";"2";"10";"63";"53961"
"1";"0";"1";"10";"63";"53962"
"1";"1";"0";"10";"63";"53963"
"1";"1";"0";"10";"63";"53964"
"1";"1";"0";"10";"63";"53966"
"2";"0";"2";"10";"63";"53969"
"4";"0";"4";"10";"63";"53971"
"2";"0";"2";"10";"63";"53974"
"5";"1";"4";"10";"63";"53975"
"4";"1";"3";"10";"63";"53976"
"359";"255";"104";"10";"63";"53980"
"3";"1";"2";"10";"63";"53983"
"4";"1";"3";"10";"63";"53985"
"3";"1";"2";"10";"63";"53987"
"2";"1";"1";"10";"63";"53988"
"4";"2";"2";"10";"63";"53989"
"1";"0";"1";"10";"63";"53991"
"37";"16";"21";"10";"63";"53992"
"2";"0";"2";"10";"63";"53994"
"4";"0";"4";"10";"63";"53996"
"5";"3";"2";"10";"63";"53997"
"2";"0";"2";"10";"63";"53998"
"168";"103";"65";"10";"63";"54000"
"4";"0";"4";"10";"63";"54002"
"2";"0";"2";"10";"63";"54004"
"1";"1";"0";"10";"63";"54006"
"40";"15";"25";"10";"63";"54007"
"3";"3";"0";"10";"63";"54011"
"2";"0";"2";"10";"63";"54012"
"14";"7";"7";"10";"63";"54013"
"2";"1";"1";"10";"63";"54014"
"2";"1";"1";"10";"63";"54015"
"5";"0";"5";"10";"63";"54016"
"14";"5";"9";"10";"63";"54017"
"2";"0";"2";"10";"63";"54022"
"2";"0";"2";"10";"63";"54023"
"3";"0";"3";"10";"63";"54025"
"1";"1";"0";"10";"63";"54026"
"1";"0";"1";"10";"63";"54028"
"206";"138";"68";"10";"63";"54029"
"4";"1";"3";"10";"63";"54030"
"5";"1";"4";"10";"63";"54032"
"4";"1";"3";"10";"63";"54033"
"35";"17";"18";"10";"63";"54034"
"13";"2";"11";"10";"63";"54035"
"2";"1";"1";"10";"63";"54039"
"4";"2";"2";"10";"63";"54040"
"2";"2";"0";"10";"63";"54042"
"2";"2";"0";"10";"63";"54046"
"2";"0";"2";"10";"63";"54047"
"2";"2";"0";"10";"63";"54051"
"2";"1";"1";"10";"63";"54053"
"1";"0";"1";"10";"63";"54055"
"2";"2";"0";"10";"63";"54059"
"6";"0";"6";"10";"63";"54063"
"9";"2";"7";"10";"63";"54064"
"4";"1";"3";"10";"63";"54065"
"548";"506";"42";"10";"63";"54066"
"11";"4";"7";"10";"63";"54067"
"13";"1";"12";"10";"63";"54068"
"3";"0";"3";"10";"63";"54069"
"3";"2";"1";"10";"63";"54070"
"29";"16";"13";"10";"63";"54072"
"4";"1";"3";"10";"63";"54074"
"2";"1";"1";"10";"63";"54076"
"1";"1";"0";"10";"63";"54077"
"1";"1";"0";"10";"63";"54078"
"14";"2";"12";"10";"63";"54079"
"17";"9";"8";"10";"63";"54080"
"1";"1";"0";"10";"63";"54081"
"2";"0";"2";"10";"63";"54083"
"8";"3";"5";"10";"63";"54084"
"1";"0";"1";"10";"63";"54085"
"4";"0";"4";"10";"63";"54087"
"10";"1";"9";"10";"63";"54089"
"3";"1";"2";"10";"63";"54090"
"11";"3";"8";"10";"63";"54091"
"3";"0";"3";"10";"63";"54092"
"40";"24";"16";"10";"63";"54093"
"1";"1";"0";"10";"63";"54097"
"3";"0";"3";"10";"63";"54098"
"1";"0";"1";"10";"63";"54099"
"7";"3";"4";"10";"63";"54100"
"2";"0";"2";"10";"63";"54101"
"16";"11";"5";"10";"63";"54110"
"1";"0";"1";"10";"63";"54111"
"4";"0";"4";"10";"63";"54112"
"3";"0";"3";"10";"63";"54113"
"1";"0";"1";"10";"63";"54115"
"6";"1";"5";"10";"63";"54118"
"5";"2";"3";"10";"63";"54119"
"2";"0";"2";"10";"63";"54121"
"5";"0";"5";"10";"63";"54123"
"3";"1";"2";"10";"63";"54127"
"1";"0";"1";"10";"63";"54130"
"2";"1";"1";"10";"63";"54131"
"2";"0";"2";"10";"63";"54132"
"5";"2";"3";"10";"63";"54133"
"5";"2";"3";"10";"63";"54134"
"6";"3";"3";"10";"63";"54136"
"10";"2";"8";"10";"63";"54137"
"20";"2";"18";"10";"63";"54141"
"3";"0";"3";"10";"63";"54143"
"2";"1";"1";"10";"63";"54144"
"34";"11";"23";"10";"63";"54145"
"1";"1";"0";"10";"63";"54147"
"1";"1";"0";"10";"63";"54149"
"1";"0";"1";"10";"63";"54152"
"2";"0";"2";"10";"63";"54154"
"3";"0";"3";"10";"63";"54155"
"10";"4";"6";"10";"63";"54156"
"10";"3";"7";"10";"63";"54157"
"2";"1";"1";"10";"63";"54158"
"13";"10";"3";"10";"63";"54159"
"9";"4";"5";"10";"63";"54160"
"4";"1";"3";"10";"63";"54161"
"2";"1";"1";"10";"63";"54162"
"5";"1";"4";"10";"63";"54164"
"2";"1";"1";"10";"63";"54165"
"3";"0";"3";"10";"63";"54166"
"16";"3";"13";"10";"63";"54168"
"10";"1";"9";"10";"63";"54172"
"1";"1";"0";"10";"63";"54174"
"2";"1";"1";"10";"63";"54176"
"4";"2";"2";"10";"63";"54177"
"3";"0";"3";"10";"63";"54178"
"4";"2";"2";"10";"63";"54180"
"1";"0";"1";"10";"63";"54181"
"8";"3";"5";"10";"63";"54182"
"1";"0";"1";"10";"63";"54183"
"3";"0";"3";"10";"63";"54184"
"11";"0";"11";"10";"63";"54188"
"2";"0";"2";"10";"63";"54189"
"26";"4";"22";"10";"63";"54191"
"12";"4";"8";"10";"63";"54192"
"3";"2";"1";"10";"63";"54196"
"2";"1";"1";"10";"63";"54197"
"3";"0";"3";"10";"63";"54198"
"2";"0";"2";"10";"63";"54199"
"2";"0";"2";"10";"63";"54200"
"14";"2";"12";"10";"63";"54202"
"8";"3";"5";"10";"63";"54203"
"1";"1";"0";"10";"63";"54204"
"3";"0";"3";"10";"63";"54207"
"10";"2";"8";"10";"63";"54210"
"2";"0";"2";"10";"63";"54211"
"2";"1";"1";"10";"63";"54212"
"11";"4";"7";"10";"63";"54215"
"2";"0";"2";"10";"63";"54218"
"2";"0";"2";"10";"63";"54220"
"2";"1";"1";"10";"63";"54222"
"10";"4";"6";"10";"63";"54223"
"2";"1";"1";"10";"63";"54225"
"8";"2";"6";"10";"63";"54226"
"95";"41";"54";"10";"63";"54228"
"2";"2";"0";"10";"63";"54229"
"1";"0";"1";"10";"63";"54231"
"2";"1";"1";"10";"63";"54232"
"2";"1";"1";"10";"63";"54235"
"1";"0";"1";"10";"63";"54236"
"4";"0";"4";"10";"63";"54237"
"35";"10";"25";"10";"63";"54238"
"3";"1";"2";"10";"63";"54239"
"6";"2";"4";"10";"63";"54241"
"4";"0";"4";"10";"63";"54242"
"10";"2";"8";"10";"63";"54244"
"4";"0";"4";"10";"63";"54247"
"1";"0";"1";"10";"63";"54250"
"1";"0";"1";"10";"63";"54252"
"1";"1";"0";"10";"63";"54253"
"20";"11";"9";"10";"63";"54255"
"1";"0";"1";"10";"63";"54258"
"1";"0";"1";"10";"63";"54259"
"4";"1";"3";"10";"63";"54260"
"2";"1";"1";"10";"63";"54261"
"101";"54";"47";"10";"63";"54262"
"6";"1";"5";"10";"63";"54265"
"166";"62";"104";"10";"63";"54269"
"3";"0";"3";"10";"63";"54270"
"1";"0";"1";"10";"63";"54271"
"2";"2";"0";"10";"63";"54272"
"3";"3";"0";"10";"63";"54276"
"6";"1";"5";"10";"63";"54277"
"1";"1";"0";"10";"63";"54278"
"10";"4";"6";"10";"63";"54280"
"1";"0";"1";"10";"63";"54281"
"2";"0";"2";"10";"63";"54282"
"1";"0";"1";"10";"63";"54283"
"4";"0";"4";"10";"63";"54286"
"2";"1";"1";"10";"63";"54287"
"33";"17";"16";"10";"63";"54288"
"3";"1";"2";"10";"63";"54289"
"6";"1";"5";"10";"63";"54291"
"2";"0";"2";"10";"63";"54292"
"5";"1";"4";"10";"63";"54293"
"1";"0";"1";"10";"63";"54294"
"1";"0";"1";"10";"63";"54296"
"3";"1";"2";"10";"63";"54297"
"2";"1";"1";"10";"63";"54301"
"2";"1";"1";"10";"63";"54305"
"2";"0";"2";"10";"63";"54309"
"2";"1";"1";"10";"63";"54310"
"4";"1";"3";"10";"63";"54311"
"13";"4";"9";"10";"63";"54312"
"18";"5";"13";"10";"63";"54314"
"35";"14";"21";"10";"63";"54316"
"18";"9";"9";"10";"63";"54317"
"16";"5";"11";"10";"63";"54318"
"12";"3";"9";"10";"63";"54319"
"3";"1";"2";"10";"63";"54322"
"6";"1";"5";"10";"63";"54323"
"3";"1";"2";"10";"63";"54325"
"31";"13";"18";"10";"63";"54328"
"8";"6";"2";"10";"63";"54329"
"3";"3";"0";"10";"63";"54330"
"2";"1";"1";"10";"63";"54331"
"11";"2";"9";"10";"63";"54332"
"17";"6";"11";"10";"63";"54335"
"7";"1";"6";"10";"63";"54336"
"22";"7";"15";"10";"63";"54337"
"5";"2";"3";"10";"63";"54338"
"1";"1";"0";"10";"63";"54339"
"1";"0";"1";"10";"63";"54340"
"3";"1";"2";"10";"63";"54341"
"2";"0";"2";"10";"63";"54342"
"3";"0";"3";"10";"63";"54344"
"9";"2";"7";"10";"63";"54347"
"27";"11";"16";"10";"63";"54348"
"2";"1";"1";"10";"63";"54351"
"6";"0";"6";"10";"63";"54353"
"1";"0";"1";"10";"63";"54354"
"1";"0";"1";"10";"63";"54357"
"1";"0";"1";"10";"63";"54358"
"3";"2";"1";"10";"63";"54360"
"10";"2";"8";"10";"63";"54362"
"4";"1";"3";"10";"63";"54363"
"2";"0";"2";"10";"63";"54364"
"16";"6";"10";"10";"63";"54366"
"6";"2";"4";"10";"63";"54367"
"1";"1";"0";"10";"63";"54368"
"1";"0";"1";"10";"63";"54370"
"4";"0";"4";"10";"63";"54372"
"1";"1";"0";"10";"63";"54373"
"2";"1";"1";"10";"63";"54376"
"16";"7";"9";"10";"63";"54377"
"1";"1";"0";"10";"63";"54378"
"2";"1";"1";"10";"63";"54381"
"15";"4";"11";"10";"63";"54382"
"2";"1";"1";"10";"63";"54383"
"1";"0";"1";"10";"63";"54384"
"38";"4";"34";"10";"63";"54387"
"9";"1";"8";"10";"63";"54390"
"2";"0";"2";"10";"63";"54394"
"8";"1";"7";"10";"63";"54397"
"2";"0";"2";"10";"63";"54398"
"3";"0";"3";"10";"63";"54402"
"1";"0";"1";"10";"63";"54405"
"8";"1";"7";"10";"63";"54407"
"1";"1";"0";"10";"63";"54408"
"3";"0";"3";"10";"63";"54411"
"7";"1";"6";"10";"63";"54413"
"9";"4";"5";"10";"63";"54414"
"20";"3";"17";"10";"63";"54415"
"1";"1";"0";"10";"63";"54416"
"3";"1";"2";"10";"63";"54417"
"1";"0";"1";"10";"63";"54420"
"9";"4";"5";"10";"63";"54421"
"11";"2";"9";"10";"63";"54422"
"1";"1";"0";"10";"63";"54423"
"2";"0";"2";"10";"63";"54424"
"22";"10";"12";"10";"63";"54426"
"15";"5";"10";"10";"63";"54428"
"3";"0";"3";"10";"63";"54429"
"7";"1";"6";"10";"63";"54432"
"8";"2";"6";"10";"63";"54433"
"3";"0";"3";"10";"63";"54435"
"7";"2";"5";"10";"63";"54436"
"3";"0";"3";"10";"63";"54438"
"1";"1";"0";"10";"63";"54440"
"6";"1";"5";"10";"63";"54441"
"3";"0";"3";"10";"63";"54444"
"15";"2";"13";"10";"63";"54445"
"3";"0";"3";"10";"63";"54446"
"3";"0";"3";"10";"63";"54448"
"1";"0";"1";"10";"63";"54451"
"26";"9";"17";"10";"63";"54452"
"251";"135";"116";"10";"63";"54453"
"21";"4";"17";"10";"63";"54455"
"7";"0";"7";"10";"63";"54456"
"4";"1";"3";"10";"63";"54457"
"2";"0";"2";"10";"63";"54458"
"3";"0";"3";"10";"63";"54459"
"6";"2";"4";"10";"63";"54463"
"1";"1";"0";"10";"63";"54464"
"1";"0";"1";"10";"63";"54465"
"2";"0";"2";"10";"63";"54466"
"2";"0";"2";"10";"63";"54467"
"1";"0";"1";"10";"63";"54468"
"6";"2";"4";"10";"63";"54470"
"2";"0";"2";"10";"63";"54471"
"1";"0";"1";"10";"63";"54472"
"3";"1";"2";"10";"63";"54475"
"5";"0";"5";"10";"63";"54476"
"75";"53";"22";"10";"63";"54477"
"47";"13";"34";"10";"63";"54478"
"3";"0";"3";"10";"63";"54479"
"7";"0";"7";"10";"63";"54480"
"2";"0";"2";"10";"63";"54481"
"1";"0";"1";"10";"63";"54482"
"4";"1";"3";"10";"63";"54484"
"15";"2";"13";"10";"63";"54487"
"66";"16";"50";"10";"63";"54490"
"1";"1";"0";"10";"63";"54493"
"4";"1";"3";"10";"63";"54494"
"5";"2";"3";"10";"63";"54496"
"21";"5";"16";"10";"63";"54497"
"3";"0";"3";"10";"63";"54498"
"18";"8";"10";"10";"63";"54499"
"79";"31";"48";"10";"63";"54501"
"3";"1";"2";"10";"63";"54503"
"10";"3";"7";"10";"63";"54504"
"5";"1";"4";"10";"63";"54505"
"1";"1";"0";"10";"63";"54506"
"1";"1";"0";"10";"63";"54507"
"1";"0";"1";"10";"63";"54510"
"48";"30";"18";"10";"63";"54511"
"2";"0";"2";"10";"63";"54513"
"2";"1";"1";"10";"63";"54514"
"1";"1";"0";"10";"63";"54517"
"1";"1";"0";"10";"63";"54518"
"1";"0";"1";"10";"63";"54520"
"1";"1";"0";"10";"63";"54521"
"24";"6";"18";"10";"63";"54526"
"9";"1";"8";"10";"63";"54527"
"1";"1";"0";"10";"63";"54528"
"42";"13";"29";"10";"63";"54531"
"6";"1";"5";"10";"63";"54534"
"26";"3";"23";"10";"63";"54537"
"2";"0";"2";"10";"63";"54538"
"19";"9";"10";"10";"63";"54539"
"40";"10";"30";"10";"63";"54540"
"7";"1";"6";"10";"63";"54543"
"9";"8";"1";"10";"63";"54545"
"5";"1";"4";"10";"63";"54546"
"13";"0";"13";"10";"63";"54547"
"2";"2";"0";"10";"63";"54550"
"96";"81";"15";"10";"63";"54552"
"4";"2";"2";"10";"63";"54553"
"2";"1";"1";"10";"63";"54554"
"1";"0";"1";"10";"63";"54558"
"1";"1";"0";"10";"63";"54559"
"2";"0";"2";"10";"63";"54560"
"4";"0";"4";"10";"63";"54562"
"3";"0";"3";"10";"63";"54565"
"3";"0";"3";"10";"63";"54569"
"13";"3";"10";"10";"63";"54570"
"1";"0";"1";"10";"63";"54571"
"6";"1";"5";"10";"63";"54573"
"4";"0";"4";"10";"63";"54574"
"1";"1";"0";"10";"63";"54575"
"2";"0";"2";"10";"63";"54576"
"36";"12";"24";"10";"63";"54577"
"1";"0";"1";"10";"63";"54578"
"6";"3";"3";"10";"63";"54580"
"1";"0";"1";"10";"63";"54581"
"1";"1";"0";"10";"63";"54582"
"30";"27";"3";"10";"63";"54583"
"5";"2";"3";"10";"63";"54584"
"4";"2";"2";"10";"63";"54586"
"6";"2";"4";"10";"63";"54587"
"2";"2";"0";"10";"63";"54590"
"2";"0";"2";"10";"63";"54594"
"4";"1";"3";"10";"63";"54595"
"1";"1";"0";"10";"63";"54596"
"1";"1";"0";"10";"63";"54597"
"2";"1";"1";"10";"63";"54598"
"2";"0";"2";"10";"63";"54599"
"2";"0";"2";"10";"63";"54600"
"18";"4";"14";"10";"63";"54603"
"1";"1";"0";"10";"63";"54604"
"10";"1";"9";"10";"63";"54606"
"6";"1";"5";"10";"63";"54607"
"8";"1";"7";"10";"63";"54608"
"4";"1";"3";"10";"63";"54610"
"1";"0";"1";"10";"63";"54611"
"3";"0";"3";"10";"63";"54613"
"2";"2";"0";"10";"63";"54614"
"2";"0";"2";"10";"63";"54618"
"1";"0";"1";"10";"63";"54620"
"1";"0";"1";"10";"63";"54621"
"2";"0";"2";"10";"63";"54622"
"16";"1";"15";"10";"63";"54623"
"2";"0";"2";"10";"63";"54628"
"6";"1";"5";"10";"63";"54630"
"19";"1";"18";"10";"63";"54632"
"2";"0";"2";"10";"63";"54633"
"1";"1";"0";"10";"63";"54636"
"1";"1";"0";"10";"63";"54638"
"1";"1";"0";"10";"63";"54643"
"1";"1";"0";"10";"63";"54644"
"1";"1";"0";"10";"63";"54646"
"4";"1";"3";"10";"63";"54650"
"8";"8";"0";"10";"63";"54652"
"8";"3";"5";"10";"63";"54654"
"15";"12";"3";"10";"63";"54655"
"1";"1";"0";"10";"63";"54658"
"1";"1";"0";"10";"63";"54660"
"2";"1";"1";"10";"63";"54662"
"1";"1";"0";"10";"63";"54663"
"56";"50";"6";"10";"63";"54664"
"2";"1";"1";"10";"63";"54666"
"1";"1";"0";"10";"63";"54667"
"3";"1";"2";"10";"63";"54668"
"3";"3";"0";"10";"63";"54670"
"1";"1";"0";"10";"63";"54672"
"2";"0";"2";"10";"63";"54673"
"15";"3";"12";"10";"63";"54674"
"1";"1";"0";"10";"63";"54676"
"2";"0";"2";"10";"63";"54677"
"3";"0";"3";"10";"63";"54678"
"2";"1";"1";"10";"63";"54679"
"1";"1";"0";"10";"63";"54681"
"3";"0";"3";"10";"63";"54683"
"51";"19";"32";"10";"63";"54685"
"6";"6";"0";"10";"63";"54690"
"2";"1";"1";"10";"63";"54693"
"886";"791";"95";"10";"63";"54697"
"64";"32";"32";"10";"63";"54699"
"13";"4";"9";"10";"63";"54700"
"13";"7";"6";"10";"63";"54702"
"9";"5";"4";"10";"63";"54703"
"3";"1";"2";"10";"63";"54705"
"6";"2";"4";"10";"63";"54706"
"3";"0";"3";"10";"63";"54710"
"2";"1";"1";"10";"63";"54715"
"1569";"1318";"251";"10";"63";"54718"
"1";"1";"0";"10";"63";"54720"
"1";"0";"1";"10";"63";"54722"
"4";"1";"3";"10";"63";"54723"
"2";"0";"2";"10";"63";"54724"
"8";"3";"5";"10";"63";"54725"
"4";"0";"4";"10";"63";"54727"
"3";"1";"2";"10";"63";"54730"
"3";"1";"2";"10";"63";"54731"
"4";"2";"2";"10";"63";"54732"
"9";"2";"7";"10";"63";"54733"
"3";"1";"2";"10";"63";"54734"
"1";"0";"1";"10";"63";"54737"
"303";"213";"90";"10";"63";"54738"
"1";"1";"0";"10";"63";"54739"
"4";"1";"3";"10";"63";"54742"
"1";"0";"1";"10";"63";"54746"
"7";"2";"5";"10";"63";"54747"
"2";"1";"1";"10";"63";"54748"
"4";"1";"3";"10";"63";"54749"
"19";"5";"14";"10";"63";"54750"
"1";"0";"1";"10";"63";"54752"
"15";"6";"9";"10";"63";"54754"
"3";"0";"3";"10";"63";"54755"
"8";"3";"5";"10";"63";"54758"
"24";"8";"16";"10";"63";"54760"
"2";"0";"2";"10";"63";"54763"
"2";"0";"2";"10";"63";"54767"
"1";"0";"1";"10";"63";"54768"
"1";"1";"0";"10";"63";"54769"
"5";"0";"5";"10";"63";"54770"
"11";"3";"8";"10";"63";"54774"
"1";"0";"1";"10";"63";"54779"
"7";"2";"5";"10";"63";"54780"
"7";"2";"5";"10";"63";"54781"
"1";"1";"0";"10";"63";"54785"
"2";"0";"2";"10";"63";"54786"
"2";"0";"2";"10";"63";"54790"
"1";"0";"1";"10";"63";"54792"
"5";"0";"5";"10";"63";"54793"
"3";"1";"2";"10";"63";"54795"
"6";"2";"4";"10";"63";"54797"
"4";"1";"3";"10";"63";"54798"
"1";"0";"1";"10";"63";"54799"
"2";"1";"1";"10";"63";"54803"
"24";"11";"13";"10";"63";"54804"
"5";"1";"4";"10";"63";"54805"
"5";"2";"3";"10";"63";"54806"
"291";"202";"89";"10";"63";"54808"
"4";"2";"2";"10";"63";"54810"
"4";"4";"0";"10";"63";"54811"
"1";"1";"0";"10";"63";"54812"
"2";"1";"1";"10";"63";"54813"
"1";"1";"0";"10";"63";"54814"
"11";"3";"8";"10";"63";"54815"
"2";"1";"1";"10";"63";"54816"
"7";"2";"5";"10";"63";"54817"
"3";"1";"2";"10";"63";"54824"
"4";"2";"2";"10";"63";"54826"
"5";"1";"4";"10";"63";"54828"
"1";"1";"0";"10";"63";"54829"
"1";"1";"0";"10";"63";"54832"
"10";"1";"9";"10";"63";"54834"
"4";"0";"4";"10";"63";"54835"
"19";"7";"12";"10";"63";"54836"
"10";"2";"8";"10";"63";"54842"
"2";"0";"2";"10";"63";"54844"
"8";"0";"8";"10";"63";"54846"
"1";"1";"0";"10";"63";"54847"
"6";"1";"5";"10";"63";"54850"
"2";"0";"2";"10";"63";"54852"
"2";"0";"2";"10";"63";"54854"
"30";"13";"17";"10";"63";"54855"
"32";"18";"14";"10";"63";"54856"
"1";"1";"0";"10";"63";"54857"
"4";"0";"4";"10";"63";"54858"
"7";"0";"7";"10";"63";"54859"
"2";"0";"2";"10";"63";"54860"
"8";"4";"4";"10";"63";"54863"
"38";"33";"5";"10";"63";"54864"
"10";"8";"2";"10";"63";"54865"
"5";"1";"4";"10";"63";"54866"
"2";"0";"2";"10";"63";"54869"
"7";"1";"6";"10";"63";"54870"
"35";"5";"30";"10";"63";"54872"
"13";"2";"11";"10";"63";"54874"
"1";"0";"1";"10";"63";"54875"
"2";"0";"2";"10";"63";"54876"
"2";"1";"1";"10";"63";"54877"
"5";"1";"4";"10";"63";"54884"
"3";"2";"1";"10";"63";"54885"
"19";"3";"16";"10";"63";"54887"
"2";"1";"1";"10";"63";"54889"
"5";"0";"5";"10";"63";"54892"
"6";"1";"5";"10";"63";"54893"
"63";"15";"48";"10";"63";"54894"
"1";"1";"0";"10";"63";"54895"
"22";"4";"18";"10";"63";"54897"
"13";"7";"6";"10";"63";"54898"
"3";"0";"3";"10";"63";"54899"
"3";"0";"3";"10";"63";"54900"
"32";"6";"26";"10";"63";"54901"
"2";"2";"0";"10";"63";"54902"
"4";"0";"4";"10";"63";"54903"
"1";"0";"1";"10";"63";"54908"
"6";"1";"5";"10";"63";"54909"
"9";"2";"7";"10";"63";"54911"
"2";"1";"1";"10";"63";"54915"
"12";"7";"5";"10";"63";"54916"
"22";"4";"18";"10";"63";"54920"
"3";"0";"3";"10";"63";"54923"
"1";"1";"0";"10";"63";"54924"
"2";"0";"2";"10";"63";"54925"
"2";"0";"2";"10";"63";"54926"
"3";"1";"2";"10";"63";"54927"
"21";"2";"19";"10";"63";"54928"
"3";"0";"3";"10";"63";"54929"
"1";"1";"0";"10";"63";"54930"
"1";"0";"1";"10";"63";"54931"
"2";"2";"0";"10";"63";"54932"
"5";"1";"4";"10";"63";"54933"
"4";"0";"4";"10";"63";"54935"
"15";"3";"12";"10";"63";"54937"
"1";"1";"0";"10";"63";"54938"
"21";"1";"20";"10";"63";"54943"
"1";"1";"0";"10";"63";"54949"
"58";"8";"50";"10";"63";"54951"
"9";"2";"7";"10";"63";"54954"
"2";"2";"0";"10";"63";"54956"
"5";"1";"4";"10";"63";"54957"
"9";"7";"2";"10";"63";"54960"
"2";"1";"1";"10";"63";"54962"
"4";"4";"0";"10";"63";"54964"
"10";"5";"5";"10";"63";"54966"
"98";"62";"36";"10";"63";"54969"
"6";"2";"4";"10";"63";"54970"
"15";"11";"4";"10";"63";"54973"
"1";"1";"0";"10";"63";"54975"
"4";"0";"4";"10";"63";"54976"
"23";"4";"19";"10";"63";"54978"
"33";"8";"25";"10";"63";"54979"
"2";"0";"2";"10";"63";"54980"
"7";"0";"7";"10";"63";"54981"
"9";"4";"5";"10";"63";"54984"
"2";"0";"2";"10";"63";"54985"
"12";"1";"11";"10";"63";"54987"
"10";"2";"8";"10";"63";"54991"
"1";"1";"0";"10";"63";"54993"
"3";"0";"3";"10";"63";"54994"
"2";"1";"1";"10";"63";"54995"
"2";"2";"0";"10";"63";"54996"
"9";"3";"6";"10";"63";"55000"
"45";"33";"12";"10";"63";"55003"
"3";"1";"2";"10";"63";"55004"
"5";"1";"4";"10";"63";"55008"
"6";"2";"4";"10";"63";"55009"
"6";"0";"6";"10";"63";"55011"
"1";"0";"1";"10";"63";"55013"
"3";"0";"3";"10";"63";"55016"
"10";"2";"8";"10";"63";"55018"
"4";"1";"3";"10";"63";"55019"
"1";"1";"0";"10";"63";"55022"
"21";"18";"3";"10";"63";"55024"
"3";"1";"2";"10";"63";"55028"
"36";"19";"17";"10";"63";"55031"
"3";"3";"0";"10";"63";"55034"
"1";"0";"1";"10";"63";"55037"
"3";"0";"3";"10";"63";"55039"
"2";"1";"1";"10";"63";"55040"
"4";"1";"3";"10";"63";"55042"
"5";"2";"3";"10";"63";"55046"
"1";"0";"1";"10";"63";"55047"
"1";"0";"1";"10";"63";"55050"
"5";"0";"5";"10";"63";"55052"
"1";"0";"1";"10";"63";"55054"
"1";"1";"0";"10";"63";"55055"
"12";"3";"9";"10";"63";"55056"
"3";"2";"1";"10";"63";"55057"
"6";"2";"4";"10";"63";"55058"
"36";"0";"36";"10";"63";"55059"
"2";"1";"1";"10";"63";"55061"
"9";"9";"0";"10";"63";"55063"
"6";"2";"4";"10";"63";"55064"
"5";"1";"4";"10";"63";"55066"
"4";"0";"4";"10";"63";"55067"
"4";"1";"3";"10";"63";"55069"
"1";"1";"0";"10";"63";"55070"
"2";"2";"0";"10";"63";"55073"
"1";"1";"0";"10";"63";"55075"
"54";"32";"22";"10";"63";"55076"
"2";"1";"1";"10";"63";"55077"
"1";"1";"0";"10";"63";"55078"
"17";"2";"15";"10";"63";"55079"
"1";"0";"1";"10";"63";"55080"
"2";"0";"2";"10";"63";"55081"
"140";"110";"30";"10";"63";"55082"
"5";"1";"4";"10";"63";"55083"
"5";"5";"0";"10";"63";"55085"
"3";"0";"3";"10";"63";"55086"
"9";"2";"7";"10";"63";"55090"
"3";"0";"3";"10";"63";"55093"
"5";"2";"3";"10";"63";"55095"
"26";"4";"22";"10";"63";"55098"
"5";"1";"4";"10";"63";"55099"
"3";"1";"2";"10";"63";"55102"
"826";"678";"148";"10";"63";"55106"
"4";"0";"4";"10";"63";"55107"
"4";"2";"2";"10";"63";"55108"
"24";"13";"11";"10";"63";"55111"
"206";"164";"42";"10";"63";"55114"
"13";"2";"11";"10";"63";"55115"
"2";"0";"2";"10";"63";"55117"
"1";"1";"0";"10";"63";"55118"
"17";"2";"15";"10";"63";"55119"
"2";"0";"2";"10";"63";"55120"
"1";"1";"0";"10";"63";"55121"
"4";"1";"3";"10";"63";"55124"
"6";"1";"5";"10";"63";"55125"
"1";"0";"1";"10";"63";"55126"
"1";"0";"1";"10";"63";"55130"
"2";"2";"0";"10";"63";"55132"
"5";"1";"4";"10";"63";"55139"
"7";"6";"1";"10";"63";"55143"
"1";"1";"0";"10";"63";"55144"
"2";"2";"0";"10";"63";"55145"
"10";"1";"9";"10";"63";"55146"
"6";"3";"3";"10";"63";"55153"
"27";"20";"7";"10";"63";"55154"
"1";"1";"0";"10";"63";"55160"
"3";"0";"3";"10";"63";"55161"
"4";"0";"4";"10";"63";"55162"
"4";"0";"4";"10";"63";"55163"
"14";"4";"10";"10";"63";"55166"
"3";"0";"3";"10";"63";"55170"
"6";"3";"3";"10";"63";"55171"
"1";"1";"0";"10";"63";"55172"
"11";"4";"7";"10";"63";"55174"
"14";"11";"3";"10";"63";"55176"
"7";"1";"6";"10";"63";"55178"
"3";"3";"0";"10";"63";"55180"
"9";"4";"5";"10";"63";"55183"
"2";"0";"2";"10";"63";"55184"
"4";"2";"2";"10";"63";"55185"
"1";"0";"1";"10";"63";"55197"
"2";"1";"1";"10";"63";"55198"
"1";"0";"1";"10";"63";"55199"
"12";"9";"3";"10";"63";"55206"
"4";"1";"3";"10";"63";"55210"
"19";"2";"17";"10";"63";"55212"
"2";"0";"2";"10";"63";"55215"
"2";"0";"2";"10";"63";"55216"
"4";"0";"4";"10";"63";"55218"
"131";"104";"27";"10";"63";"55220"
"2";"1";"1";"10";"63";"55221"
"2";"0";"2";"10";"63";"55222"
"4";"0";"4";"10";"63";"55223"
"4";"2";"2";"10";"63";"55224"
"37";"6";"31";"10";"63";"55225"
"1";"1";"0";"10";"63";"55227"
"2";"0";"2";"10";"63";"55230"
"2";"0";"2";"10";"63";"55231"
"4";"1";"3";"10";"63";"55233"
"4";"0";"4";"10";"63";"55234"
"1";"1";"0";"10";"63";"55236"
"2";"1";"1";"10";"63";"55237"
"36";"16";"20";"10";"63";"55238"
"6";"1";"5";"10";"63";"55242"
"1";"1";"0";"10";"63";"55244"
"1";"1";"0";"10";"63";"55246"
"17";"5";"12";"10";"63";"55247"
"1";"1";"0";"10";"63";"55249"
"1";"0";"1";"10";"63";"55252"
"15";"10";"5";"10";"63";"55254"
"1";"0";"1";"10";"63";"55255"
"8";"2";"6";"10";"63";"55257"
"55";"30";"25";"10";"63";"55258"
"4";"1";"3";"10";"63";"55260"
"17";"14";"3";"10";"63";"55261"
"2";"0";"2";"10";"63";"55264"
"2";"1";"1";"10";"63";"55266"
"3";"1";"2";"10";"63";"55268"
"2";"0";"2";"10";"63";"55271"
"2";"0";"2";"10";"63";"55272"
"3";"1";"2";"10";"63";"55274"
"2";"0";"2";"10";"63";"55277"
"1";"0";"1";"10";"63";"55278"
"1";"0";"1";"10";"63";"55279"
"12";"0";"12";"10";"63";"55280"
"20";"15";"5";"10";"63";"55282"
"22";"5";"17";"10";"63";"55285"
"1";"0";"1";"10";"63";"55288"
"5";"1";"4";"10";"63";"55289"
"2";"2";"0";"10";"63";"55290"
"1";"1";"0";"10";"63";"55291"
"5";"1";"4";"10";"63";"55292"
"3";"3";"0";"10";"63";"55294"
"1";"1";"0";"10";"63";"55296"
"1";"1";"0";"10";"63";"55297"
"1";"0";"1";"10";"63";"55300"
"4";"2";"2";"10";"63";"55303"
"12";"2";"10";"10";"63";"55304"
"4";"2";"2";"10";"63";"55306"
"9";"2";"7";"10";"63";"55311"
"153";"70";"83";"10";"63";"55313"
"4";"1";"3";"10";"63";"55314"
"5";"0";"5";"10";"63";"55319"
"3";"0";"3";"10";"63";"55320"
"84";"29";"55";"10";"63";"55321"
"1";"0";"1";"10";"63";"55322"
"4";"1";"3";"10";"63";"55323"
"1";"0";"1";"10";"63";"55324"
"2";"0";"2";"10";"63";"55325"
"2";"0";"2";"10";"63";"55327"
"4";"0";"4";"10";"63";"55328"
"8";"3";"5";"10";"63";"55330"
"42";"6";"36";"10";"63";"55331"
"5";"1";"4";"10";"63";"55333"
"10";"1";"9";"10";"63";"55334"
"2";"0";"2";"10";"63";"55335"
"3";"1";"2";"10";"63";"55337"
"2";"0";"2";"10";"63";"55338"
"2";"1";"1";"10";"63";"55340"
"1";"0";"1";"10";"63";"55343"
"1";"0";"1";"10";"63";"55344"
"9";"2";"7";"10";"63";"55349"
"5";"0";"5";"10";"63";"55350"
"3";"1";"2";"10";"63";"55351"
"2";"0";"2";"10";"63";"55352"
"14";"1";"13";"10";"63";"55353"
"5";"1";"4";"10";"63";"55355"
"2";"0";"2";"10";"63";"55358"
"6";"2";"4";"10";"63";"55359"
"9";"5";"4";"10";"63";"55361"
"2";"0";"2";"10";"63";"55362"
"4";"1";"3";"10";"63";"55364"
"1";"0";"1";"10";"63";"55365"
"1";"1";"0";"10";"63";"55366"
"18";"8";"10";"10";"63";"55369"
"3";"1";"2";"10";"63";"55372"
"12";"3";"9";"10";"63";"55373"
"5";"0";"5";"10";"63";"55375"
"4";"1";"3";"10";"63";"55377"
"2";"0";"2";"10";"63";"55378"
"4";"2";"2";"10";"63";"55380"
"3";"1";"2";"10";"63";"55381"
"21";"4";"17";"10";"63";"55382"
"2";"0";"2";"10";"63";"55383"
"1";"1";"0";"10";"63";"55385"
"4";"2";"2";"10";"63";"55386"
"3";"0";"3";"10";"63";"55387"
"15";"3";"12";"10";"63";"55389"
"2";"0";"2";"10";"63";"55393"
"7";"1";"6";"10";"63";"55396"
"1";"0";"1";"10";"63";"55397"
"2";"0";"2";"10";"63";"55398"
"2";"0";"2";"10";"63";"55401"
"9";"1";"8";"10";"63";"55404"
"2";"0";"2";"10";"63";"55405"
"2";"0";"2";"10";"63";"55406"
"4";"1";"3";"10";"63";"55407"
"5";"2";"3";"10";"63";"55408"
"2";"1";"1";"10";"63";"55411"
"3";"0";"3";"10";"63";"55414"
"1";"1";"0";"10";"63";"55415"
"25";"19";"6";"10";"63";"55418"
"8";"2";"6";"10";"63";"55422"
"1";"0";"1";"10";"63";"55423"
"5";"0";"5";"10";"63";"55424"
"6";"1";"5";"10";"63";"55427"
"2";"2";"0";"10";"63";"55428"
"4";"1";"3";"10";"63";"55429"
"2";"1";"1";"10";"63";"55433"
"10";"3";"7";"10";"63";"55434"
"7";"6";"1";"10";"63";"55435"
"1";"1";"0";"10";"63";"55437"
"2";"0";"2";"10";"63";"55438"
"16";"6";"10";"10";"63";"55440"
"1";"1";"0";"10";"63";"55441"
"3";"1";"2";"10";"63";"55444"
"1";"0";"1";"10";"63";"55447"
"5";"0";"5";"10";"63";"55449"
"4";"1";"3";"10";"63";"55450"
"7";"2";"5";"10";"63";"55451"
"1";"0";"1";"10";"63";"55452"
"3";"1";"2";"10";"63";"55454"
"2";"0";"2";"10";"63";"55456"
"4";"1";"3";"10";"63";"55458"
"3";"0";"3";"10";"63";"55461"
"2";"2";"0";"10";"63";"55463"
"2";"2";"0";"10";"63";"55464"
"1";"1";"0";"10";"63";"55465"
"18";"5";"13";"10";"63";"55467"
"3";"1";"2";"10";"63";"55470"
"85";"32";"53";"10";"63";"55471"
"3";"0";"3";"10";"63";"55472"
"30";"5";"25";"10";"63";"55473"
"4";"0";"4";"10";"63";"55474"
"1";"0";"1";"10";"63";"55475"
"4";"0";"4";"10";"63";"55476"
"1";"0";"1";"10";"63";"55477"
"1";"1";"0";"10";"63";"55479"
"1";"0";"1";"10";"63";"55480"
"1";"0";"1";"10";"63";"55483"
"1";"1";"0";"10";"63";"55485"
"3";"0";"3";"10";"63";"55486"
"2";"1";"1";"10";"63";"55487"
"5";"0";"5";"10";"63";"55488"
"20";"3";"17";"10";"63";"55490"
"1";"1";"0";"10";"63";"55491"
"8";"2";"6";"10";"63";"55493"
"1";"1";"0";"10";"63";"55498"
"1";"1";"0";"10";"63";"55499"
"3";"3";"0";"10";"63";"55500"
"28";"25";"3";"10";"63";"55501"
"2";"1";"1";"10";"63";"55503"
"1";"0";"1";"10";"63";"55504"
"5";"1";"4";"10";"63";"55505"
"4";"0";"4";"10";"63";"55506"
"2";"0";"2";"10";"63";"55508"
"11";"1";"10";"10";"63";"55510"
"2";"1";"1";"10";"63";"55512"
"1";"0";"1";"10";"63";"55513"
"1";"1";"0";"10";"63";"55514"
"5";"3";"2";"10";"63";"55516"
"2";"0";"2";"10";"63";"55517"
"48";"13";"35";"10";"63";"55518"
"4";"2";"2";"10";"63";"55519"
"6";"1";"5";"10";"63";"55520"
"1";"1";"0";"10";"63";"55521"
"2";"0";"2";"10";"63";"55524"
"4";"2";"2";"10";"63";"55526"
"2";"0";"2";"10";"63";"55527"
"1";"0";"1";"10";"63";"55529"
"2";"1";"1";"10";"63";"55530"
"1";"1";"0";"10";"63";"55532"
"3";"1";"2";"10";"63";"55535"
"5";"2";"3";"10";"63";"55538"
"3";"0";"3";"10";"63";"55539"
"4";"0";"4";"10";"63";"55543"
"1";"1";"0";"10";"63";"55545"
"3";"3";"0";"10";"63";"55546"
"4";"0";"4";"10";"63";"55547"
"4";"1";"3";"10";"63";"55551"
"5";"1";"4";"10";"63";"55552"
"4";"0";"4";"10";"63";"55556"
"2";"0";"2";"10";"63";"55558"
"2";"0";"2";"10";"63";"55566"
"1";"1";"0";"10";"63";"55567"
"9";"3";"6";"10";"63";"55569"
"3";"1";"2";"10";"63";"55570"
"3";"1";"2";"10";"63";"55572"
"5";"1";"4";"10";"63";"55573"
"1";"0";"1";"10";"63";"55574"
"5";"3";"2";"10";"63";"55576"
"3";"1";"2";"10";"63";"55579"
"3";"0";"3";"10";"63";"55580"
"2";"0";"2";"10";"63";"55582"
"2";"2";"0";"10";"63";"55584"
"1";"1";"0";"10";"63";"55586"
"5";"1";"4";"10";"63";"55587"
"2";"0";"2";"10";"63";"55588"
"11";"2";"9";"10";"63";"55589"
"1";"0";"1";"10";"63";"55591"
"3";"1";"2";"10";"63";"55593"
"2";"0";"2";"10";"63";"55594"
"1";"0";"1";"10";"63";"55598"
"1";"0";"1";"10";"63";"55599"
"4";"1";"3";"10";"63";"55600"
"13";"3";"10";"10";"63";"55601"
"1";"1";"0";"10";"63";"55602"
"7";"1";"6";"10";"63";"55604"
"5";"1";"4";"10";"63";"55605"
"5";"0";"5";"10";"63";"55608"
"16";"3";"13";"10";"63";"55609"
"2";"0";"2";"10";"63";"55611"
"1";"0";"1";"10";"63";"55612"
"3";"1";"2";"10";"63";"55613"
"1";"0";"1";"10";"63";"55614"
"2";"0";"2";"10";"63";"55615"
"1";"0";"1";"10";"63";"55616"
"6";"2";"4";"10";"63";"55617"
"3";"0";"3";"10";"63";"55622"
"1";"0";"1";"10";"63";"55623"
"8";"1";"7";"10";"63";"55625"
"3";"1";"2";"10";"63";"55626"
"2";"1";"1";"10";"63";"55628"
"43";"11";"32";"10";"63";"55629"
"1";"0";"1";"10";"63";"55630"
"2";"0";"2";"10";"63";"55631"
"7";"2";"5";"10";"63";"55634"
"2";"0";"2";"10";"63";"55636"
"62";"13";"49";"10";"63";"55638"
"1";"1";"0";"10";"63";"55640"
"3";"0";"3";"10";"63";"55642"
"1";"1";"0";"10";"63";"55643"
"3";"1";"2";"10";"63";"55645"
"6";"2";"4";"10";"63";"55646"
"6";"1";"5";"10";"63";"55648"
"2";"0";"2";"10";"63";"55649"
"1";"0";"1";"10";"63";"55652"
"4";"1";"3";"10";"63";"55653"
"2";"0";"2";"10";"63";"55654"
"1";"0";"1";"10";"63";"55655"
"8";"0";"8";"10";"63";"55656"
"3";"1";"2";"10";"63";"55657"
"4";"2";"2";"10";"63";"55658"
"1";"0";"1";"10";"63";"55659"
"20";"5";"15";"10";"63";"55660"
"1";"0";"1";"10";"63";"55662"
"2";"0";"2";"10";"63";"55664"
"4";"0";"4";"10";"63";"55665"
"1";"0";"1";"10";"63";"55666"
"7";"1";"6";"10";"63";"55667"
"1";"0";"1";"10";"63";"55671"
"12";"1";"11";"10";"63";"55672"
"2";"0";"2";"10";"63";"55673"
"5";"1";"4";"10";"63";"55674"
"2";"0";"2";"10";"63";"55675"
"2";"1";"1";"10";"63";"55676"
"16";"11";"5";"10";"63";"55679"
"1";"1";"0";"10";"63";"55681"
"1";"0";"1";"10";"63";"55682"
"4";"1";"3";"10";"63";"55685"
"3";"0";"3";"10";"63";"55689"
"1";"1";"0";"10";"63";"55693"
"10";"4";"6";"10";"63";"55694"
"2";"0";"2";"10";"63";"55695"
"3";"1";"2";"10";"63";"55697"
"4";"1";"3";"10";"63";"55701"
"2";"0";"2";"10";"63";"55702"
"7";"1";"6";"10";"63";"55703"
"148";"61";"87";"10";"63";"55704"
"9";"3";"6";"10";"63";"55706"
"1";"1";"0";"10";"63";"55707"
"4";"1";"3";"10";"63";"55708"
"1";"0";"1";"10";"63";"55710"
"4";"0";"4";"10";"63";"55712"
"5";"2";"3";"10";"63";"55714"
"2";"0";"2";"10";"63";"55717"
"2";"0";"2";"10";"63";"55718"
"2";"1";"1";"10";"63";"55719"
"1";"1";"0";"10";"63";"55720"
"1";"1";"0";"10";"63";"55721"
"2";"1";"1";"10";"63";"55722"
"2";"1";"1";"10";"63";"55723"
"13";"11";"2";"10";"63";"55724"
"1";"0";"1";"10";"63";"55725"
"4";"0";"4";"10";"63";"55726"
"24";"16";"8";"10";"63";"55727"
"3";"0";"3";"10";"63";"55728"
"10";"1";"9";"10";"63";"55729"
"39";"3";"36";"10";"63";"55731"
"5";"1";"4";"10";"63";"55734"
"8";"2";"6";"10";"63";"55736"
"1";"1";"0";"10";"63";"55738"
"3";"0";"3";"10";"63";"55739"
"4";"1";"3";"10";"63";"55741"
"1";"1";"0";"10";"63";"55742"
"4";"1";"3";"10";"63";"55744"
"2";"0";"2";"10";"63";"55746"
"4";"1";"3";"10";"63";"55747"
"2";"1";"1";"10";"63";"55749"
"2";"0";"2";"10";"63";"55750"
"2";"0";"2";"10";"63";"55752"
"18";"3";"15";"10";"63";"55753"
"43";"8";"35";"10";"63";"55754"
"5";"0";"5";"10";"63";"55759"
"1";"0";"1";"10";"63";"55761"
"1";"0";"1";"10";"63";"55763"
"2";"1";"1";"10";"63";"55764"
"61";"35";"26";"10";"63";"55767"
"15";"4";"11";"10";"63";"55770"
"5";"1";"4";"10";"63";"55774"
"1";"0";"1";"10";"63";"55776"
"7";"2";"5";"10";"63";"55778"
"3";"1";"2";"10";"63";"55780"
"2";"1";"1";"10";"63";"55782"
"23";"3";"20";"10";"63";"55784"
"1";"0";"1";"10";"63";"55786"
"2";"0";"2";"10";"63";"55795"
"1";"0";"1";"10";"63";"55796"
"3";"1";"2";"10";"63";"55801"
"3";"0";"3";"10";"63";"55805"
"2";"0";"2";"10";"63";"55809"
"6";"1";"5";"10";"63";"55811"
"2";"0";"2";"10";"63";"55814"
"3";"1";"2";"10";"63";"55815"
"1";"0";"1";"10";"63";"55816"
"11";"3";"8";"10";"63";"55818"
"1";"0";"1";"10";"63";"55822"
"5";"2";"3";"10";"63";"55824"
"4";"3";"1";"10";"63";"55825"
"7";"1";"6";"10";"63";"55827"
"3";"3";"0";"10";"63";"55829"
"2";"1";"1";"10";"63";"55830"
"13";"10";"3";"10";"63";"55831"
"8";"2";"6";"10";"63";"55832"
"1";"0";"1";"10";"63";"55833"
"3";"1";"2";"10";"63";"55834"
"2";"0";"2";"10";"63";"55837"
"4";"1";"3";"10";"63";"55841"
"1";"0";"1";"10";"63";"55842"
"1";"1";"0";"10";"63";"55843"
"2";"1";"1";"10";"63";"55844"
"1";"1";"0";"10";"63";"55845"
"2";"0";"2";"10";"63";"55846"
"1365";"1341";"24";"10";"63";"55851"
"1";"1";"0";"10";"63";"55852"
"26";"15";"11";"10";"63";"55853"
"1";"0";"1";"10";"63";"55854"
"3";"0";"3";"10";"63";"55855"
"3";"1";"2";"10";"63";"55856"
"2";"1";"1";"10";"63";"55857"
"53";"13";"40";"10";"63";"55860"
"26";"10";"16";"10";"63";"55861"
"2";"0";"2";"10";"63";"55864"
"3";"0";"3";"10";"63";"55865"
"8";"6";"2";"10";"63";"55866"
"9";"3";"6";"10";"63";"55867"
"7";"3";"4";"10";"63";"55868"
"14";"2";"12";"10";"63";"55870"
"1";"0";"1";"10";"63";"55872"
"2";"0";"2";"10";"63";"55873"
"2";"0";"2";"10";"63";"55874"
"3";"0";"3";"10";"63";"55878"
"2";"1";"1";"10";"63";"55879"
"2";"1";"1";"10";"63";"55880"
"2";"1";"1";"10";"63";"55883"
"4";"1";"3";"10";"63";"55890"
"2";"2";"0";"10";"63";"55894"
"7";"3";"4";"10";"63";"55897"
"7";"0";"7";"10";"63";"55898"
"1";"1";"0";"10";"63";"55900"
"2";"1";"1";"10";"63";"55904"
"4";"1";"3";"10";"63";"55905"
"2";"0";"2";"10";"63";"55911"
"52";"46";"6";"10";"63";"55916"
"1";"1";"0";"10";"63";"55917"
"3";"0";"3";"10";"63";"55919"
"3";"0";"3";"10";"63";"55922"
"3";"0";"3";"10";"63";"55923"
"4";"1";"3";"10";"63";"55924"
"3";"1";"2";"10";"63";"55927"
"9";"5";"4";"10";"63";"55928"
"2";"1";"1";"10";"63";"55929"
"1";"1";"0";"10";"63";"55930"
"2";"0";"2";"10";"63";"55932"
"1";"0";"1";"10";"63";"55936"
"3";"0";"3";"10";"63";"55937"
"8";"1";"7";"10";"63";"55938"
"4";"4";"0";"10";"63";"55939"
"2";"0";"2";"10";"63";"55941"
"1";"0";"1";"10";"63";"55943"
"3";"2";"1";"10";"63";"55944"
"5";"1";"4";"10";"63";"55947"
"2";"1";"1";"10";"63";"55953"
"111";"26";"85";"10";"63";"55955"
"3";"0";"3";"10";"63";"55956"
"2";"0";"2";"10";"63";"55957"
"1";"0";"1";"10";"63";"55958"
"3";"1";"2";"10";"63";"55959"
"11";"1";"10";"10";"63";"55960"
"5";"2";"3";"10";"63";"55964"
"77";"55";"22";"10";"63";"55965"
"3";"0";"3";"10";"63";"55967"
"2";"1";"1";"10";"63";"55970"
"2";"1";"1";"10";"63";"55973"
"3";"3";"0";"10";"63";"55974"
"1";"1";"0";"10";"63";"55978"
"2";"1";"1";"10";"63";"55979"
"1";"1";"0";"10";"63";"55982"
"4";"1";"3";"10";"63";"55983"
"4";"0";"4";"10";"63";"55984"
"2";"0";"2";"10";"63";"55985"
"1";"1";"0";"10";"63";"55986"
"5";"2";"3";"10";"63";"55987"
"53";"19";"34";"10";"63";"55989"
"4";"1";"3";"10";"63";"55990"
"1";"1";"0";"10";"63";"55991"
"3";"1";"2";"10";"63";"55992"
"2";"1";"1";"10";"63";"55994"
"2";"0";"2";"10";"63";"55996"
"3";"0";"3";"10";"63";"55997"
"3";"1";"2";"10";"63";"55998"
"2";"1";"1";"10";"63";"56003"
"4";"2";"2";"10";"63";"56004"
"2";"1";"1";"10";"63";"56006"
"2";"2";"0";"10";"63";"56007"
"6";"2";"4";"10";"63";"56008"
"2";"0";"2";"10";"63";"56009"
"2";"0";"2";"10";"63";"56010"
"806";"715";"91";"10";"63";"56011"
"9";"1";"8";"10";"63";"56014"
"1";"0";"1";"10";"63";"56017"
"4";"1";"3";"10";"63";"56018"
"4";"2";"2";"10";"63";"56020"
"1";"1";"0";"10";"63";"56021"
"1";"0";"1";"10";"63";"56022"
"5";"0";"5";"10";"63";"56026"
"12";"3";"9";"10";"63";"56027"
"1";"1";"0";"10";"63";"56029"
"6";"0";"6";"10";"63";"56031"
"2";"0";"2";"10";"63";"56032"
"2";"0";"2";"10";"63";"56034"
"56";"7";"49";"10";"63";"56035"
"12";"2";"10";"10";"63";"56037"
"2";"0";"2";"10";"63";"56039"
"1";"0";"1";"10";"63";"56041"
"2";"0";"2";"10";"63";"56042"
"1";"0";"1";"10";"63";"56043"
"5";"2";"3";"10";"63";"56044"
"6";"1";"5";"10";"63";"56045"
"3";"1";"2";"10";"63";"56046"
"7";"1";"6";"10";"63";"56048"
"2";"1";"1";"10";"63";"56049"
"4";"2";"2";"10";"63";"56050"
"3";"1";"2";"10";"63";"56052"
"3";"0";"3";"10";"63";"56053"
"2";"2";"0";"10";"63";"56055"
"5";"1";"4";"10";"63";"56058"
"3";"0";"3";"10";"63";"56060"
"127";"81";"46";"10";"63";"56061"
"45";"4";"41";"10";"63";"56062"
"1";"1";"0";"10";"63";"56064"
"4";"1";"3";"10";"63";"56066"
"1";"1";"0";"10";"63";"56067"
"13";"4";"9";"10";"63";"56068"
"2";"1";"1";"10";"63";"56069"
"2";"0";"2";"10";"63";"56071"
"3";"1";"2";"10";"63";"56072"
"1";"1";"0";"10";"63";"56076"
"2";"0";"2";"10";"63";"56077"
"1";"1";"0";"10";"63";"56078"
"2";"1";"1";"10";"63";"56079"
"2";"0";"2";"10";"63";"56080"
"1";"0";"1";"10";"63";"56081"
"5";"1";"4";"10";"63";"56084"
"20";"3";"17";"10";"63";"56085"
"2";"1";"1";"10";"63";"56086"
"3";"0";"3";"10";"63";"56089"
"2";"0";"2";"10";"63";"56091"
"1";"0";"1";"10";"63";"56093"
"13";"11";"2";"10";"63";"56096"
"5";"1";"4";"10";"63";"56097"
"2";"0";"2";"10";"63";"56098"
"47";"35";"12";"10";"63";"56099"
"1";"1";"0";"10";"63";"56100"
"1";"0";"1";"10";"63";"56101"
"6";"2";"4";"10";"63";"56102"
"9";"0";"9";"10";"63";"56103"
"1";"0";"1";"10";"63";"56104"
"6";"6";"0";"10";"63";"56106"
"2";"0";"2";"10";"63";"56108"
"1";"1";"0";"10";"63";"56109"
"6";"1";"5";"10";"63";"56110"
"3";"0";"3";"10";"63";"56111"
"6";"2";"4";"10";"63";"56112"
"2";"1";"1";"10";"63";"56114"
"3";"0";"3";"10";"63";"56115"
"11";"3";"8";"10";"63";"56116"
"2";"2";"0";"10";"63";"56119"
"2";"0";"2";"10";"63";"56122"
"17";"4";"13";"10";"63";"56124"
"10";"6";"4";"10";"63";"56127"
"1";"1";"0";"10";"63";"56133"
"4";"1";"3";"10";"63";"56135"
"5";"3";"2";"10";"63";"56136"
"4";"1";"3";"10";"63";"56137"
"5";"3";"2";"10";"63";"56139"
"2";"0";"2";"10";"63";"56140"
"485";"381";"104";"10";"63";"56142"
"6";"1";"5";"10";"63";"56146"
"7";"2";"5";"10";"63";"56147"
"7";"6";"1";"10";"63";"56149"
"1";"0";"1";"10";"63";"56150"
"11";"1";"10";"10";"63";"56151"
"1";"1";"0";"10";"63";"56152"
"2";"2";"0";"10";"63";"56153"
"2";"0";"2";"10";"63";"56156"
"8";"2";"6";"10";"63";"56158"
"3";"0";"3";"10";"63";"56162"
"6";"2";"4";"10";"63";"56163"
"4";"2";"2";"10";"63";"56164"
"1";"1";"0";"10";"63";"56166"
"3";"0";"3";"10";"63";"56167"
"1";"0";"1";"10";"63";"56171"
"7";"1";"6";"10";"63";"56172"
"2";"1";"1";"10";"63";"56173"
"6";"1";"5";"10";"63";"56174"
"2";"1";"1";"10";"63";"56175"
"8";"1";"7";"10";"63";"56176"
"4";"2";"2";"10";"63";"56180"
"16";"2";"14";"10";"63";"56181"
"3";"1";"2";"10";"63";"56185"
"4";"0";"4";"10";"63";"56186"
"3";"1";"2";"10";"63";"56188"
"2";"0";"2";"10";"63";"56189"
"5";"1";"4";"10";"63";"56191"
"2";"0";"2";"10";"63";"56192"
"15";"2";"13";"10";"63";"56193"
"1";"0";"1";"10";"63";"56194"
"1";"0";"1";"10";"63";"56196"
"3";"1";"2";"10";"63";"56198"
"2";"1";"1";"10";"63";"56199"
"1";"0";"1";"10";"63";"56200"
"3";"3";"0";"10";"63";"56201"
"7";"2";"5";"10";"63";"56202"
"7";"3";"4";"10";"63";"56205"
"1";"0";"1";"10";"63";"56209"
"2";"0";"2";"10";"63";"56212"
"1";"1";"0";"10";"63";"56213"
"9";"1";"8";"10";"63";"56214"
"2";"2";"0";"10";"63";"56216"
"1";"0";"1";"10";"63";"56217"
"1";"1";"0";"10";"63";"56219"
"3";"0";"3";"10";"63";"56221"
"7";"2";"5";"10";"63";"56222"
"4";"1";"3";"10";"63";"56225"
"1";"1";"0";"10";"63";"56226"
"3";"0";"3";"10";"63";"56228"
"2";"1";"1";"10";"63";"56229"
"5";"1";"4";"10";"63";"56230"
"2";"0";"2";"10";"63";"56231"
"4";"1";"3";"10";"63";"56232"
"3";"0";"3";"10";"63";"56233"
"2";"1";"1";"10";"63";"56235"
"1";"0";"1";"10";"63";"56236"
"22";"5";"17";"10";"63";"56243"
"3";"1";"2";"10";"63";"56246"
"1";"0";"1";"10";"63";"56248"
"1";"1";"0";"10";"63";"56249"
"4";"1";"3";"10";"63";"56251"
"1";"1";"0";"10";"63";"56253"
"2";"1";"1";"10";"63";"56258"
"1";"0";"1";"10";"63";"56259"
"4";"0";"4";"10";"63";"56262"
"1";"1";"0";"10";"63";"56268"
"1";"0";"1";"10";"63";"56269"
"1";"0";"1";"10";"63";"56270"
"12";"2";"10";"10";"63";"56271"
"7";"5";"2";"10";"63";"56272"
"30";"6";"24";"10";"63";"56273"
"2";"1";"1";"10";"63";"56274"
"1";"0";"1";"10";"63";"56275"
"2";"1";"1";"10";"63";"56278"
"3";"0";"3";"10";"63";"56282"
"3";"0";"3";"10";"63";"56283"
"5";"1";"4";"10";"63";"56284"
"2";"0";"2";"10";"63";"56285"
"3";"3";"0";"10";"63";"56288"
"5";"0";"5";"10";"63";"56290"
"4";"0";"4";"10";"63";"56291"
"1";"1";"0";"10";"63";"56292"
"21";"2";"19";"10";"63";"56293"
"15";"11";"4";"10";"63";"56294"
"2";"1";"1";"10";"63";"56298"
"1";"0";"1";"10";"63";"56299"
"3";"0";"3";"10";"63";"56302"
"6";"1";"5";"10";"63";"56303"
"17";"9";"8";"10";"63";"56307"
"2";"0";"2";"10";"63";"56309"
"2";"1";"1";"10";"63";"56311"
"8";"2";"6";"10";"63";"56312"
"8";"1";"7";"10";"63";"56314"
"1";"0";"1";"10";"63";"56315"
"5";"2";"3";"10";"63";"56317"
"5";"1";"4";"10";"63";"56318"
"509";"398";"111";"10";"63";"56319"
"8";"2";"6";"10";"63";"56321"
"9";"2";"7";"10";"63";"56322"
"13";"4";"9";"10";"63";"56323"
"6";"2";"4";"10";"63";"56324"
"4";"1";"3";"10";"63";"56325"
"17";"4";"13";"10";"63";"56327"
"17";"14";"3";"10";"63";"56328"
"2";"1";"1";"10";"63";"56331"
"6";"2";"4";"10";"63";"56333"
"3";"1";"2";"10";"63";"56334"
"3";"0";"3";"10";"63";"56337"
"6";"1";"5";"10";"63";"56339"
"1";"0";"1";"10";"63";"56341"
"4";"1";"3";"10";"63";"56343"
"153";"115";"38";"10";"63";"56344"
"1";"0";"1";"10";"63";"56345"
"14";"2";"12";"10";"63";"56346"
"2";"0";"2";"10";"63";"56348"
"2";"1";"1";"10";"63";"56349"
"5";"2";"3";"10";"63";"56351"
"2";"0";"2";"10";"63";"56353"
"3";"0";"3";"10";"63";"56355"
"3";"1";"2";"10";"63";"56359"
"5";"1";"4";"10";"63";"56360"
"3";"1";"2";"10";"63";"56363"
"8";"2";"6";"10";"63";"56364"
"1";"1";"0";"10";"63";"56367"
"5";"3";"2";"10";"63";"56369"
"1";"0";"1";"10";"63";"56370"
"30";"16";"14";"10";"63";"56372"
"4";"1";"3";"10";"63";"56373"
"2";"1";"1";"10";"63";"56375"
"38";"24";"14";"10";"63";"56376"
"108";"67";"41";"10";"63";"56378"
"6";"2";"4";"10";"63";"56380"
"7";"2";"5";"10";"63";"56381"
"9";"3";"6";"10";"63";"56382"
"2";"1";"1";"10";"63";"56383"
"11";"3";"8";"10";"63";"56385"
"3";"2";"1";"10";"63";"56389"
"14";"2";"12";"10";"63";"56390"
"5";"1";"4";"10";"63";"56391"
"4";"0";"4";"10";"63";"56392"
"2";"0";"2";"10";"63";"56393"
"5";"2";"3";"10";"63";"56395"
"17";"13";"4";"10";"63";"56397"
"5";"5";"0";"10";"63";"56399"
"8";"0";"8";"10";"63";"56402"
"13";"2";"11";"10";"63";"56403"
"2";"2";"0";"10";"63";"56404"
"60";"6";"54";"10";"63";"56408"
"8";"2";"6";"10";"63";"56410"
"7";"1";"6";"10";"63";"56411"
"3";"3";"0";"10";"63";"56412"
"1";"1";"0";"10";"63";"56414"
"14";"4";"10";"10";"63";"56416"
"8";"2";"6";"10";"63";"56418"
"4";"0";"4";"10";"63";"56423"
"8";"1";"7";"10";"63";"56424"
"1";"1";"0";"10";"63";"56425"
"1";"1";"0";"10";"63";"56428"
"2";"0";"2";"10";"63";"56430"
"5";"1";"4";"10";"63";"56433"
"3";"0";"3";"10";"63";"56435"
"2";"1";"1";"10";"63";"56440"
"9";"1";"8";"10";"63";"56441"
"6";"3";"3";"10";"63";"56443"
"2";"0";"2";"10";"63";"56444"
"6";"1";"5";"10";"63";"56445"
"5";"1";"4";"10";"63";"56446"
"2";"0";"2";"10";"63";"56450"
"3";"1";"2";"10";"63";"56452"
"13";"5";"8";"10";"63";"56453"
"2";"0";"2";"10";"63";"56454"
"6";"4";"2";"10";"63";"56456"
"17";"2";"15";"10";"63";"56457"
"6";"1";"5";"10";"63";"56461"
"4";"2";"2";"10";"63";"56464"
"1";"0";"1";"10";"63";"56467"
"5";"1";"4";"10";"63";"56469"
"2";"0";"2";"10";"63";"56473"
"2";"1";"1";"10";"63";"56474"
"2";"1";"1";"10";"63";"56475"
"4";"1";"3";"10";"63";"56476"
"2";"0";"2";"10";"63";"56478"
"2";"0";"2";"10";"63";"56479"
"4";"1";"3";"10";"63";"56480"
"10";"0";"10";"10";"63";"56482"
"2";"0";"2";"10";"63";"56483"
"3";"0";"3";"10";"63";"56486"
"51";"18";"33";"10";"63";"56490"
"6";"1";"5";"10";"63";"56491"
"2";"0";"2";"10";"63";"56493"
"1";"0";"1";"10";"63";"56494"
"3";"0";"3";"10";"63";"56497"
"3";"0";"3";"10";"63";"56498"
"4";"2";"2";"10";"63";"56500"
"5";"1";"4";"10";"63";"56502"
"2";"0";"2";"10";"63";"56505"
"1";"0";"1";"10";"63";"56509"
"6";"1";"5";"10";"63";"56510"
"2";"2";"0";"10";"63";"56511"
"4";"3";"1";"10";"63";"56512"
"1";"1";"0";"10";"63";"56513"
"4";"1";"3";"10";"63";"56515"
"10";"1";"9";"10";"63";"56516"
"4";"1";"3";"10";"63";"56517"
"4";"3";"1";"10";"63";"56524"
"6";"1";"5";"10";"63";"56526"
"1";"1";"0";"10";"63";"56527"
"3";"3";"0";"10";"63";"56530"
"1";"1";"0";"10";"63";"56531"
"2";"1";"1";"10";"63";"56533"
"1";"0";"1";"10";"63";"56534"
"7";"1";"6";"10";"63";"56535"
"1";"0";"1";"10";"63";"56539"
"6";"2";"4";"10";"63";"56540"
"24";"9";"15";"10";"63";"56541"
"2";"1";"1";"10";"63";"56544"
"3";"0";"3";"10";"63";"56545"
"38";"11";"27";"10";"63";"56547"
"2";"1";"1";"10";"63";"56549"
"1";"1";"0";"10";"63";"56553"
"1";"1";"0";"10";"63";"56557"
"2";"0";"2";"10";"63";"56558"
"1";"0";"1";"10";"63";"56559"
"1";"0";"1";"10";"63";"56561"
"1";"0";"1";"10";"63";"56562"
"2";"0";"2";"10";"63";"56564"
"2";"0";"2";"10";"63";"56566"
"7";"1";"6";"10";"63";"56570"
"3";"0";"3";"10";"63";"56571"
"11";"1";"10";"10";"63";"56574"
"1";"0";"1";"10";"63";"56575"
"13";"6";"7";"10";"63";"56576"
"36";"15";"21";"10";"63";"56579"
"1";"1";"0";"10";"63";"56580"
"5";"1";"4";"10";"63";"56583"
"24";"7";"17";"10";"63";"56585"
"5";"0";"5";"10";"63";"56586"
"2";"1";"1";"10";"63";"56587"
"5";"1";"4";"10";"63";"56589"
"11";"2";"9";"10";"63";"56590"
"3";"1";"2";"10";"63";"56594"
"6";"4";"2";"10";"63";"56600"
"4";"0";"4";"10";"63";"56603"
"1";"0";"1";"10";"63";"56604"
"3";"1";"2";"10";"63";"56605"
"5";"1";"4";"10";"63";"56606"
"1";"1";"0";"10";"63";"56607"
"9";"2";"7";"10";"63";"56608"
"1";"1";"0";"10";"63";"56611"
"1";"1";"0";"10";"63";"56613"
"2";"1";"1";"10";"63";"56614"
"3";"1";"2";"10";"63";"56615"
"2";"1";"1";"10";"63";"56616"
"1";"0";"1";"10";"63";"56617"
"1";"0";"1";"10";"63";"56618"
"1";"0";"1";"10";"63";"56619"
"2";"0";"2";"10";"63";"56621"
"8";"2";"6";"10";"63";"56622"
"2";"1";"1";"10";"63";"56625"
"6";"1";"5";"10";"63";"56626"
"1";"0";"1";"10";"63";"56627"
"10";"3";"7";"10";"63";"56628"
"2";"0";"2";"10";"63";"56629"
"3";"0";"3";"10";"63";"56630"
"12";"4";"8";"10";"63";"56632"
"2";"0";"2";"10";"63";"56633"
"2";"2";"0";"10";"63";"56634"
"6";"1";"5";"10";"63";"56636"
"6";"1";"5";"10";"63";"56638"
"4";"1";"3";"10";"63";"56639"
"16";"1";"15";"10";"63";"56642"
"4";"0";"4";"10";"63";"56643"
"11";"4";"7";"10";"63";"56644"
"5";"2";"3";"10";"63";"56645"
"4";"1";"3";"10";"63";"56646"
"3";"2";"1";"10";"63";"56647"
"4";"2";"2";"10";"63";"56648"
"2";"0";"2";"10";"63";"56651"
"2";"0";"2";"10";"63";"56652"
"5";"0";"5";"10";"63";"56654"
"2";"0";"2";"10";"63";"56662"
"12";"1";"11";"10";"63";"56663"
"4";"2";"2";"10";"63";"56665"
"35";"19";"16";"10";"63";"56666"
"4";"0";"4";"10";"63";"56668"
"2";"0";"2";"10";"63";"56670"
"3";"1";"2";"10";"63";"56672"
"4";"1";"3";"10";"63";"56673"
"15";"3";"12";"10";"63";"56674"
"1";"1";"0";"10";"63";"56679"
"4";"2";"2";"10";"63";"56680"
"5";"1";"4";"10";"63";"56687"
"3";"1";"2";"10";"63";"56689"
"1";"0";"1";"10";"63";"56690"
"2";"0";"2";"10";"63";"56691"
"7";"2";"5";"10";"63";"56692"
"4";"0";"4";"10";"63";"56694"
"2";"1";"1";"10";"63";"56695"
"3";"3";"0";"10";"63";"56698"
"5";"2";"3";"10";"63";"56699"
"7";"0";"7";"10";"63";"56703"
"7";"1";"6";"10";"63";"56704"
"5";"0";"5";"10";"63";"56706"
"4";"1";"3";"10";"63";"56708"
"2";"1";"1";"10";"63";"56709"
"18";"13";"5";"10";"63";"56710"
"3";"1";"2";"10";"63";"56712"
"6";"2";"4";"10";"63";"56713"
"3";"0";"3";"10";"63";"56714"
"2";"1";"1";"10";"63";"56715"
"2";"0";"2";"10";"63";"56717"
"1";"1";"0";"10";"63";"56719"
"12";"5";"7";"10";"63";"56720"
"10";"7";"3";"10";"63";"56722"
"6";"1";"5";"10";"63";"56723"
"5";"2";"3";"10";"63";"56724"
"4";"1";"3";"10";"63";"56725"
"2";"2";"0";"10";"63";"56727"
"12";"4";"8";"10";"63";"56728"
"2";"0";"2";"10";"63";"56729"
"3";"0";"3";"10";"63";"56730"
"3";"0";"3";"10";"63";"56731"
"2";"1";"1";"10";"63";"56732"
"6";"0";"6";"10";"63";"56733"
"1";"0";"1";"10";"63";"56734"
"3";"2";"1";"10";"63";"56735"
"1";"0";"1";"10";"63";"56736"
"8";"0";"8";"10";"63";"56738"
"3";"3";"0";"10";"63";"56739"
"2";"1";"1";"10";"63";"56741"
"4";"1";"3";"10";"63";"56743"
"15";"8";"7";"10";"63";"56744"
"1";"0";"1";"10";"63";"56746"
"9";"0";"9";"10";"63";"56749"
"3";"0";"3";"10";"63";"56752"
"3";"2";"1";"10";"63";"56754"
"1";"1";"0";"10";"63";"56756"
"2";"0";"2";"10";"63";"56758"
"4";"1";"3";"10";"63";"56760"
"1";"1";"0";"10";"63";"56763"
"1";"0";"1";"10";"63";"56766"
"2";"0";"2";"10";"63";"56769"
"7";"2";"5";"10";"63";"56770"
"11";"3";"8";"10";"63";"56771"
"3";"1";"2";"10";"63";"56772"
"2";"0";"2";"10";"63";"56773"
"6";"4";"2";"10";"63";"56774"
"2";"0";"2";"10";"63";"56775"
"4";"0";"4";"10";"63";"56776"
"728";"559";"169";"10";"63";"56777"
"7";"3";"4";"10";"63";"56779"
"3";"1";"2";"10";"63";"56780"
"2";"2";"0";"10";"63";"56781"
"1";"1";"0";"10";"63";"56782"
"38";"5";"33";"10";"63";"56783"
"2";"0";"2";"10";"63";"56784"
"1";"0";"1";"10";"63";"56787"
"2";"1";"1";"10";"63";"56788"
"11";"4";"7";"10";"63";"56789"
"3";"3";"0";"10";"63";"56792"
"5";"1";"4";"10";"63";"56794"
"1";"0";"1";"10";"63";"56795"
"1";"0";"1";"10";"63";"56796"
"1";"0";"1";"10";"63";"56797"
"5";"0";"5";"10";"63";"56798"
"1";"0";"1";"10";"63";"56799"
"19";"4";"15";"10";"63";"56800"
"6";"1";"5";"10";"63";"56801"
"93";"58";"35";"10";"63";"56802"
"82";"68";"14";"10";"63";"56803"
"5";"2";"3";"10";"63";"56804"
"5";"2";"3";"10";"63";"56805"
"13";"9";"4";"10";"63";"56807"
"3";"1";"2";"10";"63";"56808"
"2";"0";"2";"10";"63";"56809"
"4";"0";"4";"10";"63";"56811"
"8";"0";"8";"10";"63";"56812"
"2";"1";"1";"10";"63";"56813"
"5";"2";"3";"10";"63";"56814"
"23";"14";"9";"10";"63";"56815"
"4";"1";"3";"10";"63";"56819"
"5";"1";"4";"10";"63";"56821"
"18";"3";"15";"10";"63";"56823"
"1";"1";"0";"10";"63";"56824"
"1";"1";"0";"10";"63";"56825"
"3";"0";"3";"10";"63";"56827"
"16";"3";"13";"10";"63";"56830"
"1";"1";"0";"10";"63";"56831"
"1";"1";"0";"10";"63";"56832"
"1";"1";"0";"10";"63";"56834"
"4";"0";"4";"10";"63";"56835"
"5";"2";"3";"10";"63";"56836"
"1";"1";"0";"10";"63";"56839"
"1";"1";"0";"10";"63";"56840"
"4";"4";"0";"10";"63";"56842"
"6";"4";"2";"10";"63";"56843"
"1";"1";"0";"10";"63";"56844"
"2";"1";"1";"10";"63";"56846"
"24";"12";"12";"10";"63";"56849"
"2";"0";"2";"10";"63";"56850"
"1";"1";"0";"10";"63";"56852"
"2";"2";"0";"10";"63";"56853"
"2";"0";"2";"10";"63";"56856"
"10";"5";"5";"10";"63";"56857"
"2";"1";"1";"10";"63";"56858"
"4";"0";"4";"10";"63";"56859"
"6";"2";"4";"10";"63";"56862"
"2";"0";"2";"10";"63";"56863"
"5";"0";"5";"10";"63";"56865"
"1";"0";"1";"10";"63";"56866"
"7";"3";"4";"10";"63";"56867"
"25";"15";"10";"10";"63";"56868"
"83";"23";"60";"10";"63";"56869"
"1";"1";"0";"10";"63";"56875"
"1";"1";"0";"10";"63";"56876"
"1";"0";"1";"10";"63";"56877"
"5";"1";"4";"10";"63";"56878"
"2";"1";"1";"10";"63";"56879"
"4";"1";"3";"10";"63";"56881"
"6";"0";"6";"10";"63";"56883"
"2";"1";"1";"10";"63";"56884"
"3";"0";"3";"10";"63";"56885"
"3";"1";"2";"10";"63";"56886"
"7";"1";"6";"10";"63";"56887"
"2";"1";"1";"10";"63";"56891"
"3";"0";"3";"10";"63";"56892"
"2";"0";"2";"10";"63";"56894"
"5";"2";"3";"10";"63";"56895"
"8";"2";"6";"10";"63";"56896"
"19";"11";"8";"10";"63";"56898"
"8";"2";"6";"10";"63";"56899"
"3";"2";"1";"10";"63";"56900"
"5";"0";"5";"10";"63";"56902"
"53";"41";"12";"10";"63";"56903"
"2";"0";"2";"10";"63";"56904"
"18";"4";"14";"10";"63";"56905"
"2";"0";"2";"10";"63";"56911"
"2";"0";"2";"10";"63";"56912"
"104";"80";"24";"10";"63";"56915"
"2";"0";"2";"10";"63";"56916"
"68";"48";"20";"10";"63";"56917"
"1";"0";"1";"10";"63";"56919"
"5";"0";"5";"10";"63";"56921"
"3";"1";"2";"10";"63";"56922"
"1";"0";"1";"10";"63";"56923"
"11";"6";"5";"10";"63";"56925"
"11";"1";"10";"10";"63";"56926"
"1";"0";"1";"10";"63";"56927"
"2";"0";"2";"10";"63";"56928"
"4";"0";"4";"10";"63";"56929"
"5";"2";"3";"10";"63";"56930"
"1";"0";"1";"10";"63";"56932"
"2";"0";"2";"10";"63";"56933"
"7";"2";"5";"10";"63";"56935"
"4";"1";"3";"10";"63";"56936"
"14";"1";"13";"10";"63";"56937"
"8";"3";"5";"10";"63";"56938"
"1";"0";"1";"10";"63";"56939"
"6";"1";"5";"10";"63";"56942"
"2";"0";"2";"10";"63";"56944"
"3";"0";"3";"10";"63";"56945"
"10";"3";"7";"10";"63";"56946"
"2";"0";"2";"10";"63";"56947"
"5";"3";"2";"10";"63";"56948"
"4";"0";"4";"10";"63";"56949"
"2";"1";"1";"10";"63";"56950"
"7";"1";"6";"10";"63";"56952"
"4";"1";"3";"10";"63";"56953"
"5";"1";"4";"10";"63";"56954"
"33";"16";"17";"10";"63";"56955"
"18";"2";"16";"10";"63";"56957"
"2";"1";"1";"10";"63";"56959"
"12";"2";"10";"10";"63";"56961"
"15";"3";"12";"10";"63";"56962"
"7";"2";"5";"10";"63";"56963"
"4";"0";"4";"10";"63";"56964"
"5";"1";"4";"10";"63";"56965"
"3";"2";"1";"10";"63";"56967"
"3";"1";"2";"10";"63";"56968"
"4";"1";"3";"10";"63";"56969"
"2";"1";"1";"10";"63";"56971"
"3";"0";"3";"10";"63";"56972"
"2";"1";"1";"10";"63";"56973"
"16";"10";"6";"10";"63";"56974"
"11";"6";"5";"10";"63";"56975"
"7";"2";"5";"10";"63";"56976"
"1";"1";"0";"10";"63";"56977"
"2";"0";"2";"10";"63";"56978"
"2";"0";"2";"10";"63";"56981"
"4";"1";"3";"10";"63";"56982"
"1";"1";"0";"10";"63";"56983"
"9";"3";"6";"10";"63";"56984"
"12";"1";"11";"10";"63";"56986"
"10";"2";"8";"10";"63";"56988"
"3";"0";"3";"10";"63";"56990"
"2";"0";"2";"10";"63";"56991"
"1";"1";"0";"10";"63";"56992"
"9";"1";"8";"10";"63";"56994"
"1";"0";"1";"10";"63";"56995"
"18";"10";"8";"10";"63";"56996"
"19";"3";"16";"10";"63";"56997"
"1";"0";"1";"10";"63";"56998"
"2";"0";"2";"10";"63";"56999"
"1";"1";"0";"10";"63";"57000"
"3";"1";"2";"10";"63";"57001"
"6";"1";"5";"10";"63";"57004"
"9";"3";"6";"10";"63";"57005"
"3";"0";"3";"10";"63";"57010"
"1";"0";"1";"10";"63";"57011"
"8";"8";"0";"10";"63";"57013"
"1";"1";"0";"10";"63";"57016"
"13";"1";"12";"10";"63";"57017"
"5";"2";"3";"10";"63";"57021"
"4";"0";"4";"10";"63";"57022"
"1";"0";"1";"10";"63";"57024"
"2";"0";"2";"10";"63";"57025"
"5";"1";"4";"10";"63";"57027"
"2";"1";"1";"10";"63";"57029"
"1";"1";"0";"10";"63";"57032"
"4";"1";"3";"10";"63";"57033"
"1";"1";"0";"10";"63";"57034"
"1";"0";"1";"10";"63";"57040"
"2";"1";"1";"10";"63";"57041"
"8";"3";"5";"10";"63";"57043"
"12";"3";"9";"10";"63";"57048"
"3";"1";"2";"10";"63";"57049"
"2";"2";"0";"10";"63";"57050"
"111";"91";"20";"10";"63";"57052"
"2";"0";"2";"10";"63";"57053"
"13";"4";"9";"10";"63";"57054"
"3";"1";"2";"10";"63";"57055"
"2";"0";"2";"10";"63";"57056"
"2";"0";"2";"10";"63";"57058"
"2";"1";"1";"10";"63";"57059"
"7";"1";"6";"10";"63";"57060"
"5";"1";"4";"10";"63";"57061"
"3";"0";"3";"10";"63";"57063"
"16";"4";"12";"10";"63";"57064"
"20";"6";"14";"10";"63";"57065"
"2";"0";"2";"10";"63";"57066"
"1";"0";"1";"10";"63";"57067"
"1";"0";"1";"10";"63";"57071"
"4";"0";"4";"10";"63";"57075"
"2";"0";"2";"10";"63";"57076"
"10";"3";"7";"10";"63";"57077"
"1";"0";"1";"10";"63";"57079"
"9";"2";"7";"10";"63";"57081"
"3";"0";"3";"10";"63";"57082"
"1";"0";"1";"10";"63";"57085"
"7";"1";"6";"10";"63";"57086"
"3";"1";"2";"10";"63";"57087"
"18";"5";"13";"10";"63";"57089"
"3";"0";"3";"10";"63";"57091"
"3";"1";"2";"10";"63";"57092"
"3";"1";"2";"10";"63";"57093"
"1";"0";"1";"10";"63";"57096"
"2";"1";"1";"10";"63";"57097"
"6";"5";"1";"10";"63";"57098"
"1";"1";"0";"10";"63";"57100"
"1";"1";"0";"10";"63";"57101"
"1";"0";"1";"10";"63";"57104"
"6";"2";"4";"10";"63";"57106"
"3";"1";"2";"10";"63";"57108"
"33";"8";"25";"10";"63";"57112"
"8";"2";"6";"10";"63";"57113"
"1";"1";"0";"10";"63";"57116"
"1";"0";"1";"10";"63";"57117"
"5";"1";"4";"10";"63";"57118"
"4";"1";"3";"10";"63";"57120"
"2";"0";"2";"10";"63";"57123"
"2";"0";"2";"10";"63";"57125"
"5";"0";"5";"10";"63";"57127"
"1";"0";"1";"10";"63";"57128"
"3";"1";"2";"10";"63";"57131"
"8";"1";"7";"10";"63";"57132"
"2";"0";"2";"10";"63";"57135"
"2";"1";"1";"10";"63";"57137"
"1";"1";"0";"10";"63";"57138"
"3";"2";"1";"10";"63";"57139"
"9";"3";"6";"10";"63";"57140"
"6";"2";"4";"10";"63";"57141"
"2";"1";"1";"10";"63";"57142"
"3";"1";"2";"10";"63";"57143"
"2";"1";"1";"10";"63";"57145"
"4";"0";"4";"10";"63";"57146"
"13";"4";"9";"10";"63";"57147"
"1";"0";"1";"10";"63";"57149"
"1";"0";"1";"10";"63";"57153"
"1";"0";"1";"10";"63";"57156"
"3";"1";"2";"10";"63";"57158"
"3";"0";"3";"10";"63";"57161"
"2";"0";"2";"10";"63";"57162"
"3";"1";"2";"10";"63";"57163"
"3";"0";"3";"10";"63";"57165"
"21";"12";"9";"10";"63";"57167"
"2";"0";"2";"10";"63";"57169"
"1";"1";"0";"10";"63";"57170"
"2";"1";"1";"10";"63";"57171"
"9";"3";"6";"10";"63";"57172"
"1";"1";"0";"10";"63";"57175"
"5";"1";"4";"10";"63";"57179"
"8";"3";"5";"10";"63";"57181"
"1";"1";"0";"10";"63";"57182"
"2";"1";"1";"10";"63";"57187"
"1";"0";"1";"10";"63";"57189"
"2";"1";"1";"10";"63";"57190"
"2";"0";"2";"10";"63";"57193"
"1";"0";"1";"10";"63";"57194"
"6";"2";"4";"10";"63";"57196"
"5";"1";"4";"10";"63";"57198"
"2";"1";"1";"10";"63";"57199"
"4";"1";"3";"10";"63";"57200"
"2";"0";"2";"10";"63";"57201"
"3";"0";"3";"10";"63";"57204"
"2";"0";"2";"10";"63";"57205"
"5";"2";"3";"10";"63";"57208"
"3";"0";"3";"10";"63";"57209"
"2";"0";"2";"10";"63";"57210"
"3";"0";"3";"10";"63";"57211"
"14";"8";"6";"10";"63";"57213"
"9";"5";"4";"10";"63";"57214"
"9";"2";"7";"10";"63";"57216"
"5";"2";"3";"10";"63";"57219"
"1";"1";"0";"10";"63";"57224"
"3";"0";"3";"10";"63";"57226"
"2";"0";"2";"10";"63";"57228"
"2";"1";"1";"10";"63";"57230"
"3";"0";"3";"10";"63";"57232"
"4";"1";"3";"10";"63";"57236"
"1";"0";"1";"10";"63";"57238"
"3";"1";"2";"10";"63";"57239"
"100";"34";"66";"10";"63";"57240"
"4";"2";"2";"10";"63";"57242"
"6";"1";"5";"10";"63";"57244"
"3";"0";"3";"10";"63";"57245"
"2";"0";"2";"10";"63";"57246"
"6";"3";"3";"10";"63";"57250"
"4";"0";"4";"10";"63";"57251"
"1";"1";"0";"10";"63";"57252"
"3";"1";"2";"10";"63";"57253"
"4";"2";"2";"10";"63";"57254"
"3";"0";"3";"10";"63";"57255"
"1";"0";"1";"10";"63";"57256"
"15";"1";"14";"10";"63";"57257"
"6";"2";"4";"10";"63";"57258"
"3";"1";"2";"10";"63";"57260"
"2";"0";"2";"10";"63";"57261"
"3";"2";"1";"10";"63";"57262"
"2";"1";"1";"10";"63";"57263"
"16";"3";"13";"10";"63";"57264"
"2";"0";"2";"10";"63";"57265"
"4";"1";"3";"10";"63";"57266"
"6";"1";"5";"10";"63";"57268"
"2";"0";"2";"10";"63";"57269"
"22";"7";"15";"10";"63";"57270"
"4";"0";"4";"10";"63";"57271"
"2";"1";"1";"10";"63";"57274"
"7";"1";"6";"10";"63";"57275"
"127";"44";"83";"10";"63";"57278"
"3";"0";"3";"10";"63";"57279"
"22";"4";"18";"10";"63";"57281"
"11";"4";"7";"10";"63";"57282"
"3";"0";"3";"10";"63";"57283"
"1";"0";"1";"10";"63";"57284"
"2";"0";"2";"10";"63";"57285"
"1";"0";"1";"10";"63";"57286"
"52";"13";"39";"10";"63";"57287"
"9";"1";"8";"10";"63";"57290"
"15";"6";"9";"10";"63";"57291"
"2";"0";"2";"10";"63";"57292"
"6";"1";"5";"10";"63";"57294"
"2";"1";"1";"10";"63";"57295"
"6";"2";"4";"10";"63";"57296"
"14";"4";"10";"10";"63";"57297"
"6";"2";"4";"10";"63";"57298"
"22";"9";"13";"10";"63";"57299"
"4";"0";"4";"10";"63";"57300"
"2";"0";"2";"10";"63";"57302"
"4";"2";"2";"10";"63";"57307"
"1";"1";"0";"10";"63";"57308"
"8";"2";"6";"10";"63";"57309"
"3";"1";"2";"10";"63";"57313"
"1";"0";"1";"10";"63";"57314"
"23";"9";"14";"10";"63";"57315"
"7";"1";"6";"10";"63";"57318"
"4";"2";"2";"10";"63";"57320"
"9";"6";"3";"10";"63";"57321"
"8";"1";"7";"10";"63";"57324"
"9";"1";"8";"10";"63";"57327"
"1";"0";"1";"10";"63";"57329"
"10";"2";"8";"10";"63";"57330"
"1";"0";"1";"10";"63";"57331"
"5";"1";"4";"10";"63";"57333"
"2";"0";"2";"10";"63";"57341"
"27";"13";"14";"10";"63";"57344"
"2";"0";"2";"10";"63";"57346"
"1";"1";"0";"10";"63";"57347"
"1";"0";"1";"10";"63";"57350"
"14";"10";"4";"10";"63";"57356"
"36";"16";"20";"10";"63";"57357"
"4";"1";"3";"10";"63";"57359"
"2";"0";"2";"10";"63";"57360"
"4";"0";"4";"10";"63";"57361"
"77";"29";"48";"10";"63";"57362"
"10";"2";"8";"10";"63";"57363"
"2";"1";"1";"10";"63";"57364"
"1";"0";"1";"10";"63";"57366"
"57";"33";"24";"10";"63";"57367"
"6";"2";"4";"10";"63";"57368"
"11";"2";"9";"10";"63";"57370"
"28";"19";"9";"10";"63";"57371"
"1";"0";"1";"10";"63";"57372"
"1";"0";"1";"10";"63";"57376"
"18";"3";"15";"10";"63";"57378"
"1";"1";"0";"10";"63";"57380"
"17";"7";"10";"10";"63";"57384"
"3";"0";"3";"10";"63";"57385"
"1";"0";"1";"10";"63";"57392"
"6";"1";"5";"10";"63";"57393"
"7";"1";"6";"10";"63";"57394"
"3";"0";"3";"10";"63";"57396"
"3";"0";"3";"10";"63";"57399"
"1";"0";"1";"10";"63";"57401"
"3";"1";"2";"10";"63";"57402"
"53";"15";"38";"10";"63";"57404"
"18";"4";"14";"10";"63";"57405"
"5";"0";"5";"10";"63";"57406"
"3";"0";"3";"10";"63";"57407"
"1";"1";"0";"10";"63";"57410"
"22";"4";"18";"10";"63";"57412"
"18";"2";"16";"10";"63";"57413"
"4";"1";"3";"10";"63";"57414"
"20";"5";"15";"10";"63";"57418"
"3";"0";"3";"10";"63";"57419"
"13";"4";"9";"10";"63";"57420"
"1";"0";"1";"10";"63";"57421"
"1";"0";"1";"10";"63";"57422"
"4";"0";"4";"10";"63";"57423"
"16";"16";"0";"10";"63";"57426"
"1";"1";"0";"10";"63";"57427"
"2";"1";"1";"10";"63";"57428"
"25";"8";"17";"10";"63";"57430"
"1";"1";"0";"10";"63";"57431"
"2";"0";"2";"10";"63";"57434"
"1";"0";"1";"10";"63";"57435"
"2";"0";"2";"10";"63";"57436"
"10";"3";"7";"10";"63";"57438"
"7";"1";"6";"10";"63";"57439"
"3";"0";"3";"10";"63";"57441"
"2";"0";"2";"10";"63";"57442"
"2";"0";"2";"10";"63";"57444"
"1";"0";"1";"10";"63";"57445"
"358";"282";"76";"10";"63";"57446"
"2";"0";"2";"10";"63";"57447"
"3";"1";"2";"10";"63";"57449"
"7";"1";"6";"10";"63";"57451"
"2";"0";"2";"10";"63";"57453"
"4";"0";"4";"10";"63";"57454"
"1";"0";"1";"10";"63";"57458"
"2";"0";"2";"10";"63";"57459"
"1";"0";"1";"10";"63";"57460"
"1";"1";"0";"10";"63";"57462"
"2";"0";"2";"10";"63";"57464"
"2";"1";"1";"10";"63";"57467"
"59";"16";"43";"10";"63";"57468"
"4";"0";"4";"10";"63";"57473"
"61";"50";"11";"10";"63";"57474"
"2";"0";"2";"10";"63";"57481"
"4";"0";"4";"10";"63";"57482"
"4";"1";"3";"10";"63";"57483"
"1";"1";"0";"10";"63";"57484"
"3";"1";"2";"10";"63";"57486"
"3";"0";"3";"10";"63";"57489"
"2";"1";"1";"10";"63";"57490"
"41";"12";"29";"10";"63";"57492"
"4";"0";"4";"10";"63";"57494"
"1";"1";"0";"10";"63";"57495"
"8";"2";"6";"10";"63";"57497"
"4";"1";"3";"10";"63";"57499"
"8";"2";"6";"10";"63";"57500"
"3";"1";"2";"10";"63";"57501"
"8";"2";"6";"10";"63";"57502"
"1";"1";"0";"10";"63";"57507"
"1";"0";"1";"10";"63";"57509"
"12";"6";"6";"10";"63";"57510"
"3";"1";"2";"10";"63";"57511"
"5";"1";"4";"10";"63";"57513"
"2";"0";"2";"10";"63";"57514"
"6";"1";"5";"10";"63";"57516"
"5";"1";"4";"10";"63";"57518"
"5";"2";"3";"10";"63";"57521"
"35";"22";"13";"10";"63";"57523"
"3";"0";"3";"10";"63";"57526"
"6";"0";"6";"10";"63";"57527"
"1";"0";"1";"10";"63";"57528"
"5";"2";"3";"10";"63";"57529"
"2";"0";"2";"10";"63";"57530"
"2";"1";"1";"10";"63";"57531"
"167";"125";"42";"10";"63";"57535"
"14";"8";"6";"10";"63";"57536"
"3";"1";"2";"10";"63";"57537"
"1";"0";"1";"10";"63";"57538"
"4";"1";"3";"10";"63";"57540"
"1";"0";"1";"10";"63";"57543"
"1";"1";"0";"10";"63";"57545"
"14";"1";"13";"10";"63";"57546"
"5";"2";"3";"10";"63";"57547"
"2";"2";"0";"10";"63";"57548"
"1";"1";"0";"10";"63";"57551"
"3";"1";"2";"10";"63";"57552"
"6";"1";"5";"10";"63";"57554"
"3";"0";"3";"10";"63";"57556"
"3";"1";"2";"10";"63";"57557"
"2";"0";"2";"10";"63";"57559"
"9";"3";"6";"10";"63";"57562"
"1";"0";"1";"10";"63";"57563"
"6";"2";"4";"10";"63";"57565"
"4";"2";"2";"10";"63";"57568"
"2";"1";"1";"10";"63";"57572"
"6";"1";"5";"10";"63";"57573"
"5";"1";"4";"10";"63";"57576"
"1";"0";"1";"10";"63";"57580"
"5";"3";"2";"10";"63";"57581"
"3";"1";"2";"10";"63";"57584"
"4";"0";"4";"10";"63";"57585"
"7";"1";"6";"10";"63";"57586"
"2";"1";"1";"10";"63";"57587"
"6";"1";"5";"10";"63";"57588"
"7";"1";"6";"10";"63";"57590"
"2";"0";"2";"10";"63";"57591"
"1";"1";"0";"10";"63";"57593"
"4";"0";"4";"10";"63";"57597"
"2";"1";"1";"10";"63";"57598"
"8";"1";"7";"10";"63";"57600"
"4";"0";"4";"10";"63";"57602"
"3";"1";"2";"10";"63";"57604"
"2";"1";"1";"10";"63";"57605"
"25";"12";"13";"10";"63";"57606"
"3";"0";"3";"10";"63";"57607"
"3";"1";"2";"10";"63";"57608"
"1";"1";"0";"10";"63";"57609"
"14";"2";"12";"10";"63";"57610"
"5";"0";"5";"10";"63";"57612"
"3";"1";"2";"10";"63";"57613"
"1";"0";"1";"10";"63";"57615"
"2";"0";"2";"10";"63";"57616"
"2";"0";"2";"10";"63";"57618"
"2";"0";"2";"10";"63";"57619"
"4";"1";"3";"10";"63";"57620"
"1";"0";"1";"10";"63";"57622"
"1";"0";"1";"10";"63";"57623"
"7";"0";"7";"10";"63";"57624"
"6";"2";"4";"10";"63";"57627"
"2";"0";"2";"10";"63";"57628"
"1";"0";"1";"10";"63";"57629"
"2";"1";"1";"10";"63";"57630"
"4";"1";"3";"10";"63";"57631"
"3";"0";"3";"10";"63";"57635"
"3";"0";"3";"10";"63";"57637"
"1";"0";"1";"10";"63";"57640"
"4";"3";"1";"10";"63";"57642"
"1";"0";"1";"10";"63";"57643"
"5";"0";"5";"10";"63";"57645"
"447";"309";"138";"10";"63";"57646"
"2";"0";"2";"10";"63";"57647"
"2";"1";"1";"10";"63";"57648"
"4";"1";"3";"10";"63";"57649"
"14";"6";"8";"10";"63";"57650"
"4";"1";"3";"10";"63";"57652"
"4";"1";"3";"10";"63";"57653"
"4";"1";"3";"10";"63";"57654"
"5";"1";"4";"10";"63";"57656"
"5";"2";"3";"10";"63";"57657"
"69";"34";"35";"10";"63";"57659"
"4";"0";"4";"10";"63";"57660"
"11";"7";"4";"10";"63";"57661"
"3";"0";"3";"10";"63";"57663"
"1";"0";"1";"10";"63";"57664"
"4";"2";"2";"10";"63";"57665"
"12";"1";"11";"10";"63";"57666"
"2";"0";"2";"10";"63";"57671"
"3";"1";"2";"10";"63";"57672"
"2";"0";"2";"10";"63";"57675"
"1";"1";"0";"10";"63";"57676"
"1";"0";"1";"10";"63";"57678"
"6";"2";"4";"10";"63";"57679"
"3";"1";"2";"10";"63";"57680"
"10";"2";"8";"10";"63";"57682"
"66";"13";"53";"10";"63";"57684"
"1";"1";"0";"10";"63";"57686"
"5";"1";"4";"10";"63";"57687"
"2";"0";"2";"10";"63";"57688"
"2";"0";"2";"10";"63";"57691"
"3";"2";"1";"10";"63";"57692"
"8";"1";"7";"10";"63";"57694"
"5";"1";"4";"10";"63";"57697"
"1";"0";"1";"10";"63";"57698"
"3";"1";"2";"10";"63";"57699"
"24";"4";"20";"10";"63";"57701"
"3";"0";"3";"10";"63";"57702"
"3";"0";"3";"10";"63";"57703"
"4";"4";"0";"10";"63";"57709"
"7";"2";"5";"10";"63";"57710"
"28";"3";"25";"10";"63";"57711"
"5";"2";"3";"10";"63";"57713"
"2";"1";"1";"10";"63";"57714"
"5";"1";"4";"10";"63";"57715"
"2";"0";"2";"10";"63";"57716"
"2";"0";"2";"10";"63";"57718"
"18";"2";"16";"10";"63";"57720"
"2";"0";"2";"10";"63";"57721"
"2";"1";"1";"10";"63";"57722"
"3";"0";"3";"10";"63";"57723"
"9";"2";"7";"10";"63";"57724"
"5";"0";"5";"10";"63";"57725"
"6";"2";"4";"10";"63";"57727"
"8";"4";"4";"10";"63";"57728"
"25";"9";"16";"10";"63";"57729"
"1";"1";"0";"10";"63";"57730"
"1";"0";"1";"10";"63";"57731"
"4";"1";"3";"10";"63";"57734"
"2";"0";"2";"10";"63";"57736"
"2";"0";"2";"10";"63";"57737"
"8";"5";"3";"10";"63";"57738"
"9";"2";"7";"10";"63";"57740"
"3";"1";"2";"10";"63";"57742"
"5";"2";"3";"10";"63";"57743"
"5";"1";"4";"10";"63";"57745"
"5";"2";"3";"10";"63";"57748"
"1";"0";"1";"10";"63";"57749"
"5";"1";"4";"10";"63";"57750"
"2";"0";"2";"10";"63";"57752"
"5";"3";"2";"10";"63";"57753"
"9";"2";"7";"10";"63";"57754"
"4";"1";"3";"10";"63";"57756"
"19";"7";"12";"10";"63";"57757"
"4";"0";"4";"10";"63";"57758"
"3";"1";"2";"10";"63";"57759"
"7";"2";"5";"10";"63";"57764"
"3";"1";"2";"10";"63";"57765"
"4";"0";"4";"10";"63";"57766"
"40";"5";"35";"10";"63";"57767"
"4";"0";"4";"10";"63";"57769"
"10";"3";"7";"10";"63";"57771"
"2";"0";"2";"10";"63";"57772"
"32";"25";"7";"10";"63";"57776"
"4";"1";"3";"10";"63";"57782"
"1";"0";"1";"10";"63";"57783"
"6";"1";"5";"10";"63";"57784"
"4";"1";"3";"10";"63";"57786"
"2";"0";"2";"10";"63";"57787"
"2";"2";"0";"10";"63";"57789"
"21";"1";"20";"10";"63";"57790"
"1";"0";"1";"10";"63";"57792"
"2";"0";"2";"10";"63";"57793"
"1";"1";"0";"10";"63";"57794"
"1";"0";"1";"10";"63";"57798"
"1";"0";"1";"10";"63";"57800"
"1";"1";"0";"10";"63";"57803"
"4";"2";"2";"10";"63";"57804"
"2";"0";"2";"10";"63";"57805"
"2";"1";"1";"10";"63";"57808"
"7";"0";"7";"10";"63";"57809"
"1";"1";"0";"10";"63";"57810"
"1";"1";"0";"10";"63";"57812"
"1";"0";"1";"10";"63";"57814"
"1";"1";"0";"10";"63";"57815"
"1";"1";"0";"10";"63";"57817"
"3";"0";"3";"10";"63";"57818"
"5";"2";"3";"10";"63";"57819"
"1";"0";"1";"10";"63";"57820"
"7";"1";"6";"10";"63";"57821"
"7";"3";"4";"10";"63";"57822"
"1";"0";"1";"10";"63";"57823"
"5";"1";"4";"10";"63";"57825"
"15";"1";"14";"10";"63";"57826"
"1";"0";"1";"10";"63";"57827"
"1";"0";"1";"10";"63";"57832"
"2";"0";"2";"10";"63";"57833"
"7";"2";"5";"10";"63";"57835"
"6";"2";"4";"10";"63";"57836"
"7";"1";"6";"10";"63";"57837"
"1";"0";"1";"10";"63";"57838"
"4";"2";"2";"10";"63";"57839"
"1";"0";"1";"10";"63";"57840"
"2";"0";"2";"10";"63";"57841"
"2";"0";"2";"10";"63";"57846"
"2";"0";"2";"10";"63";"57847"
"9";"3";"6";"10";"63";"57848"
"2";"0";"2";"10";"63";"57849"
"11";"1";"10";"10";"63";"57850"
"1";"1";"0";"10";"63";"57851"
"16";"3";"13";"10";"63";"57852"
"15";"10";"5";"10";"63";"57853"
"3";"0";"3";"10";"63";"57855"
"1";"1";"0";"10";"63";"57856"
"4";"1";"3";"10";"63";"57857"
"12";"10";"2";"10";"63";"57862"
"5";"2";"3";"10";"63";"57863"
"3";"2";"1";"10";"63";"57865"
"3";"0";"3";"10";"63";"57867"
"7";"2";"5";"10";"63";"57869"
"2";"1";"1";"10";"63";"57870"
"1";"1";"0";"10";"63";"57871"
"21";"5";"16";"10";"63";"57872"
"1";"1";"0";"10";"63";"57873"
"3";"0";"3";"10";"63";"57874"
"23";"12";"11";"10";"63";"57875"
"1";"0";"1";"10";"63";"57877"
"9";"0";"9";"10";"63";"57879"
"28";"9";"19";"10";"63";"57883"
"3";"1";"2";"10";"63";"57884"
"7";"2";"5";"10";"63";"57889"
"1";"1";"0";"10";"63";"57894"
"2";"1";"1";"10";"63";"57898"
"2";"1";"1";"10";"63";"57899"
"4";"1";"3";"10";"63";"57900"
"3";"2";"1";"10";"63";"57901"
"2";"0";"2";"10";"63";"57902"
"3";"0";"3";"10";"63";"57903"
"4";"2";"2";"10";"63";"57904"
"10";"5";"5";"10";"63";"57905"
"5";"1";"4";"10";"63";"57906"
"13";"4";"9";"10";"63";"57908"
"13";"6";"7";"10";"63";"57909"
"2";"0";"2";"10";"63";"57911"
"4";"1";"3";"10";"63";"57912"
"2";"1";"1";"10";"63";"57913"
"2";"1";"1";"10";"63";"57917"
"2";"0";"2";"10";"63";"57918"
"10";"2";"8";"10";"63";"57919"
"1";"0";"1";"10";"63";"57921"
"2";"0";"2";"10";"63";"57923"
"3";"0";"3";"10";"63";"57925"
"19";"9";"10";"10";"63";"57927"
"3";"1";"2";"10";"63";"57929"
"1";"0";"1";"10";"63";"57930"
"1";"0";"1";"10";"63";"57931"
"2";"0";"2";"10";"63";"57933"
"11";"5";"6";"10";"63";"57935"
"1";"0";"1";"10";"63";"57937"
"44";"16";"28";"10";"63";"57940"
"5";"1";"4";"10";"63";"57944"
"1";"0";"1";"10";"63";"57945"
"8";"2";"6";"10";"63";"57947"
"4";"0";"4";"10";"63";"57948"
"17";"6";"11";"10";"63";"57949"
"8";"1";"7";"10";"63";"57950"
"7";"1";"6";"10";"63";"57952"
"1";"0";"1";"10";"63";"57955"
"3";"1";"2";"10";"63";"57956"
"4";"0";"4";"10";"63";"57958"
"2";"0";"2";"10";"63";"57959"
"17";"6";"11";"10";"63";"57961"
"5";"0";"5";"10";"63";"57962"
"1";"1";"0";"10";"63";"57963"
"2";"0";"2";"10";"63";"57964"
"1";"0";"1";"10";"63";"57965"
"5";"1";"4";"10";"63";"57967"
"3";"0";"3";"10";"63";"57969"
"3";"1";"2";"10";"63";"57970"
"4";"0";"4";"10";"63";"57971"
"1";"1";"0";"10";"63";"57973"
"1";"0";"1";"10";"63";"57974"
"1";"0";"1";"10";"63";"57975"
"3";"1";"2";"10";"63";"57977"
"2";"0";"2";"10";"63";"57980"
"2";"0";"2";"10";"63";"57981"
"2";"1";"1";"10";"63";"57985"
"26";"16";"10";"10";"63";"57987"
"2";"0";"2";"10";"63";"57988"
"2";"0";"2";"10";"63";"57989"
"2";"0";"2";"10";"63";"57991"
"1";"0";"1";"10";"63";"57992"
"1";"0";"1";"10";"63";"57993"
"4";"1";"3";"10";"63";"57994"
"6";"1";"5";"10";"63";"57995"
"1";"0";"1";"10";"63";"57997"
"1";"1";"0";"10";"63";"57998"
"7";"3";"4";"10";"63";"57999"
"65";"7";"58";"10";"63";"58000"
"6";"1";"5";"10";"63";"58003"
"2";"1";"1";"10";"63";"58004"
"9";"3";"6";"10";"63";"58005"
"2";"0";"2";"10";"63";"58006"
"2";"1";"1";"10";"63";"58008"
"3";"0";"3";"10";"63";"58012"
"3";"0";"3";"10";"63";"58013"
"3";"1";"2";"10";"63";"58014"
"2";"1";"1";"10";"63";"58015"
"6";"0";"6";"10";"63";"58016"
"2";"2";"0";"10";"63";"58018"
"20";"5";"15";"10";"63";"58019"
"5";"1";"4";"10";"63";"58021"
"21";"12";"9";"10";"63";"58022"
"1";"0";"1";"10";"63";"58023"
"6";"1";"5";"10";"63";"58024"
"1";"1";"0";"10";"63";"58025"
"5";"2";"3";"10";"63";"58026"
"3";"2";"1";"10";"63";"58027"
"11";"2";"9";"10";"63";"58031"
"1";"1";"0";"10";"63";"58034"
"6";"1";"5";"10";"63";"58035"
"2";"1";"1";"10";"63";"58036"
"9";"2";"7";"10";"63";"58038"
"1";"1";"0";"10";"63";"58039"
"6";"2";"4";"10";"63";"58042"
"2";"0";"2";"10";"63";"58045"
"5";"2";"3";"10";"63";"58046"
"2";"0";"2";"10";"63";"58047"
"2";"0";"2";"10";"63";"58048"
"8";"1";"7";"10";"63";"58049"
"3";"0";"3";"10";"63";"58050"
"4";"1";"3";"10";"63";"58051"
"3";"1";"2";"10";"63";"58052"
"1";"1";"0";"10";"63";"58054"
"1";"0";"1";"10";"63";"58055"
"9";"2";"7";"10";"63";"58057"
"1";"1";"0";"10";"63";"58058"
"2";"2";"0";"10";"63";"58059"
"11";"3";"8";"10";"63";"58060"
"10";"3";"7";"10";"63";"58061"
"1";"0";"1";"10";"63";"58063"
"12";"3";"9";"10";"63";"58064"
"1";"0";"1";"10";"63";"58065"
"4";"1";"3";"10";"63";"58067"
"8";"2";"6";"10";"63";"58068"
"2";"0";"2";"10";"63";"58070"
"2";"0";"2";"10";"63";"58071"
"84";"41";"43";"10";"63";"58073"
"1";"1";"0";"10";"63";"58074"
"2";"2";"0";"10";"63";"58075"
"8";"3";"5";"10";"63";"58076"
"7";"2";"5";"10";"63";"58078"
"2";"1";"1";"10";"63";"58079"
"5";"1";"4";"10";"63";"58081"
"6";"1";"5";"10";"63";"58082"
"4";"1";"3";"10";"63";"58084"
"2";"1";"1";"10";"63";"58085"
"7";"2";"5";"10";"63";"58086"
"1";"0";"1";"10";"63";"58087"
"1";"1";"0";"10";"63";"58088"
"5";"1";"4";"10";"63";"58089"
"4";"1";"3";"10";"63";"58091"
"14";"3";"11";"10";"63";"58093"
"1";"0";"1";"10";"63";"58095"
"6";"1";"5";"10";"63";"58096"
"20";"8";"12";"10";"63";"58097"
"5";"2";"3";"10";"63";"58098"
"2";"1";"1";"10";"63";"58100"
"5";"2";"3";"10";"63";"58102"
"6";"1";"5";"10";"63";"58103"
"1";"0";"1";"10";"63";"58104"
"5";"2";"3";"10";"63";"58106"
"6";"1";"5";"10";"63";"58107"
"4";"0";"4";"10";"63";"58108"
"24";"5";"19";"10";"63";"58109"
"216";"157";"59";"10";"63";"58110"
"3";"0";"3";"10";"63";"58111"
"3";"1";"2";"10";"63";"58112"
"2";"0";"2";"10";"63";"58113"
"4";"1";"3";"10";"63";"58114"
"41";"13";"28";"10";"63";"58115"
"3";"1";"2";"10";"63";"58117"
"2";"0";"2";"10";"63";"58119"
"19";"7";"12";"10";"63";"58120"
"2";"1";"1";"10";"63";"58122"
"43";"14";"29";"10";"63";"58123"
"3";"1";"2";"10";"63";"58124"
"167";"131";"36";"10";"63";"58126"
"2";"0";"2";"10";"63";"58128"
"11";"3";"8";"10";"63";"58129"
"13";"4";"9";"10";"63";"58130"
"1";"1";"0";"10";"63";"58132"
"6";"1";"5";"10";"63";"58133"
"43";"7";"36";"10";"63";"58136"
"33";"13";"20";"10";"63";"58138"
"5";"1";"4";"10";"63";"58140"
"1";"0";"1";"10";"63";"58142"
"1";"1";"0";"10";"63";"58144"
"2";"1";"1";"10";"63";"58146"
"5";"1";"4";"10";"63";"58148"
"7";"2";"5";"10";"63";"58150"
"3";"1";"2";"10";"63";"58151"
"4";"2";"2";"10";"63";"58153"
"16";"7";"9";"10";"63";"58155"
"10";"1";"9";"10";"63";"58156"
"13";"1";"12";"10";"63";"58161"
"4";"2";"2";"10";"63";"58162"
"8";"3";"5";"10";"63";"58163"
"10";"3";"7";"10";"63";"58164"
"2";"2";"0";"10";"63";"58165"
"5";"2";"3";"10";"63";"58166"
"1";"1";"0";"10";"63";"58167"
"2";"0";"2";"10";"63";"58169"
"9";"0";"9";"10";"63";"58171"
"4";"2";"2";"10";"63";"58176"
"4";"0";"4";"10";"63";"58177"
"2";"1";"1";"10";"63";"58178"
"1";"0";"1";"10";"63";"58179"
"3";"0";"3";"10";"63";"58180"
"1";"0";"1";"10";"63";"58182"
"2";"0";"2";"10";"63";"58187"
"5";"1";"4";"10";"63";"58194"
"2";"0";"2";"10";"63";"58196"
"5";"5";"0";"10";"63";"58197"
"15";"7";"8";"10";"63";"58198"
"2";"1";"1";"10";"63";"58201"
"2";"2";"0";"10";"63";"58204"
"1";"1";"0";"10";"63";"58205"
"2";"0";"2";"10";"63";"58207"
"2";"1";"1";"10";"63";"58208"
"32";"7";"25";"10";"63";"58209"
"1";"0";"1";"10";"63";"58210"
"1";"0";"1";"10";"63";"58212"
"5";"2";"3";"10";"63";"58214"
"1";"1";"0";"10";"63";"58217"
"3";"0";"3";"10";"63";"58218"
"2";"1";"1";"10";"63";"58225"
"2";"0";"2";"10";"63";"58227"
"1";"0";"1";"10";"63";"58228"
"1";"1";"0";"10";"63";"58229"
"1";"1";"0";"10";"63";"58230"
"8";"4";"4";"10";"63";"58234"
"1";"0";"1";"10";"63";"58240"
"5";"0";"5";"10";"63";"58242"
"2";"1";"1";"10";"63";"58244"
"7";"6";"1";"10";"63";"58246"
"2";"0";"2";"10";"63";"58247"
"2";"1";"1";"10";"63";"58251"
"1";"1";"0";"10";"63";"58253"
"4";"1";"3";"10";"63";"58258"
"13";"9";"4";"10";"63";"58259"
"7";"3";"4";"10";"63";"58260"
"10";"5";"5";"10";"63";"58262"
"13";"2";"11";"10";"63";"58267"
"3";"0";"3";"10";"63";"58270"
"1";"0";"1";"10";"63";"58275"
"1";"0";"1";"10";"63";"58277"
"4";"1";"3";"10";"63";"58278"
"9";"7";"2";"10";"63";"58279"
"3";"0";"3";"10";"63";"58281"
"1";"0";"1";"10";"63";"58283"
"2";"0";"2";"10";"63";"58287"
"4";"0";"4";"10";"63";"58290"
"11";"3";"8";"10";"63";"58291"
"6";"1";"5";"10";"63";"58293"
"4";"2";"2";"10";"63";"58294"
"1";"0";"1";"10";"63";"58297"
"3";"1";"2";"10";"63";"58299"
"27";"5";"22";"10";"63";"58301"
"1";"0";"1";"10";"63";"58302"
"8";"2";"6";"10";"63";"58304"
"8";"4";"4";"10";"63";"58305"
"1";"1";"0";"10";"63";"58308"
"3";"1";"2";"10";"63";"58309"
"1";"0";"1";"10";"63";"58310"
"6";"2";"4";"10";"63";"58311"
"2";"1";"1";"10";"63";"58316"
"6";"2";"4";"10";"63";"58317"
"4";"2";"2";"10";"63";"58320"
"1";"0";"1";"10";"63";"58321"
"46";"32";"14";"10";"63";"58322"
"4";"2";"2";"10";"63";"58323"
"2";"2";"0";"10";"63";"58327"
"3";"0";"3";"10";"63";"58330"
"3";"1";"2";"10";"63";"58333"
"3";"0";"3";"10";"63";"58336"
"1";"0";"1";"10";"63";"58341"
"2";"0";"2";"10";"63";"58342"
"6";"2";"4";"10";"63";"58343"
"2";"1";"1";"10";"63";"58347"
"8";"3";"5";"10";"63";"58349"
"4";"0";"4";"10";"63";"58352"
"1";"0";"1";"10";"63";"58353"
"3";"1";"2";"10";"63";"58358"
"5";"1";"4";"10";"63";"58361"
"5";"2";"3";"10";"63";"58362"
"4";"0";"4";"10";"63";"58364"
"1";"1";"0";"10";"63";"58365"
"2";"0";"2";"10";"63";"58368"
"2";"0";"2";"10";"63";"58369"
"16";"5";"11";"10";"63";"58373"
"2";"2";"0";"10";"63";"58374"
"9";"3";"6";"10";"63";"58377"
"6";"4";"2";"10";"63";"58379"
"3";"2";"1";"10";"63";"58381"
"29";"5";"24";"10";"63";"58382"
"4";"1";"3";"10";"63";"58391"
"1";"0";"1";"10";"63";"58393"
"2";"0";"2";"10";"63";"58394"
"1";"0";"1";"10";"63";"58395"
"4";"1";"3";"10";"63";"58396"
"1";"1";"0";"10";"63";"58397"
"7";"2";"5";"10";"63";"58399"
"1";"0";"1";"10";"63";"58401"
"7";"0";"7";"10";"63";"58402"
"1";"1";"0";"10";"63";"58408"
"1";"1";"0";"10";"63";"58410"
"3";"1";"2";"10";"63";"58411"
"2";"1";"1";"10";"63";"58419"
"1";"0";"1";"10";"63";"58420"
"3";"0";"3";"10";"63";"58421"
"8";"4";"4";"10";"63";"58428"
"2";"0";"2";"10";"63";"58433"
"2";"0";"2";"10";"63";"58436"
"3";"1";"2";"10";"63";"58437"
"7";"1";"6";"10";"63";"58438"
"6";"1";"5";"10";"63";"58440"
"23";"8";"15";"10";"63";"58443"
"4";"1";"3";"10";"63";"58444"
"18";"5";"13";"10";"63";"58446"
"3";"1";"2";"10";"63";"58449"
"1";"0";"1";"10";"63";"58450"
"14";"2";"12";"10";"63";"58451"
"4";"1";"3";"10";"63";"58452"
"1";"1";"0";"10";"63";"58454"
"5";"1";"4";"10";"63";"58455"
"13";"5";"8";"10";"63";"58456"
"3";"0";"3";"10";"63";"58458"
"1";"1";"0";"10";"63";"58459"
"4";"0";"4";"10";"63";"58460"
"6";"1";"5";"10";"63";"58461"
"1";"1";"0";"10";"63";"58462"
"4";"1";"3";"10";"63";"58463"
"4";"1";"3";"10";"63";"58464"
"2";"0";"2";"10";"63";"58471"
"4";"1";"3";"10";"63";"58472"
"2";"0";"2";"10";"63";"58473"
"1";"0";"1";"10";"63";"58476"
"2";"0";"2";"10";"63";"58477"
"1";"1";"0";"10";"63";"58478"
"1";"0";"1";"10";"63";"58481"
"1";"1";"0";"10";"63";"58483"
"4";"1";"3";"10";"63";"58485"
"5";"2";"3";"10";"63";"58486"
"3";"1";"2";"10";"63";"58487"
"33";"7";"26";"10";"63";"58488"
"5";"0";"5";"10";"63";"58492"
"3";"0";"3";"10";"63";"58493"
"15";"3";"12";"10";"63";"58494"
"7";"1";"6";"10";"63";"58497"
"3";"0";"3";"10";"63";"58498"
"176";"117";"59";"10";"63";"58500"
"3";"0";"3";"10";"63";"58502"
"6";"2";"4";"10";"63";"58504"
"6";"2";"4";"10";"63";"58507"
"47";"9";"38";"10";"63";"58508"
"1";"0";"1";"10";"63";"58511"
"11";"3";"8";"10";"63";"58514"
"5";"2";"3";"10";"63";"58515"
"5";"1";"4";"10";"63";"58516"
"2";"0";"2";"10";"63";"58518"
"4";"2";"2";"10";"63";"58520"
"5";"1";"4";"10";"63";"58521"
"1";"1";"0";"10";"63";"58522"
"2";"0";"2";"10";"63";"58525"
"27";"20";"7";"10";"63";"58526"
"2";"0";"2";"10";"63";"58528"
"6";"0";"6";"10";"63";"58529"
"4";"1";"3";"10";"63";"58530"
"6";"2";"4";"10";"63";"58533"
"4";"0";"4";"10";"63";"58537"
"5";"1";"4";"10";"63";"58538"
"1";"1";"0";"10";"63";"58539"
"5";"2";"3";"10";"63";"58544"
"1";"0";"1";"10";"63";"58545"
"6";"3";"3";"10";"63";"58547"
"1347";"1193";"154";"10";"63";"58549"
"74";"36";"38";"10";"63";"58551"
"9";"2";"7";"10";"63";"58552"
"9";"3";"6";"10";"63";"58553"
"5";"2";"3";"10";"63";"58561"
"2";"1";"1";"10";"63";"58562"
"1";"0";"1";"10";"63";"58563"
"6";"2";"4";"10";"63";"58564"
"1";"0";"1";"10";"63";"58565"
"4";"1";"3";"10";"63";"58567"
"4";"1";"3";"10";"63";"58568"
"10";"4";"6";"10";"63";"58570"
"2";"0";"2";"10";"63";"58572"
"1";"0";"1";"10";"63";"58575"
"1";"0";"1";"10";"63";"58577"
"167";"145";"22";"10";"63";"58580"
"4";"1";"3";"10";"63";"58581"
"1";"0";"1";"10";"63";"58584"
"4";"1";"3";"10";"63";"58587"
"6";"1";"5";"10";"63";"58589"
"3";"0";"3";"10";"63";"58590"
"22";"17";"5";"10";"63";"58592"
"4";"1";"3";"10";"63";"58593"
"4";"0";"4";"10";"63";"58595"
"25";"17";"8";"10";"63";"58596"
"7";"2";"5";"10";"63";"58597"
"1";"0";"1";"10";"63";"58598"
"2";"0";"2";"10";"63";"58602"
"4";"1";"3";"10";"63";"58603"
"13";"2";"11";"10";"63";"58605"
"2";"1";"1";"10";"63";"58610"
"2";"0";"2";"10";"63";"58611"
"4";"1";"3";"10";"63";"58614"
"1";"1";"0";"10";"63";"58615"
"3";"0";"3";"10";"63";"58616"
"9";"2";"7";"10";"63";"58617"
"14";"6";"8";"10";"63";"58618"
"3";"1";"2";"10";"63";"58619"
"1";"0";"1";"10";"63";"58620"
"6";"1";"5";"10";"63";"58621"
"2";"1";"1";"10";"63";"58622"
"29";"12";"17";"10";"63";"58626"
"19";"7";"12";"10";"63";"58627"
"1";"0";"1";"10";"63";"58629"
"7";"2";"5";"10";"63";"58630"
"1";"0";"1";"10";"63";"58631"
"5";"0";"5";"10";"63";"58632"
"1";"0";"1";"10";"63";"58635"
"1";"0";"1";"10";"63";"58639"
"1";"1";"0";"10";"63";"58641"
"4";"1";"3";"10";"63";"58644"
"6";"4";"2";"10";"63";"58645"
"3";"1";"2";"10";"63";"58649"
"3";"0";"3";"10";"63";"58650"
"2";"0";"2";"10";"63";"58652"
"3";"3";"0";"10";"63";"58655"
"2";"1";"1";"10";"63";"58657"
"5";"2";"3";"10";"63";"58658"
"2";"0";"2";"10";"63";"58659"
"15";"10";"5";"10";"63";"58661"
"2";"2";"0";"10";"63";"58663"
"2";"0";"2";"10";"63";"58666"
"45";"19";"26";"10";"63";"58670"
"14";"1";"13";"10";"63";"58671"
"3";"1";"2";"10";"63";"58673"
"1";"1";"0";"10";"63";"58675"
"3";"0";"3";"10";"63";"58677"
"4";"0";"4";"10";"63";"58678"
"4";"0";"4";"10";"63";"58679"
"1";"0";"1";"10";"63";"58680"
"15";"6";"9";"10";"63";"58681"
"3";"0";"3";"10";"63";"58684"
"1";"1";"0";"10";"63";"58685"
"4";"1";"3";"10";"63";"58689"
"4";"1";"3";"10";"63";"58690"
"1";"1";"0";"10";"63";"58691"
"6";"1";"5";"10";"63";"58692"
"2";"0";"2";"10";"63";"58694"
"43";"35";"8";"10";"63";"58695"
"11";"4";"7";"10";"63";"58698"
"12";"1";"11";"10";"63";"58699"
"5";"1";"4";"10";"63";"58703"
"7";"3";"4";"10";"63";"58706"
"2";"0";"2";"10";"63";"58707"
"6";"2";"4";"10";"63";"58708"
"6";"1";"5";"10";"63";"58709"
"5";"1";"4";"10";"63";"58711"
"2";"2";"0";"10";"63";"58713"
"1";"0";"1";"10";"63";"58718"
"1";"1";"0";"10";"63";"58720"
"11";"1";"10";"10";"63";"58724"
"13";"3";"10";"10";"63";"58725"
"14";"2";"12";"10";"63";"58726"
"11";"1";"10";"10";"63";"58728"
"18";"11";"7";"10";"63";"58729"
"7";"2";"5";"10";"63";"58730"
"1";"1";"0";"10";"63";"58731"
"14";"3";"11";"10";"63";"58732"
"6";"0";"6";"10";"63";"58733"
"1";"1";"0";"10";"63";"58734"
"4";"0";"4";"10";"63";"58736"
"4";"0";"4";"10";"63";"58737"
"3";"1";"2";"10";"63";"58738"
"1";"1";"0";"10";"63";"58741"
"1";"0";"1";"10";"63";"58742"
"1";"0";"1";"10";"63";"58743"
"2";"0";"2";"10";"63";"58746"
"5";"2";"3";"10";"63";"58747"
"10";"3";"7";"10";"63";"58748"
"1";"0";"1";"10";"63";"58752"
"4";"1";"3";"10";"63";"58753"
"2";"1";"1";"10";"63";"58754"
"2";"0";"2";"10";"63";"58756"
"8";"2";"6";"10";"63";"58757"
"4";"0";"4";"10";"63";"58759"
"5";"2";"3";"10";"63";"58760"
"2";"0";"2";"10";"63";"58762"
"5";"2";"3";"10";"63";"58763"
"1";"0";"1";"10";"63";"58767"
"14";"11";"3";"10";"63";"58773"
"5";"2";"3";"10";"63";"58775"
"2";"1";"1";"10";"63";"58777"
"4";"1";"3";"10";"63";"58778"
"21";"6";"15";"10";"63";"58780"
"14";"5";"9";"10";"63";"58782"
"1";"0";"1";"10";"63";"58783"
"3";"0";"3";"10";"63";"58786"
"1";"0";"1";"10";"63";"58788"
"1";"1";"0";"10";"63";"58789"
"2";"0";"2";"10";"63";"58791"
"14";"7";"7";"10";"63";"58793"
"2";"1";"1";"10";"63";"58796"
"2";"1";"1";"10";"63";"58798"
"2";"0";"2";"10";"63";"58799"
"1";"0";"1";"10";"63";"58800"
"2";"0";"2";"10";"63";"58802"
"1";"0";"1";"10";"63";"58808"
"10";"5";"5";"10";"63";"58809"
"21";"4";"17";"10";"63";"58812"
"3";"0";"3";"10";"63";"58814"
"1";"0";"1";"10";"63";"58816"
"4";"2";"2";"10";"63";"58818"
"4";"0";"4";"10";"63";"58819"
"1";"0";"1";"10";"63";"58821"
"7";"2";"5";"10";"63";"58822"
"3";"1";"2";"10";"63";"58823"
"3";"1";"2";"10";"63";"58824"
"1";"1";"0";"10";"63";"58827"
"9";"2";"7";"10";"63";"58831"
"3";"0";"3";"10";"63";"58833"
"3";"1";"2";"10";"63";"58834"
"2";"2";"0";"10";"63";"58838"
"1";"1";"0";"10";"63";"58839"
"1";"0";"1";"10";"63";"58841"
"3";"1";"2";"10";"63";"58842"
"1";"0";"1";"10";"63";"58843"
"1";"1";"0";"10";"63";"58847"
"30";"10";"20";"10";"63";"58848"
"4";"2";"2";"10";"63";"58851"
"10";"7";"3";"10";"63";"58852"
"3";"0";"3";"10";"63";"58853"
"7";"1";"6";"10";"63";"58855"
"1";"0";"1";"10";"63";"58857"
"9";"0";"9";"10";"63";"58858"
"2";"1";"1";"10";"63";"58859"
"24";"10";"14";"10";"63";"58860"
"4";"1";"3";"10";"63";"58863"
"23";"17";"6";"10";"63";"58864"
"9";"1";"8";"10";"63";"58870"
"1";"0";"1";"10";"63";"58871"
"3";"0";"3";"10";"63";"58872"
"4";"0";"4";"10";"63";"58875"
"10";"3";"7";"10";"63";"58878"
"2";"1";"1";"10";"63";"58886"
"5";"0";"5";"10";"63";"58889"
"3";"1";"2";"10";"63";"58892"
"16";"4";"12";"10";"63";"58895"
"2";"1";"1";"10";"63";"58896"
"1";"1";"0";"10";"63";"58897"
"1";"0";"1";"10";"63";"58902"
"281";"232";"49";"10";"63";"58903"
"14";"4";"10";"10";"63";"58905"
"2";"0";"2";"10";"63";"58906"
"4";"1";"3";"10";"63";"58908"
"1";"0";"1";"10";"63";"58909"
"2";"1";"1";"10";"63";"58910"
"3";"0";"3";"10";"63";"58911"
"1";"0";"1";"10";"63";"58913"
"4";"2";"2";"10";"63";"58914"
"3";"0";"3";"10";"63";"58916"
"53";"9";"44";"10";"63";"58917"
"4";"1";"3";"10";"63";"58921"
"1";"1";"0";"10";"63";"58922"
"2";"0";"2";"10";"63";"58923"
"4";"1";"3";"10";"63";"58924"
"5";"5";"0";"10";"63";"58925"
"1";"0";"1";"10";"63";"58928"
"1";"0";"1";"10";"63";"58931"
"29";"8";"21";"10";"63";"58932"
"2";"0";"2";"10";"63";"58934"
"7";"3";"4";"10";"63";"58935"
"5";"1";"4";"10";"63";"58938"
"6";"1";"5";"10";"63";"58939"
"2";"0";"2";"10";"63";"58940"
"5";"1";"4";"10";"63";"58941"
"1";"0";"1";"10";"63";"58943"
"1";"0";"1";"10";"63";"58944"
"2";"0";"2";"10";"63";"58945"
"3";"1";"2";"10";"63";"58946"
"1";"1";"0";"10";"63";"58947"
"17";"5";"12";"10";"63";"58948"
"1";"0";"1";"10";"63";"58949"
"6";"1";"5";"10";"63";"58951"
"3";"1";"2";"10";"63";"58954"
"3";"0";"3";"10";"63";"58956"
"2";"1";"1";"10";"63";"58957"
"5";"1";"4";"10";"63";"58958"
"6";"1";"5";"10";"63";"58961"
"5";"1";"4";"10";"63";"58962"
"3";"1";"2";"10";"63";"58963"
"5";"1";"4";"10";"63";"58965"
"4";"0";"4";"10";"63";"58966"
"21";"3";"18";"10";"63";"58967"
"4";"2";"2";"10";"63";"58968"
"8";"3";"5";"10";"63";"58969"
"38";"30";"8";"10";"63";"58970"
"3";"1";"2";"10";"63";"58972"
"5";"1";"4";"10";"63";"58974"
"1";"1";"0";"10";"63";"58975"
"4";"0";"4";"10";"63";"58979"
"2";"1";"1";"10";"63";"58980"
"9";"6";"3";"10";"63";"58982"
"9";"1";"8";"10";"63";"58984"
"7";"2";"5";"10";"63";"58986"
"6";"2";"4";"10";"63";"58988"
"10";"2";"8";"10";"63";"58989"
"4";"0";"4";"10";"63";"58990"
"1";"0";"1";"10";"63";"58993"
"1";"0";"1";"10";"63";"58994"
"1";"1";"0";"10";"63";"58995"
"7";"2";"5";"10";"63";"58996"
"2";"0";"2";"10";"63";"58998"
"4";"2";"2";"10";"63";"58999"
"5";"1";"4";"10";"63";"59000"
"5";"1";"4";"10";"63";"59001"
"2";"0";"2";"10";"63";"59006"
"5";"2";"3";"10";"63";"59007"
"9";"0";"9";"10";"63";"59008"
"1";"1";"0";"10";"63";"59011"
"2";"0";"2";"10";"63";"59013"
"3";"0";"3";"10";"63";"59014"
"2";"1";"1";"10";"63";"59017"
"4";"1";"3";"10";"63";"59018"
"5";"2";"3";"10";"63";"59020"
"18";"13";"5";"10";"63";"59022"
"5";"2";"3";"10";"63";"59023"
"2";"0";"2";"10";"63";"59025"
"4";"2";"2";"10";"63";"59026"
"1";"0";"1";"10";"63";"59028"
"3";"0";"3";"10";"63";"59029"
"3";"1";"2";"10";"63";"59030"
"12";"2";"10";"10";"63";"59032"
"440";"328";"112";"10";"63";"59034"
"5";"2";"3";"10";"63";"59035"
"2";"1";"1";"10";"63";"59037"
"12";"5";"7";"10";"63";"59040"
"6";"0";"6";"10";"63";"59043"
"1";"0";"1";"10";"63";"59044"
"2";"1";"1";"10";"63";"59051"
"1";"1";"0";"10";"63";"59052"
"2";"0";"2";"10";"63";"59053"
"2";"0";"2";"10";"63";"59054"
"4";"1";"3";"10";"63";"59056"
"6";"1";"5";"10";"63";"59057"
"2";"1";"1";"10";"63";"59058"
"1";"1";"0";"10";"63";"59059"
"3";"3";"0";"10";"63";"59061"
"6";"0";"6";"10";"63";"59064"
"2";"0";"2";"10";"63";"59065"
"3";"0";"3";"10";"63";"59068"
"1";"0";"1";"10";"63";"59069"
"20";"9";"11";"10";"63";"59074"
"7";"2";"5";"10";"63";"59076"
"1";"0";"1";"10";"63";"59078"
"7";"4";"3";"10";"63";"59082"
"3";"1";"2";"10";"63";"59083"
"2";"0";"2";"10";"63";"59084"
"3";"0";"3";"10";"63";"59086"
"7";"0";"7";"10";"63";"59089"
"2";"0";"2";"10";"63";"59093"
"3";"0";"3";"10";"63";"59095"
"2";"1";"1";"10";"63";"59096"
"6";"3";"3";"10";"63";"59098"
"16";"7";"9";"10";"63";"59099"
"5";"0";"5";"10";"63";"59100"
"4";"2";"2";"10";"63";"59101"
"2";"1";"1";"10";"63";"59102"
"2";"0";"2";"10";"63";"59103"
"7";"1";"6";"10";"63";"59104"
"6";"2";"4";"10";"63";"59105"
"3";"0";"3";"10";"63";"59108"
"4";"1";"3";"10";"63";"59113"
"6";"0";"6";"10";"63";"59115"
"12";"7";"5";"10";"63";"59123"
"6";"4";"2";"10";"63";"59125"
"4";"2";"2";"10";"63";"59126"
"9";"1";"8";"10";"63";"59128"
"11";"6";"5";"10";"63";"59131"
"7";"1";"6";"10";"63";"59134"
"2";"2";"0";"10";"63";"59136"
"1";"0";"1";"10";"63";"59138"
"3";"1";"2";"10";"63";"59139"
"19";"6";"13";"10";"63";"59145"
"4";"0";"4";"10";"63";"59147"
"4";"1";"3";"10";"63";"59149"
"4";"0";"4";"10";"63";"59156"
"9";"0";"9";"10";"63";"59157"
"7";"1";"6";"10";"63";"59159"
"6";"3";"3";"10";"63";"59161"
"61";"16";"45";"10";"63";"59164"
"5";"2";"3";"10";"63";"59168"
"2";"0";"2";"10";"63";"59170"
"1";"1";"0";"10";"63";"59175"
"1";"0";"1";"10";"63";"59176"
"2";"0";"2";"10";"63";"59177"
"4";"0";"4";"10";"63";"59179"
"4";"1";"3";"10";"63";"59180"
"1";"1";"0";"10";"63";"59181"
"9";"0";"9";"10";"63";"59182"
"9";"2";"7";"10";"63";"59188"
"13";"3";"10";"10";"63";"59189"
"15";"1";"14";"10";"63";"59193"
"4";"2";"2";"10";"63";"59194"
"153";"85";"68";"10";"63";"59197"
"2";"0";"2";"10";"63";"59200"
"1";"1";"0";"10";"63";"59203"
"1";"0";"1";"10";"63";"59204"
"1";"1";"0";"10";"63";"59207"
"3";"0";"3";"10";"63";"59208"
"3";"0";"3";"10";"63";"59214"
"6";"2";"4";"10";"63";"59215"
"3";"0";"3";"10";"63";"59216"
"5";"1";"4";"10";"63";"59217"
"20";"11";"9";"10";"63";"59218"
"1";"1";"0";"10";"63";"59219"
"15";"5";"10";"10";"63";"59220"
"1";"0";"1";"10";"63";"59221"
"15";"5";"10";"10";"63";"59222"
"40";"31";"9";"10";"63";"59226"
"1";"1";"0";"10";"63";"59227"
"5";"1";"4";"10";"63";"59229"
"154";"74";"80";"10";"63";"59230"
"2";"2";"0";"10";"63";"59232"
"4";"1";"3";"10";"63";"59234"
"3";"0";"3";"10";"63";"59237"
"1";"1";"0";"10";"63";"59240"
"5";"0";"5";"10";"63";"59241"
"54";"35";"19";"10";"63";"59242"
"6";"3";"3";"10";"63";"59243"
"68";"23";"45";"10";"63";"59244"
"2";"0";"2";"10";"63";"59248"
"1";"0";"1";"10";"63";"59249"
"3";"1";"2";"10";"63";"59250"
"9";"0";"9";"10";"63";"59252"
"1";"0";"1";"10";"63";"59253"
"4";"1";"3";"10";"63";"59254"
"1";"1";"0";"10";"63";"59257"
"5";"2";"3";"10";"63";"59258"
"2";"0";"2";"10";"63";"59259"
"1";"0";"1";"10";"63";"59261"
"2";"1";"1";"10";"63";"59263"
"5";"0";"5";"10";"63";"59264"
"5";"1";"4";"10";"63";"59269"
"3";"1";"2";"10";"63";"59270"
"4";"4";"0";"10";"63";"59272"
"3";"0";"3";"10";"63";"59273"
"3";"0";"3";"10";"63";"59276"
"3";"0";"3";"10";"63";"59280"
"5";"1";"4";"10";"63";"59285"
"66";"9";"57";"10";"63";"59286"
"5";"1";"4";"10";"63";"59287"
"1";"0";"1";"10";"63";"59288"
"3";"1";"2";"10";"63";"59290"
"36";"17";"19";"10";"63";"59291"
"3";"1";"2";"10";"63";"59297"
"1";"0";"1";"10";"63";"59298"
"4";"0";"4";"10";"63";"59299"
"2";"1";"1";"10";"63";"59302"
"14";"7";"7";"10";"63";"59303"
"6";"1";"5";"10";"63";"59309"
"4";"0";"4";"10";"63";"59311"
"19";"2";"17";"10";"63";"59312"
"1";"1";"0";"10";"63";"59313"
"2";"0";"2";"10";"63";"59316"
"5";"0";"5";"10";"63";"59317"
"1";"0";"1";"10";"63";"59319"
"2";"0";"2";"10";"63";"59321"
"2";"0";"2";"10";"63";"59322"
"12";"3";"9";"10";"63";"59323"
"1";"1";"0";"10";"63";"59324"
"16";"10";"6";"10";"63";"59328"
"2";"2";"0";"10";"63";"59330"
"6";"2";"4";"10";"63";"59333"
"9";"4";"5";"10";"63";"59335"
"1";"0";"1";"10";"63";"59337"
"1";"1";"0";"10";"63";"59340"
"10";"6";"4";"10";"63";"59345"
"3";"0";"3";"10";"63";"59347"
"5";"3";"2";"10";"63";"59348"
"1";"1";"0";"10";"63";"59349"
"1";"1";"0";"10";"63";"59350"
"6";"0";"6";"10";"63";"59353"
"1";"0";"1";"10";"63";"59354"
"2";"1";"1";"10";"63";"59362"
"1";"1";"0";"10";"63";"59364"
"1";"1";"0";"10";"63";"59366"
"5";"2";"3";"10";"63";"59368"
"2";"2";"0";"10";"63";"59369"
"9";"2";"7";"10";"63";"59370"
"3";"1";"2";"10";"63";"59373"
"3";"0";"3";"10";"63";"59374"
"7";"2";"5";"10";"63";"59376"
"116";"83";"33";"10";"63";"59377"
"1";"1";"0";"10";"63";"59378"
"3";"0";"3";"10";"63";"59379"
"1";"0";"1";"10";"63";"59382"
"23";"17";"6";"10";"63";"59384"
"2";"1";"1";"10";"63";"59385"
"10";"3";"7";"10";"63";"59387"
"2";"0";"2";"10";"63";"59390"
"6";"1";"5";"10";"63";"59391"
"4";"1";"3";"10";"63";"59392"
"3";"1";"2";"10";"63";"59393"
"2";"0";"2";"10";"63";"59396"
"6";"2";"4";"10";"63";"59398"
"5";"2";"3";"10";"63";"59402"
"2";"0";"2";"10";"63";"59404"
"24";"22";"2";"10";"63";"59407"
"3";"0";"3";"10";"63";"59408"
"5";"1";"4";"10";"63";"59409"
"3";"1";"2";"10";"63";"59411"
"15";"3";"12";"10";"63";"59415"
"5";"0";"5";"10";"63";"59416"
"1";"0";"1";"10";"63";"59417"
"7";"1";"6";"10";"63";"59418"
"9";"1";"8";"10";"63";"59420"
"1";"0";"1";"10";"63";"59421"
"9";"2";"7";"10";"63";"59425"
"11";"1";"10";"10";"63";"59427"
"8";"2";"6";"10";"63";"59428"
"11";"2";"9";"10";"63";"59432"
"1";"0";"1";"10";"63";"59433"
"1";"0";"1";"10";"63";"59434"
"2";"1";"1";"10";"63";"59435"
"5";"1";"4";"10";"63";"59438"
"7";"2";"5";"10";"63";"59440"
"27";"4";"23";"10";"63";"59441"
"3";"2";"1";"10";"63";"59442"
"112";"74";"38";"10";"63";"59443"
"1";"0";"1";"10";"63";"59446"
"4";"1";"3";"10";"63";"59447"
"1";"0";"1";"10";"63";"59448"
"3";"0";"3";"10";"63";"59449"
"1";"0";"1";"10";"63";"59451"
"5";"0";"5";"10";"63";"59452"
"46";"23";"23";"10";"63";"59455"
"17";"3";"14";"10";"63";"59456"
"6";"4";"2";"10";"63";"59457"
"2";"2";"0";"10";"63";"59458"
"4";"1";"3";"10";"63";"59459"
"10";"3";"7";"10";"63";"59460"
"1";"1";"0";"10";"63";"59461"
"4";"0";"4";"10";"63";"59462"
"2";"1";"1";"10";"63";"59464"
"6";"1";"5";"10";"63";"59465"
"3";"3";"0";"10";"63";"59466"
"2";"0";"2";"10";"63";"59468"
"1";"0";"1";"10";"63";"59469"
"423";"376";"47";"10";"63";"59471"
"3";"3";"0";"10";"63";"59474"
"4";"0";"4";"10";"63";"59475"
"5";"3";"2";"10";"63";"59478"
"1";"0";"1";"10";"63";"59480"
"6";"1";"5";"10";"63";"59482"
"1";"0";"1";"10";"63";"59483"
"4";"0";"4";"10";"63";"59486"
"3";"0";"3";"10";"63";"59492"
"40";"8";"32";"10";"63";"59493"
"1";"0";"1";"10";"63";"59494"
"4";"0";"4";"10";"63";"59495"
"1";"0";"1";"10";"63";"59501"
"6";"0";"6";"10";"63";"59503"
"203";"112";"91";"10";"63";"59504"
"3";"0";"3";"10";"63";"59506"
"2";"0";"2";"10";"63";"59507"
"2";"0";"2";"10";"63";"59509"
"1";"1";"0";"10";"63";"59511"
"2";"0";"2";"10";"63";"59512"
"5";"1";"4";"10";"63";"59514"
"6";"3";"3";"10";"63";"59515"
"5";"1";"4";"10";"63";"59516"
"3";"0";"3";"10";"63";"59517"
"2";"0";"2";"10";"63";"59519"
"29";"15";"14";"10";"63";"59522"
"2";"1";"1";"10";"63";"59523"
"1";"1";"0";"10";"63";"59526"
"5";"1";"4";"10";"63";"59528"
"12";"2";"10";"10";"63";"59533"
"4";"4";"0";"10";"63";"59538"
"6";"2";"4";"10";"63";"59539"
"12";"4";"8";"10";"63";"59540"
"19";"6";"13";"10";"63";"59541"
"2";"0";"2";"10";"63";"59544"
"6";"1";"5";"10";"63";"59545"
"10";"4";"6";"10";"63";"59547"
"3";"0";"3";"10";"63";"59548"
"1";"1";"0";"10";"63";"59549"
"1";"1";"0";"10";"63";"59551"
"5";"1";"4";"10";"63";"59553"
"4";"0";"4";"10";"63";"59554"
"2";"0";"2";"10";"63";"59557"
"3";"1";"2";"10";"63";"59558"
"7";"1";"6";"10";"63";"59560"
"2";"0";"2";"10";"63";"59569"
"17";"8";"9";"10";"63";"59570"
"4";"1";"3";"10";"63";"59571"
"8";"2";"6";"10";"63";"59580"
"4";"1";"3";"10";"63";"59582"
"15";"4";"11";"10";"63";"59586"
"1";"1";"0";"10";"63";"59587"
"1";"1";"0";"10";"63";"59588"
"2";"0";"2";"10";"63";"59591"
"4";"1";"3";"10";"63";"59597"
"5";"1";"4";"10";"63";"59598"
"1";"1";"0";"10";"63";"59599"
"2";"1";"1";"10";"63";"59600"
"1";"1";"0";"10";"63";"59601"
"26";"19";"7";"10";"63";"59602"
"3";"1";"2";"10";"63";"59606"
"19";"4";"15";"10";"63";"59609"
"1";"1";"0";"10";"63";"59613"
"5";"1";"4";"10";"63";"59614"
"3";"2";"1";"10";"63";"59616"
"1";"0";"1";"10";"63";"59621"
"5";"0";"5";"10";"63";"59622"
"1";"0";"1";"10";"63";"59623"
"22";"3";"19";"10";"63";"59624"
"10";"8";"2";"10";"63";"59627"
"10";"2";"8";"10";"63";"59628"
"40";"26";"14";"10";"63";"59630"
"2";"1";"1";"10";"63";"59633"
"3";"0";"3";"10";"63";"59637"
"3";"0";"3";"10";"63";"59642"
"6";"3";"3";"10";"63";"59647"
"4";"2";"2";"10";"63";"59648"
"2";"1";"1";"10";"63";"59649"
"4";"0";"4";"10";"63";"59650"
"2";"0";"2";"10";"63";"59651"
"6";"2";"4";"10";"63";"59652"
"1";"0";"1";"10";"63";"59653"
"3";"1";"2";"10";"63";"59655"
"2";"1";"1";"10";"63";"59656"
"4";"3";"1";"10";"63";"59657"
"5";"2";"3";"10";"63";"59660"
"2";"0";"2";"10";"63";"59661"
"5";"1";"4";"10";"63";"59663"
"1";"0";"1";"10";"63";"59666"
"4";"2";"2";"10";"63";"59667"
"19";"7";"12";"10";"63";"59671"
"2";"1";"1";"10";"63";"59673"
"1";"1";"0";"10";"63";"59674"
"3";"1";"2";"10";"63";"59678"
"6";"1";"5";"10";"63";"59679"
"4";"0";"4";"10";"63";"59680"
"8";"3";"5";"10";"63";"59682"
"1";"0";"1";"10";"63";"59684"
"5";"1";"4";"10";"63";"59685"
"2";"0";"2";"10";"63";"59689"
"2";"1";"1";"10";"63";"59692"
"16";"4";"12";"10";"63";"59693"
"4";"1";"3";"10";"63";"59694"
"2";"0";"2";"10";"63";"59698"
"1";"1";"0";"10";"63";"59699"
"12";"4";"8";"10";"63";"59703"
"8";"2";"6";"10";"63";"59707"
"6";"2";"4";"10";"63";"59710"
"5";"1";"4";"10";"63";"59711"
"4";"1";"3";"10";"63";"59713"
"26";"9";"17";"10";"63";"59716"
"34";"6";"28";"10";"63";"59717"
"4";"1";"3";"10";"63";"59719"
"3";"1";"2";"10";"63";"59720"
"4";"0";"4";"10";"63";"59722"
"4";"1";"3";"10";"63";"59723"
"2";"0";"2";"10";"63";"59726"
"8";"3";"5";"10";"63";"59727"
"5";"0";"5";"10";"63";"59729"
"17";"2";"15";"10";"63";"59731"
"5";"1";"4";"10";"63";"59735"
"2";"1";"1";"10";"63";"59736"
"5";"2";"3";"10";"63";"59737"
"4";"1";"3";"10";"63";"59738"
"2";"1";"1";"10";"63";"59739"
"2";"1";"1";"10";"63";"59742"
"9";"1";"8";"10";"63";"59743"
"7";"1";"6";"10";"63";"59744"
"12";"2";"10";"10";"63";"59748"
"2";"0";"2";"10";"63";"59749"
"5";"1";"4";"10";"63";"59754"
"3";"1";"2";"10";"63";"59759"
"6";"1";"5";"10";"63";"59762"
"2";"0";"2";"10";"63";"59767"
"2";"1";"1";"10";"63";"59768"
"1";"0";"1";"10";"63";"59769"
"2";"2";"0";"10";"63";"59770"
"1";"1";"0";"10";"63";"59771"
"2";"0";"2";"10";"63";"59772"
"2";"1";"1";"10";"63";"59775"
"6";"0";"6";"10";"63";"59780"
"2";"0";"2";"10";"63";"59782"
"1394";"1277";"117";"10";"63";"59784"
"6";"2";"4";"10";"63";"59786"
"1";"0";"1";"10";"63";"59787"
"3";"0";"3";"10";"63";"59788"
"1";"0";"1";"10";"63";"59789"
"20";"4";"16";"10";"63";"59792"
"4";"1";"3";"10";"63";"59793"
"7";"1";"6";"10";"63";"59794"
"2";"0";"2";"10";"63";"59795"
"3";"0";"3";"10";"63";"59798"
"6";"1";"5";"10";"63";"59800"
"3";"1";"2";"10";"63";"59802"
"6";"1";"5";"10";"63";"59803"
"6";"2";"4";"10";"63";"59804"
"12";"3";"9";"10";"63";"59808"
"8";"2";"6";"10";"63";"59810"
"2";"1";"1";"10";"63";"59811"
"3";"0";"3";"10";"63";"59812"
"4";"0";"4";"10";"63";"59815"
"2";"0";"2";"10";"63";"59816"
"7";"1";"6";"10";"63";"59820"
"3";"0";"3";"10";"63";"59821"
"6";"2";"4";"10";"63";"59822"
"7";"2";"5";"10";"63";"59823"
"65";"22";"43";"10";"63";"59824"
"1";"0";"1";"10";"63";"59826"
"6";"0";"6";"10";"63";"59829"
"10";"3";"7";"10";"63";"59830"
"1";"0";"1";"10";"63";"59832"
"3";"0";"3";"10";"63";"59834"
"1";"0";"1";"10";"63";"59835"
"1";"1";"0";"10";"63";"59836"
"2";"0";"2";"10";"63";"59837"
"2";"0";"2";"10";"63";"59838"
"2";"0";"2";"10";"63";"59839"
"4";"0";"4";"10";"63";"59841"
"1";"1";"0";"10";"63";"59842"
"3";"0";"3";"10";"63";"59846"
"3";"3";"0";"10";"63";"59850"
"4";"1";"3";"10";"63";"59851"
"1";"0";"1";"10";"63";"59854"
"11";"7";"4";"10";"63";"59856"
"4";"0";"4";"10";"63";"59858"
"19";"3";"16";"10";"63";"59859"
"3";"0";"3";"10";"63";"59860"
"8";"4";"4";"10";"63";"59861"
"1";"0";"1";"10";"63";"59862"
"2";"0";"2";"10";"63";"59863"
"7";"1";"6";"10";"63";"59864"
"4";"1";"3";"10";"63";"59867"
"1";"0";"1";"10";"63";"59870"
"4";"2";"2";"10";"63";"59872"
"1";"0";"1";"10";"63";"59874"
"21";"9";"12";"10";"63";"59877"
"1";"0";"1";"10";"63";"59878"
"19";"3";"16";"10";"63";"59880"
"42";"25";"17";"10";"63";"59882"
"2";"1";"1";"10";"63";"59883"
"3";"0";"3";"10";"63";"59884"
"4";"1";"3";"10";"63";"59885"
"12";"10";"2";"10";"63";"59890"
"5";"3";"2";"10";"63";"59891"
"6";"1";"5";"10";"63";"59892"
"1";"0";"1";"10";"63";"59894"
"1";"0";"1";"10";"63";"59895"
"7";"1";"6";"10";"63";"59897"
"2";"0";"2";"10";"63";"59899"
"4";"0";"4";"10";"63";"59900"
"8";"2";"6";"10";"63";"59901"
"10";"4";"6";"10";"63";"59902"
"3";"1";"2";"10";"63";"59905"
"6";"0";"6";"10";"63";"59906"
"1";"0";"1";"10";"63";"59908"
"4";"1";"3";"10";"63";"59909"
"14";"4";"10";"10";"63";"59912"
"16";"4";"12";"10";"63";"59914"
"2";"1";"1";"10";"63";"59915"
"8";"4";"4";"10";"63";"59917"
"34";"9";"25";"10";"63";"59919"
"2";"0";"2";"10";"63";"59920"
"12";"1";"11";"10";"63";"59922"
"5";"1";"4";"10";"63";"59924"
"19";"2";"17";"10";"63";"59925"
"5";"1";"4";"10";"63";"59930"
"1";"0";"1";"10";"63";"59931"
"8";"1";"7";"10";"63";"59933"
"2";"1";"1";"10";"63";"59934"
"3";"1";"2";"10";"63";"59935"
"3";"1";"2";"10";"63";"59936"
"3";"1";"2";"10";"63";"59937"
"2";"1";"1";"10";"63";"59939"
"1";"0";"1";"10";"63";"59944"
"4";"1";"3";"10";"63";"59945"
"7";"0";"7";"10";"63";"59949"
"2";"0";"2";"10";"63";"59950"
"2";"1";"1";"10";"63";"59951"
"3";"0";"3";"10";"63";"59954"
"4";"2";"2";"10";"63";"59955"
"3";"1";"2";"10";"63";"59957"
"1";"1";"0";"10";"63";"59958"
"2";"0";"2";"10";"63";"59959"
"4";"1";"3";"10";"63";"59960"
"4";"2";"2";"10";"63";"59962"
"11";"1";"10";"10";"63";"59963"
"28";"17";"11";"10";"63";"59965"
"4";"0";"4";"10";"63";"59966"
"7";"0";"7";"10";"63";"59968"
"3";"0";"3";"10";"63";"59971"
"2";"0";"2";"10";"63";"59972"
"8";"2";"6";"10";"63";"59973"
"12";"3";"9";"10";"63";"59975"
"9";"2";"7";"10";"63";"59978"
"5";"1";"4";"10";"63";"59979"
"3";"0";"3";"10";"63";"59981"
"10";"2";"8";"10";"63";"59983"
"1";"1";"0";"10";"63";"59984"
"5";"1";"4";"10";"63";"59986"
"3";"0";"3";"10";"63";"59987"
"3";"1";"2";"10";"63";"59989"
"3";"1";"2";"10";"63";"59991"
"3";"0";"3";"10";"63";"59995"
"1";"0";"1";"10";"63";"59996"
"10";"8";"2";"10";"63";"59998"
"4";"1";"3";"10";"63";"59999"
"4";"0";"4";"10";"63";"60000"
"12";"1";"11";"10";"63";"60002"
"8";"1";"7";"10";"63";"60003"
"4";"1";"3";"10";"63";"60005"
"2";"0";"2";"10";"63";"60006"
"2";"0";"2";"10";"63";"60007"
"4";"2";"2";"10";"63";"60008"
"3";"0";"3";"10";"63";"60011"
"2";"1";"1";"10";"63";"60015"
"3";"1";"2";"10";"63";"60020"
"7";"2";"5";"10";"63";"60023"
"2";"1";"1";"10";"63";"60024"
"5";"2";"3";"10";"63";"60026"
"14";"3";"11";"10";"63";"60027"
"2";"1";"1";"10";"63";"60028"
"4";"0";"4";"10";"63";"60029"
"3";"0";"3";"10";"63";"60030"
"1";"0";"1";"10";"63";"60034"
"42";"37";"5";"10";"63";"60035"
"13";"4";"9";"10";"63";"60038"
"4";"1";"3";"10";"63";"60040"
"2";"0";"2";"10";"63";"60042"
"5";"2";"3";"10";"63";"60046"
"2";"1";"1";"10";"63";"60047"
"12";"3";"9";"10";"63";"60051"
"4";"1";"3";"10";"63";"60055"
"6";"2";"4";"10";"63";"60056"
"1";"0";"1";"10";"63";"60059"
"5";"0";"5";"10";"63";"60060"
"2";"0";"2";"10";"63";"60061"
"1";"0";"1";"10";"63";"60062"
"50";"13";"37";"10";"63";"60064"
"4";"1";"3";"10";"63";"60065"
"31";"20";"11";"10";"63";"60067"
"3";"1";"2";"10";"63";"60068"
"7";"2";"5";"10";"63";"60071"
"3";"2";"1";"10";"63";"60072"
"2";"0";"2";"10";"63";"60073"
"5";"1";"4";"10";"63";"60078"
"2";"0";"2";"10";"63";"60079"
"3";"1";"2";"10";"63";"60080"
"17";"8";"9";"10";"63";"60082"
"4";"0";"4";"10";"63";"60083"
"5";"0";"5";"10";"63";"60084"
"8";"2";"6";"10";"63";"60086"
"6";"1";"5";"10";"63";"60088"
"23";"20";"3";"10";"63";"60090"
"9";"1";"8";"10";"63";"60094"
"3";"0";"3";"10";"63";"60095"
"10";"8";"2";"10";"63";"60097"
"1";"0";"1";"10";"63";"60098"
"4";"1";"3";"10";"63";"60100"
"7";"4";"3";"10";"63";"60101"
"27";"19";"8";"10";"63";"60104"
"5";"1";"4";"10";"63";"60106"
"1";"0";"1";"10";"63";"60108"
"2";"0";"2";"10";"63";"60111"
"2";"0";"2";"10";"63";"60112"
"5";"1";"4";"10";"63";"60114"
"3";"1";"2";"10";"63";"60117"
"1";"1";"0";"10";"63";"60122"
"9";"3";"6";"10";"63";"60124"
"1";"1";"0";"10";"63";"60125"
"3";"1";"2";"10";"63";"60127"
"2";"0";"2";"10";"63";"60130"
"5";"2";"3";"10";"63";"60131"
"1";"0";"1";"10";"63";"60132"
"2";"0";"2";"10";"63";"60135"
"2";"0";"2";"10";"63";"60137"
"4";"0";"4";"10";"63";"60139"
"10";"1";"9";"10";"63";"60140"
"1";"1";"0";"10";"63";"60141"
"14";"10";"4";"10";"63";"60142"
"2";"0";"2";"10";"63";"60143"
"2";"0";"2";"10";"63";"60144"
"3";"0";"3";"10";"63";"60149"
"2";"2";"0";"10";"63";"60150"
"1";"1";"0";"10";"63";"60151"
"4";"1";"3";"10";"63";"60152"
"46";"18";"28";"10";"63";"60155"
"3";"1";"2";"10";"63";"60158"
"1";"1";"0";"10";"63";"60159"
"8";"3";"5";"10";"63";"60161"
"4";"1";"3";"10";"63";"60162"
"2";"0";"2";"10";"63";"60163"
"5";"1";"4";"10";"63";"60164"
"3";"1";"2";"10";"63";"60166"
"1";"0";"1";"10";"63";"60167"
"1";"1";"0";"10";"63";"60169"
"3";"0";"3";"10";"63";"60172"
"4";"0";"4";"10";"63";"60174"
"1";"1";"0";"10";"63";"60176"
"3";"0";"3";"10";"63";"60179"
"6";"1";"5";"10";"63";"60180"
"2";"0";"2";"10";"63";"60182"
"3";"0";"3";"10";"63";"60183"
"1";"1";"0";"10";"63";"60184"
"12";"8";"4";"10";"63";"60185"
"2";"0";"2";"10";"63";"60187"
"4";"1";"3";"10";"63";"60189"
"2";"2";"0";"10";"63";"60191"
"2";"0";"2";"10";"63";"60192"
"19";"2";"17";"10";"63";"60193"
"1";"1";"0";"10";"63";"60194"
"1";"0";"1";"10";"63";"60199"
"3";"1";"2";"10";"63";"60201"
"4";"1";"3";"10";"63";"60202"
"8";"1";"7";"10";"63";"60203"
"6";"3";"3";"10";"63";"60204"
"2";"0";"2";"10";"63";"60207"
"6";"1";"5";"10";"63";"60212"
"3";"1";"2";"10";"63";"60214"
"4";"1";"3";"10";"63";"60215"
"3";"0";"3";"10";"63";"60216"
"1";"0";"1";"10";"63";"60217"
"4";"1";"3";"10";"63";"60219"
"7";"6";"1";"10";"63";"60221"
"2";"1";"1";"10";"63";"60223"
"1";"0";"1";"10";"63";"60224"
"1";"0";"1";"10";"63";"60225"
"13";"3";"10";"10";"63";"60227"
"2";"0";"2";"10";"63";"60229"
"2";"0";"2";"10";"63";"60232"
"3";"1";"2";"10";"63";"60233"
"14";"2";"12";"10";"63";"60236"
"24";"4";"20";"10";"63";"60238"
"5";"0";"5";"10";"63";"60242"
"1";"0";"1";"10";"63";"60244"
"1";"0";"1";"10";"63";"60245"
"25";"12";"13";"10";"63";"60246"
"3";"0";"3";"10";"63";"60248"
"5";"1";"4";"10";"63";"60249"
"3";"0";"3";"10";"63";"60250"
"4";"0";"4";"10";"63";"60251"
"1";"0";"1";"10";"63";"60256"
"2";"1";"1";"10";"63";"60258"
"10";"3";"7";"10";"63";"60259"
"11";"3";"8";"10";"63";"60262"
"2";"1";"1";"10";"63";"60263"
"4";"1";"3";"10";"63";"60264"
"9";"2";"7";"10";"63";"60265"
"1";"0";"1";"10";"63";"60266"
"2";"0";"2";"10";"63";"60267"
"5";"1";"4";"10";"63";"60268"
"4";"2";"2";"10";"63";"60269"
"3";"1";"2";"10";"63";"60271"
"12";"2";"10";"10";"63";"60274"
"1";"1";"0";"10";"63";"60275"
"11";"5";"6";"10";"63";"60278"
"1";"1";"0";"10";"63";"60280"
"9";"2";"7";"10";"63";"60281"
"23";"4";"19";"10";"63";"60285"
"5";"1";"4";"10";"63";"60290"
"4";"1";"3";"10";"63";"60292"
"1";"1";"0";"10";"63";"60293"
"7";"1";"6";"10";"63";"60294"
"13";"1";"12";"10";"63";"60296"
"2";"0";"2";"10";"63";"60300"
"5";"2";"3";"10";"63";"60303"
"1";"0";"1";"10";"63";"60304"
"3";"1";"2";"10";"63";"60307"
"2";"1";"1";"10";"63";"60308"
"3";"1";"2";"10";"63";"60309"
"23";"11";"12";"10";"63";"60313"
"2";"0";"2";"10";"63";"60314"
"6";"1";"5";"10";"63";"60316"
"5";"1";"4";"10";"63";"60319"
"2";"0";"2";"10";"63";"60321"
"2";"0";"2";"10";"63";"60324"
"8";"2";"6";"10";"63";"60325"
"12";"3";"9";"10";"63";"60328"
"3";"1";"2";"10";"63";"60329"
"1";"0";"1";"10";"63";"60332"
"1";"0";"1";"10";"63";"60333"
"5";"1";"4";"10";"63";"60334"
"2";"0";"2";"10";"63";"60336"
"2";"1";"1";"10";"63";"60341"
"8";"2";"6";"10";"63";"60344"
"7";"2";"5";"10";"63";"60347"
"1";"0";"1";"10";"63";"60349"
"7";"2";"5";"10";"63";"60350"
"2";"0";"2";"10";"63";"60351"
"5";"2";"3";"10";"63";"60352"
"2";"0";"2";"10";"63";"60353"
"9";"2";"7";"10";"63";"60355"
"7";"2";"5";"10";"63";"60357"
"5";"2";"3";"10";"63";"60358"
"321";"234";"87";"10";"63";"60359"
"4";"1";"3";"10";"63";"60361"
"1";"0";"1";"10";"63";"60362"
"4";"2";"2";"10";"63";"60363"
"6";"2";"4";"10";"63";"60364"
"2";"1";"1";"10";"63";"60366"
"1";"1";"0";"10";"63";"60368"
"1";"0";"1";"10";"63";"60369"
"2";"1";"1";"10";"63";"60370"
"2";"0";"2";"10";"63";"60372"
"7";"1";"6";"10";"63";"60373"
"12";"5";"7";"10";"63";"60376"
"8";"0";"8";"10";"63";"60378"
"4";"4";"0";"10";"63";"60379"
"5";"0";"5";"10";"63";"60381"
"5";"1";"4";"10";"63";"60382"
"6";"1";"5";"10";"63";"60383"
"4";"0";"4";"10";"63";"60384"
"2";"0";"2";"10";"63";"60385"
"8";"2";"6";"10";"63";"60387"
"26";"10";"16";"10";"63";"60389"
"3";"1";"2";"10";"63";"60393"
"2";"0";"2";"10";"63";"60395"
"2";"0";"2";"10";"63";"60396"
"3";"0";"3";"10";"63";"60397"
"3";"1";"2";"10";"63";"60398"
"5";"1";"4";"10";"63";"60399"
"2";"0";"2";"10";"63";"60400"
"2";"0";"2";"10";"63";"60401"
"6";"1";"5";"10";"63";"60404"
"5";"2";"3";"10";"63";"60405"
"1";"1";"0";"10";"63";"60406"
"11";"1";"10";"10";"63";"60409"
"63";"47";"16";"10";"63";"60410"
"2";"0";"2";"10";"63";"60411"
"3";"1";"2";"10";"63";"60413"
"34";"13";"21";"10";"63";"60416"
"1";"1";"0";"10";"63";"60417"
"1";"0";"1";"10";"63";"60422"
"6";"1";"5";"10";"63";"60423"
"3";"1";"2";"10";"63";"60424"
"7";"2";"5";"10";"63";"60425"
"10";"2";"8";"10";"63";"60426"
"4";"1";"3";"10";"63";"60427"
"5";"1";"4";"10";"63";"60428"
"3";"0";"3";"10";"63";"60429"
"5";"1";"4";"10";"63";"60430"
"4";"1";"3";"10";"63";"60432"
"2";"0";"2";"10";"63";"60434"
"2";"1";"1";"10";"63";"60436"
"2";"0";"2";"10";"63";"60437"
"26";"19";"7";"10";"63";"60438"
"8";"3";"5";"10";"63";"60442"
"8";"0";"8";"10";"63";"60444"
"2";"1";"1";"10";"63";"60445"
"9";"1";"8";"10";"63";"60447"
"1";"0";"1";"10";"63";"60448"
"6";"1";"5";"10";"63";"60449"
"2";"2";"0";"10";"63";"60450"
"2";"1";"1";"10";"63";"60451"
"14";"9";"5";"10";"63";"60453"
"3";"0";"3";"10";"63";"60455"
"7";"2";"5";"10";"63";"60457"
"8";"2";"6";"10";"63";"60459"
"2";"0";"2";"10";"63";"60461"
"11";"3";"8";"10";"63";"60462"
"9";"1";"8";"10";"63";"60466"
"1";"1";"0";"10";"63";"60468"
"1";"0";"1";"10";"63";"60471"
"4";"0";"4";"10";"63";"60472"
"1";"0";"1";"10";"63";"60473"
"2";"0";"2";"10";"63";"60474"
"21";"3";"18";"10";"63";"60477"
"4";"1";"3";"10";"63";"60479"
"3";"0";"3";"10";"63";"60482"
"8";"2";"6";"10";"63";"60483"
"2";"0";"2";"10";"63";"60485"
"3";"0";"3";"10";"63";"60487"
"6";"1";"5";"10";"63";"60488"
"1";"0";"1";"10";"63";"60492"
"2";"0";"2";"10";"63";"60493"
"1";"0";"1";"10";"63";"60495"
"3";"0";"3";"10";"63";"60497"
"3";"1";"2";"10";"63";"60500"
"1";"0";"1";"10";"63";"60502"
"2";"0";"2";"10";"63";"60504"
"6";"2";"4";"10";"63";"60505"
"1";"1";"0";"10";"63";"60509"
"15";"5";"10";"10";"63";"60512"
"1";"0";"1";"10";"63";"60513"
"6";"1";"5";"10";"63";"60516"
"2";"0";"2";"10";"63";"60521"
"2";"0";"2";"10";"63";"60525"
"4";"1";"3";"10";"63";"60528"
"8";"1";"7";"10";"63";"60529"
"17";"2";"15";"10";"63";"60530"
"3";"0";"3";"10";"63";"60531"
"3";"0";"3";"10";"63";"60534"
"21";"16";"5";"10";"63";"60536"
"7";"2";"5";"10";"63";"60537"
"1";"1";"0";"10";"63";"60539"
"4";"1";"3";"10";"63";"60540"
"8";"2";"6";"10";"63";"60543"
"3";"1";"2";"10";"63";"60544"
"1";"0";"1";"10";"63";"60545"
"13";"2";"11";"10";"63";"60546"
"1";"0";"1";"10";"63";"60547"
"2";"0";"2";"10";"63";"60548"
"23";"4";"19";"10";"63";"60549"
"1";"1";"0";"10";"63";"60550"
"10";"3";"7";"10";"63";"60554"
"4";"1";"3";"10";"63";"60555"
"14";"5";"9";"10";"63";"60556"
"5";"2";"3";"10";"63";"60557"
"2";"0";"2";"10";"63";"60558"
"11";"8";"3";"10";"63";"60560"
"12";"1";"11";"10";"63";"60565"
"5";"0";"5";"10";"63";"60566"
"9";"1";"8";"10";"63";"60569"
"2";"1";"1";"10";"63";"60570"
"4";"1";"3";"10";"63";"60572"
"20";"4";"16";"10";"63";"60574"
"6";"0";"6";"10";"63";"60575"
"4";"1";"3";"10";"63";"60578"
"4";"1";"3";"10";"63";"60581"
"2";"0";"2";"10";"63";"60582"
"10";"2";"8";"10";"63";"60583"
"3";"0";"3";"10";"63";"60585"
"1";"0";"1";"10";"63";"60587"
"1";"1";"0";"10";"63";"60588"
"11";"4";"7";"10";"63";"60589"
"1";"0";"1";"10";"63";"60594"
"1";"0";"1";"10";"63";"60595"
"5";"1";"4";"10";"63";"60596"
"1";"0";"1";"10";"63";"60597"
"4";"1";"3";"10";"63";"60598"
"2";"0";"2";"10";"63";"60602"
"3";"0";"3";"10";"63";"60603"
"3";"1";"2";"10";"63";"60605"
"6";"2";"4";"10";"63";"60606"
"3";"0";"3";"10";"63";"60607"
"2";"0";"2";"10";"63";"60608"
"5";"2";"3";"10";"63";"60609"
"3";"1";"2";"10";"63";"60610"
"1";"0";"1";"10";"63";"60611"
"5";"1";"4";"10";"63";"60615"
"2";"1";"1";"10";"63";"60617"
"2";"1";"1";"10";"63";"60618"
"16";"1";"15";"10";"63";"60619"
"2";"0";"2";"10";"63";"60620"
"2";"0";"2";"10";"63";"60622"
"11";"4";"7";"10";"63";"60623"
"13";"4";"9";"10";"63";"60625"
"3";"1";"2";"10";"63";"60626"
"3";"1";"2";"10";"63";"60629"
"6";"0";"6";"10";"63";"60633"
"8";"2";"6";"10";"63";"60634"
"7";"1";"6";"10";"63";"60635"
"17";"2";"15";"10";"63";"60636"
"1";"0";"1";"10";"63";"60637"
"1";"1";"0";"10";"63";"60640"
"14";"3";"11";"10";"63";"60641"
"5";"2";"3";"10";"63";"60642"
"11";"6";"5";"10";"63";"60644"
"19";"3";"16";"10";"63";"60645"
"4";"0";"4";"10";"63";"60646"
"6";"3";"3";"10";"63";"60647"
"4";"1";"3";"10";"63";"60648"
"6";"2";"4";"10";"63";"60657"
"1";"0";"1";"10";"63";"60659"
"8";"2";"6";"10";"63";"60660"
"4";"2";"2";"10";"63";"60663"
"2";"0";"2";"10";"63";"60665"
"1";"0";"1";"10";"63";"60668"
"6";"1";"5";"10";"63";"60669"
"1";"0";"1";"10";"63";"60671"
"5";"1";"4";"10";"63";"60672"
"5";"0";"5";"10";"63";"60674"
"2";"0";"2";"10";"63";"60675"
"7";"2";"5";"10";"63";"60676"
"3";"1";"2";"10";"63";"60677"
"3";"0";"3";"10";"63";"60679"
"1";"0";"1";"10";"63";"60680"
"5";"0";"5";"10";"63";"60681"
"1";"1";"0";"10";"63";"60682"
"40";"12";"28";"10";"63";"60683"
"3";"0";"3";"10";"63";"60684"
"6";"1";"5";"10";"63";"60686"
"2";"0";"2";"10";"63";"60692"
"2";"1";"1";"10";"63";"60693"
"5";"1";"4";"10";"63";"60695"
"3";"1";"2";"10";"63";"60696"
"1";"0";"1";"10";"63";"60697"
"7";"3";"4";"10";"63";"60698"
"4";"1";"3";"10";"63";"60699"
"6";"4";"2";"10";"63";"60700"
"2";"1";"1";"10";"63";"60701"
"4";"3";"1";"10";"63";"60702"
"12";"4";"8";"10";"63";"60704"
"2";"1";"1";"10";"63";"60707"
"15";"1";"14";"10";"63";"60708"
"6";"1";"5";"10";"63";"60710"
"4";"1";"3";"10";"63";"60713"
"6";"1";"5";"10";"63";"60716"
"3";"0";"3";"10";"63";"60718"
"4";"1";"3";"10";"63";"60719"
"3";"0";"3";"10";"63";"60720"
"5";"2";"3";"10";"63";"60721"
"3";"1";"2";"10";"63";"60722"
"1";"1";"0";"10";"63";"60725"
"2";"0";"2";"10";"63";"60726"
"6";"1";"5";"10";"63";"60727"
"3";"1";"2";"10";"63";"60731"
"13";"2";"11";"10";"63";"60733"
"3";"1";"2";"10";"63";"60734"
"5";"1";"4";"10";"63";"60736"
"12";"1";"11";"10";"63";"60737"
"3";"0";"3";"10";"63";"60740"
"2";"0";"2";"10";"63";"60744"
"3";"1";"2";"10";"63";"60748"
"8";"1";"7";"10";"63";"60751"
"91";"74";"17";"10";"63";"60752"
"2";"0";"2";"10";"63";"60754"
"2";"1";"1";"10";"63";"60755"
"4";"1";"3";"10";"63";"60756"
"3";"1";"2";"10";"63";"60757"
"1";"0";"1";"10";"63";"60758"
"8";"5";"3";"10";"63";"60759"
"1";"0";"1";"10";"63";"60760"
"4";"1";"3";"10";"63";"60767"
"1";"1";"0";"10";"63";"60768"
"11";"3";"8";"10";"63";"60770"
"7";"2";"5";"10";"63";"60771"
"9";"2";"7";"10";"63";"60774"
"12";"2";"10";"10";"63";"60776"
"13";"1";"12";"10";"63";"60777"
"2";"0";"2";"10";"63";"60778"
"10";"4";"6";"10";"63";"60783"
"7";"3";"4";"10";"63";"60786"
"7";"1";"6";"10";"63";"60790"
"8";"3";"5";"10";"63";"60792"
"1";"1";"0";"10";"63";"60793"
"2";"0";"2";"10";"63";"60795"
"10";"2";"8";"10";"63";"60798"
"4";"1";"3";"10";"63";"60799"
"34";"6";"28";"10";"63";"60802"
"2";"0";"2";"10";"63";"60803"
"1";"0";"1";"10";"63";"60804"
"4";"0";"4";"10";"63";"60806"
"2";"1";"1";"10";"63";"60807"
"2";"1";"1";"10";"63";"60808"
"10";"3";"7";"10";"63";"60816"
"11";"1";"10";"10";"63";"60817"
"2";"1";"1";"10";"63";"60818"
"4";"2";"2";"10";"63";"60819"
"3";"0";"3";"10";"63";"60825"
"1285";"1114";"171";"10";"63";"60826"
"22";"17";"5";"10";"63";"60827"
"2";"2";"0";"10";"63";"60828"
"5";"2";"3";"10";"63";"60829"
"4";"1";"3";"10";"63";"60830"
"2";"1";"1";"10";"63";"60832"
"4";"0";"4";"10";"63";"60834"
"4";"0";"4";"10";"63";"60835"
"1";"1";"0";"10";"63";"60838"
"2";"0";"2";"10";"63";"60839"
"1";"0";"1";"10";"63";"60842"
"10";"4";"6";"10";"63";"60843"
"3";"1";"2";"10";"63";"60845"
"6";"1";"5";"10";"63";"60851"
"1";"0";"1";"10";"63";"60854"
"5";"1";"4";"10";"63";"60864"
"6";"2";"4";"10";"63";"60865"
"2";"0";"2";"10";"63";"60866"
"5";"1";"4";"10";"63";"60868"
"7";"4";"3";"10";"63";"60869"
"9";"1";"8";"10";"63";"60870"
"9";"1";"8";"10";"63";"60871"
"6";"2";"4";"10";"63";"60873"
"2";"0";"2";"10";"63";"60875"
"5";"1";"4";"10";"63";"60877"
"1";"0";"1";"10";"63";"60878"
"2";"0";"2";"10";"63";"60879"
"5";"2";"3";"10";"63";"60881"
"3";"0";"3";"10";"63";"60882"
"4";"1";"3";"10";"63";"60885"
"5";"1";"4";"10";"63";"60888"
"6";"1";"5";"10";"63";"60889"
"28";"7";"21";"10";"63";"60890"
"8";"2";"6";"10";"63";"60892"
"2";"1";"1";"10";"63";"60896"
"41";"18";"23";"10";"63";"60898"
"2";"0";"2";"10";"63";"60899"
"2";"0";"2";"10";"63";"60900"
"3";"1";"2";"10";"63";"60902"
"5";"2";"3";"10";"63";"60904"
"24";"10";"14";"10";"63";"60905"
"2";"0";"2";"10";"63";"60907"
"2";"0";"2";"10";"63";"60909"
"1";"0";"1";"10";"63";"60914"
"3";"0";"3";"10";"63";"60915"
"3";"1";"2";"10";"63";"60916"
"3";"1";"2";"10";"63";"60919"
"2";"1";"1";"10";"63";"60927"
"4";"1";"3";"10";"63";"60928"
"9";"2";"7";"10";"63";"60930"
"3";"0";"3";"10";"63";"60931"
"4";"1";"3";"10";"63";"60933"
"1";"0";"1";"10";"63";"60935"
"4";"0";"4";"10";"63";"60936"
"4";"1";"3";"10";"63";"60937"
"3";"0";"3";"10";"63";"60940"
"12";"2";"10";"10";"63";"60942"
"1";"0";"1";"10";"63";"60943"
"3";"0";"3";"10";"63";"60945"
"14";"2";"12";"10";"63";"60946"
"3";"2";"1";"10";"63";"60947"
"7";"2";"5";"10";"63";"60948"
"5";"3";"2";"10";"63";"60952"
"6";"1";"5";"10";"63";"60956"
"3";"1";"2";"10";"63";"60958"
"2";"0";"2";"10";"63";"60959"
"22";"6";"16";"10";"63";"60960"
"4";"1";"3";"10";"63";"60962"
"6";"2";"4";"10";"63";"60964"
"2";"1";"1";"10";"63";"60966"
"3";"1";"2";"10";"63";"60967"
"5";"0";"5";"10";"63";"60969"
"1";"0";"1";"10";"63";"60970"
"4";"1";"3";"10";"63";"60971"
"2";"1";"1";"10";"63";"60973"
"2";"0";"2";"10";"63";"60974"
"3";"0";"3";"10";"63";"60976"
"2";"1";"1";"10";"63";"60979"
"2";"1";"1";"10";"63";"60983"
"4";"1";"3";"10";"63";"60984"
"4";"1";"3";"10";"63";"60986"
"6";"0";"6";"10";"63";"60988"
"3";"0";"3";"10";"63";"60991"
"5";"1";"4";"10";"63";"60995"
"5";"2";"3";"10";"63";"60998"
"3";"0";"3";"10";"63";"61000"
"4";"1";"3";"10";"63";"61001"
"5";"2";"3";"10";"63";"61005"
"4";"1";"3";"10";"63";"61007"
"7";"0";"7";"10";"63";"61010"
"8";"4";"4";"10";"63";"61011"
"1";"0";"1";"10";"63";"61014"
"4";"1";"3";"10";"63";"61019"
"3";"1";"2";"10";"63";"61020"
"1";"0";"1";"10";"63";"61021"
"1";"1";"0";"10";"63";"61022"
"7";"2";"5";"10";"63";"61023"
"1";"0";"1";"10";"63";"61024"
"4";"1";"3";"10";"63";"61030"
"2";"0";"2";"10";"63";"61031"
"7";"1";"6";"10";"63";"61033"
"5";"2";"3";"10";"63";"61034"
"8";"2";"6";"10";"63";"61035"
"21";"6";"15";"10";"63";"61036"
"28";"7";"21";"10";"63";"61039"
"9";"3";"6";"10";"63";"61040"
"1";"0";"1";"10";"63";"61041"
"3";"1";"2";"10";"63";"61043"
"3";"1";"2";"10";"63";"61044"
"3";"3";"0";"10";"63";"61046"
"6";"3";"3";"10";"63";"61048"
"4";"1";"3";"10";"63";"61050"
"4";"1";"3";"10";"63";"61051"
"8";"3";"5";"10";"63";"61054"
"1";"0";"1";"10";"63";"61056"
"4";"2";"2";"10";"63";"61057"
"3";"1";"2";"10";"63";"61058"
"4";"0";"4";"10";"63";"61060"
"1";"0";"1";"10";"63";"61061"
"2";"0";"2";"10";"63";"61062"
"5";"2";"3";"10";"63";"61064"
"2";"0";"2";"10";"63";"61065"
"2";"1";"1";"10";"63";"61068"
"6";"1";"5";"10";"63";"61070"
"2";"0";"2";"10";"63";"61071"
"2";"0";"2";"10";"63";"61072"
"1";"0";"1";"10";"63";"61075"
"4";"0";"4";"10";"63";"61077"
"2";"1";"1";"10";"63";"61078"
"1";"1";"0";"10";"63";"61079"
"8";"1";"7";"10";"63";"61080"
"6";"4";"2";"10";"63";"61083"
"8";"2";"6";"10";"63";"61088"
"2";"0";"2";"10";"63";"61089"
"8";"2";"6";"10";"63";"61091"
"1";"0";"1";"10";"63";"61092"
"3";"0";"3";"10";"63";"61094"
"3";"1";"2";"10";"63";"61095"
"5";"0";"5";"10";"63";"61096"
"2";"1";"1";"10";"63";"61097"
"1";"0";"1";"10";"63";"61098"
"4";"1";"3";"10";"63";"61099"
"1";"1";"0";"10";"63";"61101"
"8";"2";"6";"10";"63";"61102"
"1";"1";"0";"10";"63";"61107"
"3";"3";"0";"10";"63";"61108"
"7";"1";"6";"10";"63";"61109"
"4";"2";"2";"10";"63";"61110"
"2";"1";"1";"10";"63";"61113"
"4";"1";"3";"10";"63";"61116"
"5";"0";"5";"10";"63";"61117"
"5";"1";"4";"10";"63";"61118"
"2";"2";"0";"10";"63";"61122"
"4";"0";"4";"10";"63";"61123"
"2";"1";"1";"10";"63";"61124"
"2";"1";"1";"10";"63";"61125"
"5";"2";"3";"10";"63";"61126"
"4";"0";"4";"10";"63";"61127"
"2";"0";"2";"10";"63";"61128"
"6";"1";"5";"10";"63";"61132"
"3";"1";"2";"10";"63";"61133"
"3";"1";"2";"10";"63";"61136"
"5";"1";"4";"10";"63";"61137"
"2";"0";"2";"10";"63";"61141"
"7";"4";"3";"10";"63";"61142"
"5";"1";"4";"10";"63";"61144"
"5";"1";"4";"10";"63";"61145"
"89";"63";"26";"10";"63";"61148"
"5";"1";"4";"10";"63";"61150"
"5";"2";"3";"10";"63";"61153"
"2";"0";"2";"10";"63";"61154"
"5";"2";"3";"10";"63";"61156"
"6";"1";"5";"10";"63";"61158"
"3";"1";"2";"10";"63";"61160"
"5";"1";"4";"10";"63";"61161"
"3";"1";"2";"10";"63";"61164"
"1";"0";"1";"10";"63";"61165"
"5";"1";"4";"10";"63";"61167"
"5";"2";"3";"10";"63";"61168"
"2";"1";"1";"10";"63";"61173"
"1";"0";"1";"10";"63";"61174"
"5";"1";"4";"10";"63";"61175"
"3";"1";"2";"10";"63";"61176"
"14";"2";"12";"10";"63";"61177"
"18";"1";"17";"10";"63";"61179"
"2";"2";"0";"10";"63";"61185"
"7";"2";"5";"10";"63";"61190"
"2";"0";"2";"10";"63";"61191"
"2";"0";"2";"10";"63";"61192"
"3";"1";"2";"10";"63";"61193"
"1";"0";"1";"10";"63";"61194"
"6";"1";"5";"10";"63";"61195"
"1";"1";"0";"10";"63";"61196"
"1";"1";"0";"10";"63";"61198"
"2";"1";"1";"10";"63";"61199"
"42";"21";"21";"10";"63";"61201"
"18";"1";"17";"10";"63";"61202"
"3";"1";"2";"10";"63";"61206"
"3";"1";"2";"10";"63";"61208"
"2";"1";"1";"10";"63";"61209"
"4";"0";"4";"10";"63";"61210"
"5";"5";"0";"10";"63";"61211"
"22";"6";"16";"10";"63";"61212"
"1";"1";"0";"10";"63";"61214"
"13";"6";"7";"10";"63";"61216"
"1";"0";"1";"10";"63";"61217"
"3";"1";"2";"10";"63";"61220"
"6";"1";"5";"10";"63";"61222"
"2";"1";"1";"10";"63";"61223"
"3";"1";"2";"10";"63";"61226"
"1";"1";"0";"10";"63";"61228"
"5";"3";"2";"10";"63";"61229"
"1";"0";"1";"10";"63";"61230"
"1";"0";"1";"10";"63";"61232"
"33";"22";"11";"10";"63";"61235"
"1";"1";"0";"10";"63";"61237"
"28";"7";"21";"10";"63";"61238"
"4";"0";"4";"10";"63";"61242"
"4";"1";"3";"10";"63";"61243"
"4";"1";"3";"10";"63";"61245"
"2";"0";"2";"10";"63";"61247"
"3";"1";"2";"10";"63";"61248"
"2";"1";"1";"10";"63";"61250"
"6";"1";"5";"10";"63";"61251"
"2";"0";"2";"10";"63";"61255"
"3";"0";"3";"10";"63";"61257"
"22";"5";"17";"10";"63";"61258"
"1";"0";"1";"10";"63";"61260"
"5";"1";"4";"10";"63";"61261"
"2";"0";"2";"10";"63";"61262"
"6";"1";"5";"10";"63";"61263"
"2";"1";"1";"10";"63";"61266"
"1";"0";"1";"10";"63";"61268"
"2";"0";"2";"10";"63";"61270"
"6";"1";"5";"10";"63";"61271"
"15";"13";"2";"10";"63";"61272"
"7";"1";"6";"10";"63";"61273"
"1";"1";"0";"10";"63";"61274"
"2";"0";"2";"10";"63";"61276"
"2";"0";"2";"10";"63";"61277"
"12";"1";"11";"10";"63";"61278"
"1";"0";"1";"10";"63";"61279"
"2";"0";"2";"10";"63";"61282"
"4";"0";"4";"10";"63";"61283"
"1";"0";"1";"10";"63";"61284"
"1";"0";"1";"10";"63";"61285"
"4";"1";"3";"10";"63";"61286"
"2";"1";"1";"10";"63";"61287"
"3";"0";"3";"10";"63";"61288"
"1";"1";"0";"10";"63";"61290"
"9";"1";"8";"10";"63";"61293"
"2";"1";"1";"10";"63";"61294"
"2";"1";"1";"10";"63";"61295"
"6";"2";"4";"10";"63";"61297"
"4";"1";"3";"10";"63";"61298"
"3";"1";"2";"10";"63";"61299"
"2";"1";"1";"10";"63";"61300"
"18";"2";"16";"10";"63";"61301"
"6";"3";"3";"10";"63";"61303"
"6";"1";"5";"10";"63";"61304"
"4";"0";"4";"10";"63";"61305"
"5";"5";"0";"10";"63";"61306"
"3";"1";"2";"10";"63";"61307"
"1";"1";"0";"10";"63";"61308"
"14";"3";"11";"10";"63";"61309"
"3";"0";"3";"10";"63";"61314"
"7";"4";"3";"10";"63";"61315"
"3";"1";"2";"10";"63";"61316"
"6";"3";"3";"10";"63";"61317"
"3";"0";"3";"10";"63";"61318"
"4";"0";"4";"10";"63";"61319"
"3";"0";"3";"10";"63";"61323"
"4";"1";"3";"10";"63";"61326"
"2";"0";"2";"10";"63";"61328"
"6";"1";"5";"10";"63";"61331"
"1";"0";"1";"10";"63";"61332"
"4";"0";"4";"10";"63";"61333"
"1";"1";"0";"10";"63";"61334"
"7";"2";"5";"10";"63";"61336"
"42";"25";"17";"10";"63";"61339"
"4";"1";"3";"10";"63";"61340"
"2";"0";"2";"10";"63";"61341"
"4";"1";"3";"10";"63";"61342"
"1";"0";"1";"10";"63";"61343"
"3";"0";"3";"10";"63";"61345"
"6";"1";"5";"10";"63";"61346"
"2";"0";"2";"10";"63";"61347"
"7";"2";"5";"10";"63";"61348"
"1";"1";"0";"10";"63";"61349"
"3";"0";"3";"10";"63";"61350"
"5";"3";"2";"10";"63";"61352"
"3";"1";"2";"10";"63";"61356"
"3";"1";"2";"10";"63";"61357"
"1";"1";"0";"10";"63";"61358"
"1";"1";"0";"10";"63";"61360"
"1";"0";"1";"10";"63";"61363"
"2";"1";"1";"10";"63";"61364"
"2";"1";"1";"10";"63";"61365"
"2";"0";"2";"10";"63";"61367"
"13";"1";"12";"10";"63";"61369"
"1";"0";"1";"10";"63";"61370"
"10";"3";"7";"10";"63";"61372"
"21";"10";"11";"10";"63";"61375"
"6";"1";"5";"10";"63";"61377"
"2";"1";"1";"10";"63";"61378"
"1";"0";"1";"10";"63";"61379"
"1";"0";"1";"10";"63";"61380"
"3";"0";"3";"10";"63";"61381"
"3";"0";"3";"10";"63";"61383"
"3";"0";"3";"10";"63";"61385"
"8";"6";"2";"10";"63";"61386"
"17";"4";"13";"10";"63";"61388"
"5";"1";"4";"10";"63";"61390"
"1";"0";"1";"10";"63";"61392"
"5";"2";"3";"10";"63";"61395"
"2";"1";"1";"10";"63";"61400"
"1";"1";"0";"10";"63";"61402"
"2";"0";"2";"10";"63";"61403"
"3";"0";"3";"10";"63";"61404"
"4";"1";"3";"10";"63";"61405"
"3";"2";"1";"10";"63";"61407"
"3";"1";"2";"10";"63";"61408"
"4";"1";"3";"10";"63";"61410"
"3";"1";"2";"10";"63";"61411"
"2";"1";"1";"10";"63";"61413"
"2";"0";"2";"10";"63";"61414"
"4";"1";"3";"10";"63";"61416"
"23";"6";"17";"10";"63";"61417"
"2";"0";"2";"10";"63";"61422"
"2";"0";"2";"10";"63";"61423"
"2";"1";"1";"10";"63";"61424"
"3";"1";"2";"10";"63";"61427"
"1";"0";"1";"10";"63";"61430"
"5";"1";"4";"10";"63";"61433"
"1";"1";"0";"10";"63";"61439"
"1";"1";"0";"10";"63";"61440"
"8";"2";"6";"10";"63";"61441"
"3";"0";"3";"10";"63";"61442"
"3";"0";"3";"10";"63";"61444"
"7";"1";"6";"10";"63";"61445"
"6";"2";"4";"10";"63";"61447"
"1";"0";"1";"10";"63";"61448"
"5";"1";"4";"10";"63";"61449"
"3";"0";"3";"10";"63";"61452"
"2";"0";"2";"10";"63";"61453"
"2";"2";"0";"10";"63";"61457"
"1";"0";"1";"10";"63";"61458"
"7";"5";"2";"10";"63";"61460"
"2";"0";"2";"10";"63";"61462"
"7";"1";"6";"10";"63";"61464"
"4";"1";"3";"10";"63";"61465"
"2";"1";"1";"10";"63";"61466"
"2";"0";"2";"10";"63";"61469"
"1";"1";"0";"10";"63";"61470"
"3";"0";"3";"10";"63";"61471"
"7";"1";"6";"10";"63";"61472"
"10";"1";"9";"10";"63";"61473"
"5";"2";"3";"10";"63";"61474"
"5";"2";"3";"10";"63";"61476"
"1";"0";"1";"10";"63";"61479"
"2";"1";"1";"10";"63";"61483"
"4";"0";"4";"10";"63";"61486"
"4";"0";"4";"10";"63";"61487"
"15";"5";"10";"10";"63";"61488"
"14";"5";"9";"10";"63";"61489"
"7";"3";"4";"10";"63";"61490"
"3";"0";"3";"10";"63";"61491"
"1";"1";"0";"10";"63";"61492"
"1";"0";"1";"10";"63";"61495"
"2";"0";"2";"10";"63";"61497"
"1";"1";"0";"10";"63";"61499"
"2";"1";"1";"10";"63";"61501"
"1";"1";"0";"10";"63";"61502"
"9";"5";"4";"10";"63";"61505"
"6";"1";"5";"10";"63";"61506"
"5";"1";"4";"10";"63";"61507"
"1";"0";"1";"10";"63";"61514"
"15";"8";"7";"10";"63";"61516"
"1";"0";"1";"10";"63";"61519"
"5";"0";"5";"10";"63";"61521"
"11";"1";"10";"10";"63";"61524"
"111";"66";"45";"10";"63";"61527"
"2";"0";"2";"10";"63";"61528"
"4";"0";"4";"10";"63";"61531"
"1";"0";"1";"10";"63";"61532"
"5";"1";"4";"10";"63";"61533"
"4";"0";"4";"10";"63";"61536"
"10";"2";"8";"10";"63";"61538"
"4";"0";"4";"10";"63";"61541"
"24";"13";"11";"10";"63";"61543"
"6";"3";"3";"10";"63";"61547"
"8";"1";"7";"10";"63";"61553"
"3";"0";"3";"10";"63";"61554"
"7";"1";"6";"10";"63";"61555"
"7";"2";"5";"10";"63";"61556"
"4";"2";"2";"10";"63";"61562"
"4";"2";"2";"10";"63";"61564"
"3";"1";"2";"10";"63";"61566"
"1";"0";"1";"10";"63";"61568"
"2";"0";"2";"10";"63";"61572"
"3";"1";"2";"10";"63";"61573"
"5";"3";"2";"10";"63";"61574"
"3";"1";"2";"10";"63";"61575"
"5";"1";"4";"10";"63";"61577"
"2";"0";"2";"10";"63";"61578"
"5";"2";"3";"10";"63";"61581"
"4";"1";"3";"10";"63";"61583"
"2";"1";"1";"10";"63";"61584"
"6";"2";"4";"10";"63";"61585"
"1";"1";"0";"10";"63";"61586"
"10";"6";"4";"10";"63";"61587"
"2";"0";"2";"10";"63";"61588"
"4";"1";"3";"10";"63";"61589"
"4";"1";"3";"10";"63";"61592"
"5";"2";"3";"10";"63";"61594"
"4";"1";"3";"10";"63";"61595"
"5";"0";"5";"10";"63";"61600"
"1";"0";"1";"10";"63";"61601"
"8";"3";"5";"10";"63";"61602"
"3";"0";"3";"10";"63";"61603"
"3";"1";"2";"10";"63";"61605"
"1";"1";"0";"10";"63";"61608"
"2";"1";"1";"10";"63";"61612"
"1";"1";"0";"10";"63";"61613"
"7";"1";"6";"10";"63";"61614"
"6";"0";"6";"10";"63";"61615"
"7";"2";"5";"10";"63";"61617"
"4";"0";"4";"10";"63";"61619"
"1";"1";"0";"10";"63";"61620"
"240";"211";"29";"10";"63";"61625"
"6";"2";"4";"10";"63";"61626"
"6";"1";"5";"10";"63";"61627"
"24";"12";"12";"10";"63";"61628"
"4";"0";"4";"10";"63";"61629"
"7";"2";"5";"10";"63";"61630"
"1";"1";"0";"10";"63";"61631"
"4";"1";"3";"10";"63";"61632"
"2";"1";"1";"10";"63";"61633"
"3";"0";"3";"10";"63";"61635"
"8";"2";"6";"10";"63";"61636"
"6";"2";"4";"10";"63";"61637"
"2";"0";"2";"10";"63";"61642"
"2";"1";"1";"10";"63";"61644"
"6";"1";"5";"10";"63";"61647"
"8";"2";"6";"10";"63";"61648"
"5";"0";"5";"10";"63";"61649"
"5";"1";"4";"10";"63";"61653"
"5";"1";"4";"10";"63";"61654"
"3";"1";"2";"10";"63";"61655"
"8";"2";"6";"10";"63";"61657"
"1";"0";"1";"10";"63";"61658"
"1";"0";"1";"10";"63";"61659"
"7";"2";"5";"10";"63";"61660"
"2";"0";"2";"10";"63";"61662"
"1";"0";"1";"10";"63";"61663"
"3";"0";"3";"10";"63";"61665"
"3";"0";"3";"10";"63";"61667"
"23";"15";"8";"10";"63";"61668"
"3";"0";"3";"10";"63";"61669"
"3";"0";"3";"10";"63";"61670"
"7";"3";"4";"10";"63";"61671"
"3";"1";"2";"10";"63";"61673"
"3";"1";"2";"10";"63";"61675"
"1";"1";"0";"10";"63";"61677"
"3";"0";"3";"10";"63";"61678"
"5";"2";"3";"10";"63";"61679"
"31";"10";"21";"10";"63";"61682"
"6";"0";"6";"10";"63";"61683"
"3";"1";"2";"10";"63";"61684"
"286";"206";"80";"10";"63";"61685"
"1";"1";"0";"10";"63";"61687"
"5";"2";"3";"10";"63";"61688"
"10";"6";"4";"10";"63";"61689"
"6";"0";"6";"10";"63";"61690"
"4";"1";"3";"10";"63";"61692"
"15";"5";"10";"10";"63";"61695"
"6";"2";"4";"10";"63";"61698"
"4";"1";"3";"10";"63";"61699"
"4";"1";"3";"10";"63";"61700"
"16";"4";"12";"10";"63";"61703"
"3";"2";"1";"10";"63";"61705"
"3";"0";"3";"10";"63";"61706"
"3";"1";"2";"10";"63";"61709"
"5";"1";"4";"10";"63";"61710"
"4";"1";"3";"10";"63";"61712"
"4";"2";"2";"10";"63";"61714"
"5";"3";"2";"10";"63";"61716"
"1";"1";"0";"10";"63";"61717"
"12";"3";"9";"10";"63";"61718"
"4";"1";"3";"10";"63";"61719"
"1";"1";"0";"10";"63";"61720"
"3";"1";"2";"10";"63";"61722"
"6";"1";"5";"10";"63";"61727"
"3";"0";"3";"10";"63";"61729"
"9";"2";"7";"10";"63";"61731"
"7";"2";"5";"10";"63";"61732"
"41";"25";"16";"10";"63";"61733"
"6";"1";"5";"10";"63";"61736"
"18";"4";"14";"10";"63";"61737"
"3";"2";"1";"10";"63";"61738"
"8";"0";"8";"10";"63";"61741"
"7";"2";"5";"10";"63";"61742"
"10";"3";"7";"10";"63";"61746"
"2";"0";"2";"10";"63";"61747"
"2";"1";"1";"10";"63";"61749"
"1";"1";"0";"10";"63";"61750"
"1";"0";"1";"10";"63";"61752"
"32";"21";"11";"10";"63";"61755"
"1";"0";"1";"10";"63";"61758"
"9";"5";"4";"10";"63";"61763"
"2";"0";"2";"10";"63";"61764"
"2";"0";"2";"10";"63";"61766"
"3";"0";"3";"10";"63";"61768"
"2";"1";"1";"10";"63";"61772"
"7";"1";"6";"10";"63";"61773"
"2";"0";"2";"10";"63";"61776"
"1";"1";"0";"10";"63";"61777"
"4";"2";"2";"10";"63";"61778"
"1";"0";"1";"10";"63";"61784"
"57";"11";"46";"10";"63";"61786"
"2";"0";"2";"10";"63";"61787"
"5";"3";"2";"10";"63";"61788"
"3";"1";"2";"10";"63";"61791"
"2";"1";"1";"10";"63";"61794"
"1";"0";"1";"10";"63";"61796"
"3";"1";"2";"10";"63";"61802"
"108";"42";"66";"10";"63";"61803"
"2";"0";"2";"10";"63";"61804"
"3";"0";"3";"10";"63";"61806"
"3";"0";"3";"10";"63";"61809"
"2";"0";"2";"10";"63";"61810"
"3";"0";"3";"10";"63";"61811"
"8";"1";"7";"10";"63";"61814"
"6";"1";"5";"10";"63";"61815"
"2";"0";"2";"10";"63";"61816"
"3";"1";"2";"10";"63";"61817"
"2";"0";"2";"10";"63";"61819"
"5";"1";"4";"10";"63";"61820"
"3";"0";"3";"10";"63";"61821"
"6";"1";"5";"10";"63";"61824"
"6";"2";"4";"10";"63";"61826"
"11";"2";"9";"10";"63";"61829"
"32";"14";"18";"10";"63";"61831"
"3";"1";"2";"10";"63";"61834"
"3";"0";"3";"10";"63";"61836"
"4";"1";"3";"10";"63";"61837"
"8";"0";"8";"10";"63";"61838"
"6";"2";"4";"10";"63";"61839"
"2";"1";"1";"10";"63";"61842"
"6";"1";"5";"10";"63";"61845"
"3";"0";"3";"10";"63";"61847"
"3";"0";"3";"10";"63";"61852"
"2";"0";"2";"10";"63";"61855"
"4";"2";"2";"10";"63";"61856"
"12";"4";"8";"10";"63";"61858"
"7";"3";"4";"10";"63";"61859"
"5";"1";"4";"10";"63";"61860"
"3";"2";"1";"10";"63";"61863"
"3";"0";"3";"10";"63";"61864"
"1";"1";"0";"10";"63";"61865"
"5";"2";"3";"10";"63";"61866"
"4";"1";"3";"10";"63";"61870"
"1";"0";"1";"10";"63";"61872"
"2";"1";"1";"10";"63";"61873"
"1";"0";"1";"10";"63";"61875"
"25";"8";"17";"10";"63";"61876"
"4";"0";"4";"10";"63";"61878"
"17";"5";"12";"10";"63";"61881"
"8";"2";"6";"10";"63";"61884"
"6";"2";"4";"10";"63";"61885"
"2";"0";"2";"10";"63";"61887"
"2";"0";"2";"10";"63";"61890"
"4";"0";"4";"10";"63";"61896"
"1";"0";"1";"10";"63";"61897"
"3";"0";"3";"10";"63";"61904"
"2";"1";"1";"10";"63";"61906"
"1";"0";"1";"10";"63";"61908"
"28";"4";"24";"10";"63";"61910"
"2";"1";"1";"10";"63";"61911"
"2";"0";"2";"10";"63";"61912"
"8";"3";"5";"10";"63";"61914"
"2";"0";"2";"10";"63";"61919"
"1";"1";"0";"10";"63";"61920"
"6";"3";"3";"10";"63";"61921"
"3";"1";"2";"10";"63";"61923"
"2";"0";"2";"10";"63";"61925"
"4";"1";"3";"10";"63";"61929"
"128";"64";"64";"10";"63";"61930"
"4";"0";"4";"10";"63";"61934"
"4";"1";"3";"10";"63";"61938"
"7";"2";"5";"10";"63";"61939"
"3";"0";"3";"10";"63";"61940"
"2";"0";"2";"10";"63";"61941"
"2";"1";"1";"10";"63";"61943"
"4";"1";"3";"10";"63";"61945"
"1";"0";"1";"10";"63";"61950"
"2";"0";"2";"10";"63";"61953"
"11";"2";"9";"10";"63";"61956"
"14";"5";"9";"10";"63";"61957"
"5";"1";"4";"10";"63";"61959"
"4";"2";"2";"10";"63";"61966"
"2";"1";"1";"10";"63";"61967"
"3";"0";"3";"10";"63";"61968"
"3";"0";"3";"10";"63";"61969"
"55";"42";"13";"10";"63";"61970"
"3";"1";"2";"10";"63";"61972"
"1";"1";"0";"10";"63";"61974"
"3";"0";"3";"10";"63";"61975"
"3";"1";"2";"10";"63";"61976"
"3";"0";"3";"10";"63";"61978"
"2";"0";"2";"10";"63";"61980"
"6";"1";"5";"10";"63";"61981"
"4";"0";"4";"10";"63";"61985"
"8";"1";"7";"10";"63";"61986"
"3";"1";"2";"10";"63";"61988"
"5";"2";"3";"10";"63";"61989"
"39";"15";"24";"10";"63";"61990"
"7";"1";"6";"10";"63";"61992"
"3";"2";"1";"10";"63";"61993"
"3";"0";"3";"10";"63";"61996"
"7";"2";"5";"10";"63";"61998"
"3";"0";"3";"10";"63";"61999"
"6";"3";"3";"10";"63";"62001"
"5";"2";"3";"10";"63";"62002"
"5";"1";"4";"10";"63";"62004"
"5";"1";"4";"10";"63";"62005"
"4";"1";"3";"10";"63";"62007"
"7";"1";"6";"10";"63";"62008"
"17";"2";"15";"10";"63";"62009"
"1";"1";"0";"10";"63";"62010"
"4";"0";"4";"10";"63";"62012"
"1";"0";"1";"10";"63";"62014"
"4";"0";"4";"10";"63";"62015"
"39";"27";"12";"10";"63";"62016"
"1";"1";"0";"10";"63";"62017"
"5";"5";"0";"10";"63";"62019"
"1";"1";"0";"10";"63";"62021"
"2";"0";"2";"10";"63";"62022"
"19";"7";"12";"10";"63";"62023"
"5";"0";"5";"10";"63";"62026"
"4";"1";"3";"10";"63";"62028"
"1";"1";"0";"10";"63";"62029"
"5";"1";"4";"10";"63";"62031"
"45";"31";"14";"10";"63";"62036"
"22";"3";"19";"10";"63";"62037"
"3";"1";"2";"10";"63";"62038"
"1";"0";"1";"10";"63";"62039"
"2";"0";"2";"10";"63";"62040"
"3";"1";"2";"10";"63";"62042"
"7";"2";"5";"10";"63";"62043"
"3";"0";"3";"10";"63";"62044"
"13";"3";"10";"10";"63";"62045"
"2";"1";"1";"10";"63";"62046"
"3";"3";"0";"10";"63";"62050"
"7";"1";"6";"10";"63";"62053"
"16";"3";"13";"10";"63";"62054"
"28";"7";"21";"10";"63";"62058"
"7";"2";"5";"10";"63";"62061"
"1";"1";"0";"10";"63";"62062"
"22";"13";"9";"10";"63";"62063"
"14";"1";"13";"10";"63";"62066"
"4";"1";"3";"10";"63";"62068"
"5";"1";"4";"10";"63";"62070"
"2";"0";"2";"10";"63";"62072"
"1";"1";"0";"10";"63";"62074"
"5";"2";"3";"10";"63";"62076"
"8";"1";"7";"10";"63";"62079"
"8";"6";"2";"10";"63";"62083"
"3";"0";"3";"10";"63";"62084"
"28";"1";"27";"10";"63";"62085"
"3";"0";"3";"10";"63";"62087"
"52";"29";"23";"10";"63";"62088"
"5";"1";"4";"10";"63";"62090"
"1";"0";"1";"10";"63";"62095"
"1";"0";"1";"10";"63";"62097"
"2";"1";"1";"10";"63";"62099"
"7";"1";"6";"10";"63";"62101"
"15";"1";"14";"10";"63";"62103"
"14";"10";"4";"10";"63";"62105"
"2";"0";"2";"10";"63";"62108"
"5";"0";"5";"10";"63";"62109"
"5";"2";"3";"10";"63";"62112"
"41";"28";"13";"10";"63";"62115"
"19";"2";"17";"10";"63";"62116"
"1";"0";"1";"10";"63";"62118"
"6";"2";"4";"10";"63";"62119"
"2";"1";"1";"10";"63";"62121"
"9";"3";"6";"10";"63";"62123"
"16";"9";"7";"10";"63";"62129"
"6";"2";"4";"10";"63";"62133"
"4";"2";"2";"10";"63";"62136"
"10";"4";"6";"10";"63";"62137"
"3";"0";"3";"10";"63";"62146"
"4";"1";"3";"10";"63";"62147"
"8";"1";"7";"10";"63";"62148"
"11";"1";"10";"10";"63";"62151"
"3";"1";"2";"10";"63";"62153"
"2";"0";"2";"10";"63";"62154"
"2";"0";"2";"10";"63";"62155"
"3";"1";"2";"10";"63";"62157"
"1";"1";"0";"10";"63";"62158"
"3";"0";"3";"10";"63";"62159"
"3";"0";"3";"10";"63";"62160"
"1";"1";"0";"10";"63";"62161"
"2";"1";"1";"10";"63";"62162"
"1";"0";"1";"10";"63";"62165"
"3";"0";"3";"10";"63";"62166"
"5";"2";"3";"10";"63";"62169"
"6";"0";"6";"10";"63";"62170"
"4";"2";"2";"10";"63";"62171"
"1";"0";"1";"10";"63";"62174"
"5";"1";"4";"10";"63";"62175"
"1";"0";"1";"10";"63";"62177"
"2";"0";"2";"10";"63";"62178"
"4";"0";"4";"10";"63";"62180"
"9";"2";"7";"10";"63";"62182"
"10";"2";"8";"10";"63";"62183"
"1";"1";"0";"10";"63";"62184"
"4";"0";"4";"10";"63";"62185"
"4";"1";"3";"10";"63";"62186"
"10";"3";"7";"10";"63";"62190"
"9";"3";"6";"10";"63";"62192"
"1";"0";"1";"10";"63";"62197"
"1";"0";"1";"10";"63";"62198"
"2";"0";"2";"10";"63";"62199"
"4";"1";"3";"10";"63";"62201"
"3";"0";"3";"10";"63";"62202"
"5";"0";"5";"10";"63";"62204"
"7";"1";"6";"10";"63";"62205"
"5";"2";"3";"10";"63";"62207"
"2";"0";"2";"10";"63";"62208"
"1";"0";"1";"10";"63";"62210"
"1";"1";"0";"10";"63";"62212"
"5";"5";"0";"10";"63";"62214"
"6";"2";"4";"10";"63";"62215"
"3";"0";"3";"10";"63";"62216"
"1";"1";"0";"10";"63";"62218"
"11";"1";"10";"10";"63";"62220"
"48";"8";"40";"10";"63";"62221"
"7";"1";"6";"10";"63";"62222"
"3";"1";"2";"10";"63";"62224"
"6";"2";"4";"10";"63";"62226"
"4";"1";"3";"10";"63";"62229"
"2";"0";"2";"10";"63";"62230"
"3";"0";"3";"10";"63";"62232"
"11";"1";"10";"10";"63";"62233"
"6";"5";"1";"10";"63";"62234"
"4";"0";"4";"10";"63";"62237"
"1";"1";"0";"10";"63";"62238"
"4";"2";"2";"10";"63";"62240"
"1";"1";"0";"10";"63";"62242"
"2";"0";"2";"10";"63";"62244"
"6";"1";"5";"10";"63";"62245"
"6";"1";"5";"10";"63";"62246"
"8";"5";"3";"10";"63";"62247"
"5";"1";"4";"10";"63";"62248"
"6";"2";"4";"10";"63";"62249"
"1";"1";"0";"10";"63";"62250"
"2";"0";"2";"10";"63";"62252"
"5";"1";"4";"10";"63";"62255"
"2";"1";"1";"10";"63";"62259"
"4";"1";"3";"10";"63";"62261"
"1";"0";"1";"10";"63";"62262"
"9";"3";"6";"10";"63";"62264"
"2";"1";"1";"10";"63";"62265"
"5";"0";"5";"10";"63";"62266"
"4";"1";"3";"10";"63";"62267"
"1";"0";"1";"10";"63";"62269"
"10";"2";"8";"10";"63";"62270"
"5";"2";"3";"10";"63";"62273"
"4";"0";"4";"10";"63";"62274"
"2";"0";"2";"10";"63";"62277"
"6";"1";"5";"10";"63";"62279"
"8";"1";"7";"10";"63";"62284"
"6";"1";"5";"10";"63";"62285"
"6";"2";"4";"10";"63";"62286"
"1";"0";"1";"10";"63";"62288"
"2";"0";"2";"10";"63";"62290"
"3";"1";"2";"10";"63";"62291"
"2";"0";"2";"10";"63";"62294"
"5";"1";"4";"10";"63";"62295"
"1";"1";"0";"10";"63";"62298"
"4";"0";"4";"10";"63";"62299"
"7";"1";"6";"10";"63";"62302"
"3";"1";"2";"10";"63";"62303"
"41";"19";"22";"10";"63";"62305"
"3";"0";"3";"10";"63";"62306"
"2";"0";"2";"10";"63";"62309"
"4";"1";"3";"10";"63";"62311"
"1";"0";"1";"10";"63";"62312"
"2";"0";"2";"10";"63";"62313"
"15";"12";"3";"10";"63";"62315"
"6";"0";"6";"10";"63";"62317"
"1";"0";"1";"10";"63";"62318"
"13";"3";"10";"10";"63";"62322"
"4";"1";"3";"10";"63";"62323"
"5";"1";"4";"10";"63";"62324"
"5";"2";"3";"10";"63";"62325"
"4";"1";"3";"10";"63";"62326"
"3";"0";"3";"10";"63";"62327"
"4";"0";"4";"10";"63";"62328"
"1";"1";"0";"10";"63";"62330"
"7";"2";"5";"10";"63";"62331"
"1";"0";"1";"10";"63";"62332"
"5";"2";"3";"10";"63";"62334"
"1";"0";"1";"10";"63";"62336"
"2";"0";"2";"10";"63";"62339"
"1";"0";"1";"10";"63";"62346"
"1";"0";"1";"10";"63";"62349"
"1";"1";"0";"10";"63";"62350"
"3";"1";"2";"10";"63";"62353"
"11";"1";"10";"10";"63";"62354"
"6";"1";"5";"10";"63";"62355"
"7";"1";"6";"10";"63";"62358"
"1";"0";"1";"10";"63";"62359"
"2";"0";"2";"10";"63";"62360"
"6";"1";"5";"10";"63";"62361"
"4";"0";"4";"10";"63";"62364"
"6";"2";"4";"10";"63";"62367"
"2";"0";"2";"10";"63";"62370"
"4";"2";"2";"10";"63";"62373"
"9";"1";"8";"10";"63";"62375"
"2";"0";"2";"10";"63";"62377"
"2";"1";"1";"10";"63";"62379"
"6";"1";"5";"10";"63";"62380"
"5";"1";"4";"10";"63";"62383"
"11";"3";"8";"10";"63";"62385"
"5";"1";"4";"10";"63";"62387"
"5";"2";"3";"10";"63";"62391"
"1";"1";"0";"10";"63";"62393"
"2";"1";"1";"10";"63";"62394"
"4";"1";"3";"10";"63";"62395"
"7";"1";"6";"10";"63";"62396"
"2";"1";"1";"10";"63";"62400"
"19";"7";"12";"10";"63";"62401"
"1";"1";"0";"10";"63";"62404"
"8";"3";"5";"10";"63";"62405"
"4";"1";"3";"10";"63";"62406"
"5";"0";"5";"10";"63";"62407"
"3";"1";"2";"10";"63";"62411"
"5";"1";"4";"10";"63";"62412"
"9";"1";"8";"10";"63";"62414"
"4";"1";"3";"10";"63";"62415"
"7";"2";"5";"10";"63";"62417"
"4";"1";"3";"10";"63";"62418"
"3";"0";"3";"10";"63";"62420"
"5";"0";"5";"10";"63";"62421"
"1";"1";"0";"10";"63";"62422"
"5";"1";"4";"10";"63";"62427"
"2";"0";"2";"10";"63";"62430"
"1";"0";"1";"10";"63";"62431"
"3";"0";"3";"10";"63";"62432"
"4";"1";"3";"10";"63";"62433"
"6";"1";"5";"10";"63";"62435"
"4";"1";"3";"10";"63";"62436"
"3";"0";"3";"10";"63";"62438"
"6";"2";"4";"10";"63";"62441"
"13";"1";"12";"10";"63";"62442"
"3";"0";"3";"10";"63";"62444"
"5";"2";"3";"10";"63";"62446"
"2";"0";"2";"10";"63";"62447"
"1";"0";"1";"10";"63";"62449"
"4";"1";"3";"10";"63";"62450"
"1";"1";"0";"10";"63";"62453"
"2";"1";"1";"10";"63";"62454"
"1";"1";"0";"10";"63";"62458"
"2";"1";"1";"10";"63";"62460"
"2";"1";"1";"10";"63";"62461"
"4";"1";"3";"10";"63";"62462"
"6";"1";"5";"10";"63";"62464"
"3";"0";"3";"10";"63";"62467"
"5";"0";"5";"10";"63";"62468"
"1";"1";"0";"10";"63";"62469"
"1";"0";"1";"10";"63";"62474"
"4";"1";"3";"10";"63";"62475"
"5";"1";"4";"10";"63";"62476"
"76";"19";"57";"10";"63";"62477"
"12";"2";"10";"10";"63";"62479"
"4";"2";"2";"10";"63";"62480"
"2";"1";"1";"10";"63";"62482"
"1";"1";"0";"10";"63";"62483"
"3";"0";"3";"10";"63";"62484"
"10";"5";"5";"10";"63";"62485"
"1";"0";"1";"10";"63";"62486"
"50";"7";"43";"10";"63";"62488"
"2";"1";"1";"10";"63";"62489"
"1";"1";"0";"10";"63";"62490"
"2";"0";"2";"10";"63";"62492"
"4";"0";"4";"10";"63";"62493"
"1";"0";"1";"10";"63";"62495"
"3";"1";"2";"10";"63";"62496"
"2";"0";"2";"10";"63";"62497"
"2";"0";"2";"10";"63";"62500"
"2";"0";"2";"10";"63";"62501"
"2";"1";"1";"10";"63";"62504"
"2";"1";"1";"10";"63";"62505"
"1";"1";"0";"10";"63";"62506"
"5";"0";"5";"10";"63";"62514"
"13";"8";"5";"10";"63";"62515"
"5";"1";"4";"10";"63";"62518"
"4";"1";"3";"10";"63";"62520"
"1";"1";"0";"10";"63";"62521"
"2";"1";"1";"10";"63";"62523"
"6";"1";"5";"10";"63";"62524"
"5";"1";"4";"10";"63";"62527"
"3";"0";"3";"10";"63";"62528"
"1";"0";"1";"10";"63";"62530"
"1";"1";"0";"10";"63";"62533"
"4";"0";"4";"10";"63";"62535"
"4";"1";"3";"10";"63";"62536"
"2";"1";"1";"10";"63";"62538"
"7";"3";"4";"10";"63";"62539"
"7";"5";"2";"10";"63";"62542"
"3";"1";"2";"10";"63";"62543"
"1";"0";"1";"10";"63";"62549"
"5";"2";"3";"10";"63";"62554"
"4";"1";"3";"10";"63";"62558"
"1";"0";"1";"10";"63";"62567"
"1";"0";"1";"10";"63";"62568"
"2";"0";"2";"10";"63";"62570"
"2";"1";"1";"10";"63";"62574"
"5";"0";"5";"10";"63";"62575"
"283";"212";"71";"10";"63";"62577"
"12";"1";"11";"10";"63";"62578"
"5";"0";"5";"10";"63";"62579"
"3";"0";"3";"10";"63";"62580"
"6";"1";"5";"10";"63";"62581"
"4";"0";"4";"10";"63";"62583"
"3";"0";"3";"10";"63";"62585"
"2";"1";"1";"10";"63";"62588"
"3";"0";"3";"10";"63";"62589"
"9";"1";"8";"10";"63";"62590"
"1";"1";"0";"10";"63";"62591"
"4";"3";"1";"10";"63";"62592"
"3";"1";"2";"10";"63";"62596"
"2";"0";"2";"10";"63";"62602"
"1";"0";"1";"10";"63";"62603"
"3";"0";"3";"10";"63";"62606"
"10";"1";"9";"10";"63";"62607"
"4";"1";"3";"10";"63";"62609"
"6";"2";"4";"10";"63";"62610"
"14";"3";"11";"10";"63";"62612"
"5";"1";"4";"10";"63";"62618"
"7";"1";"6";"10";"63";"62620"
"2";"0";"2";"10";"63";"62621"
"2";"1";"1";"10";"63";"62624"
"4";"0";"4";"10";"63";"62626"
"11";"2";"9";"10";"63";"62627"
"3";"1";"2";"10";"63";"62634"
"1";"0";"1";"10";"63";"62639"
"3";"1";"2";"10";"63";"62640"
"8";"1";"7";"10";"63";"62643"
"1";"1";"0";"10";"63";"62646"
"2";"0";"2";"10";"63";"62650"
"4";"1";"3";"10";"63";"62652"
"6";"1";"5";"10";"63";"62653"
"10";"3";"7";"10";"63";"62654"
"2";"0";"2";"10";"63";"62656"
"4";"1";"3";"10";"63";"62657"
"3";"0";"3";"10";"63";"62658"
"1";"0";"1";"10";"63";"62659"
"4";"0";"4";"10";"63";"62661"
"2";"0";"2";"10";"63";"62662"
"4";"0";"4";"10";"63";"62663"
"6";"1";"5";"10";"63";"62664"
"95";"32";"63";"10";"63";"62665"
"6";"1";"5";"10";"63";"62667"
"3";"0";"3";"10";"63";"62668"
"1";"0";"1";"10";"63";"62672"
"5";"5";"0";"10";"63";"62675"
"2";"0";"2";"10";"63";"62679"
"1";"0";"1";"10";"63";"62680"
"3";"2";"1";"10";"63";"62684"
"1";"0";"1";"10";"63";"62688"
"8";"2";"6";"10";"63";"62690"
"5";"1";"4";"10";"63";"62692"
"7";"1";"6";"10";"63";"62695"
"7";"1";"6";"10";"63";"62697"
"3";"1";"2";"10";"63";"62698"
"2";"0";"2";"10";"63";"62702"
"10";"2";"8";"10";"63";"62706"
"7";"2";"5";"10";"63";"62716"
"4";"1";"3";"10";"63";"62718"
"6";"2";"4";"10";"63";"62719"
"2";"0";"2";"10";"63";"62720"
"4";"1";"3";"10";"63";"62721"
"2";"1";"1";"10";"63";"62724"
"4";"0";"4";"10";"63";"62725"
"5";"2";"3";"10";"63";"62726"
"1";"0";"1";"10";"63";"62729"
"2";"0";"2";"10";"63";"62730"
"7";"2";"5";"10";"63";"62736"
"2";"1";"1";"10";"63";"62743"
"14";"3";"11";"10";"63";"62744"
"9";"1";"8";"10";"63";"62745"
"5";"3";"2";"10";"63";"62746"
"3";"0";"3";"10";"63";"62747"
"3";"1";"2";"10";"63";"62752"
"9";"2";"7";"10";"63";"62753"
"6";"2";"4";"10";"63";"62754"
"1";"1";"0";"10";"63";"62758"
"3";"0";"3";"10";"63";"62760"
"6";"3";"3";"10";"63";"62764"
"3";"1";"2";"10";"63";"62769"
"2";"0";"2";"10";"63";"62770"
"2";"1";"1";"10";"63";"62771"
"1";"1";"0";"10";"63";"62773"
"11";"5";"6";"10";"63";"62774"
"4";"0";"4";"10";"63";"62776"
"3";"1";"2";"10";"63";"62781"
"2";"1";"1";"10";"63";"62784"
"1";"1";"0";"10";"63";"62786"
"2";"0";"2";"10";"63";"62787"
"3";"0";"3";"10";"63";"62788"
"42";"24";"18";"10";"63";"62789"
"22";"1";"21";"10";"63";"62790"
"6";"3";"3";"10";"63";"62793"
"1";"0";"1";"10";"63";"62794"
"3";"1";"2";"10";"63";"62800"
"1";"1";"0";"10";"63";"62802"
"18";"4";"14";"10";"63";"62804"
"3";"1";"2";"10";"63";"62806"
"2";"0";"2";"10";"63";"62807"
"3";"0";"3";"10";"63";"62809"
"3";"1";"2";"10";"63";"62811"
"9";"2";"7";"10";"63";"62813"
"5";"1";"4";"10";"63";"62814"
"2";"0";"2";"10";"63";"62815"
"8";"2";"6";"10";"63";"62816"
"5";"0";"5";"10";"63";"62817"
"3";"1";"2";"10";"63";"62819"
"3";"0";"3";"10";"63";"62820"
"6";"3";"3";"10";"63";"62822"
"2";"1";"1";"10";"63";"62823"
"29";"9";"20";"10";"63";"62824"
"2";"0";"2";"10";"63";"62825"
"5";"0";"5";"10";"63";"62827"
"9";"0";"9";"10";"63";"62828"
"7";"1";"6";"10";"63";"62829"
"2";"0";"2";"10";"63";"62830"
"2";"1";"1";"10";"63";"62832"
"10";"0";"10";"10";"63";"62833"
"3";"1";"2";"10";"63";"62834"
"1";"0";"1";"10";"63";"62836"
"2";"2";"0";"10";"63";"62837"
"14";"3";"11";"10";"63";"62840"
"7";"0";"7";"10";"63";"62841"
"1";"0";"1";"10";"63";"62842"
"7";"3";"4";"10";"63";"62843"
"8";"2";"6";"10";"63";"62844"
"11";"1";"10";"10";"63";"62845"
"30";"8";"22";"10";"63";"62847"
"1";"0";"1";"10";"63";"62851"
"1";"0";"1";"10";"63";"62852"
"2";"0";"2";"10";"63";"62853"
"2";"1";"1";"10";"63";"62856"
"7";"3";"4";"10";"63";"62859"
"7";"2";"5";"10";"63";"62860"
"2";"2";"0";"10";"63";"62861"
"4";"1";"3";"10";"63";"62863"
"2";"0";"2";"10";"63";"62864"
"5";"0";"5";"10";"63";"62866"
"2";"0";"2";"10";"63";"62870"
"41";"26";"15";"10";"63";"62875"
"5";"1";"4";"10";"63";"62878"
"13";"8";"5";"10";"63";"62882"
"5";"1";"4";"10";"63";"62884"
"6";"2";"4";"10";"63";"62885"
"2";"1";"1";"10";"63";"62887"
"4";"1";"3";"10";"63";"62890"
"4";"1";"3";"10";"63";"62892"
"4";"0";"4";"10";"63";"62896"
"1";"1";"0";"10";"63";"62901"
"2";"1";"1";"10";"63";"62905"
"5";"1";"4";"10";"63";"62908"
"2";"0";"2";"10";"63";"62911"
"3";"0";"3";"10";"63";"62912"
"5";"1";"4";"10";"63";"62913"
"4";"1";"3";"10";"63";"62915"
"9";"1";"8";"10";"63";"62916"
"1";"1";"0";"10";"63";"62918"
"3";"1";"2";"10";"63";"62919"
"1";"1";"0";"10";"63";"62920"
"1";"1";"0";"10";"63";"62921"
"3";"3";"0";"10";"63";"62923"
"21";"5";"16";"10";"63";"62925"
"6";"0";"6";"10";"63";"62926"
"3";"0";"3";"10";"63";"62927"
"6";"2";"4";"10";"63";"62928"
"1";"0";"1";"10";"63";"62930"
"8";"1";"7";"10";"63";"62934"
"2";"0";"2";"10";"63";"62937"
"3";"0";"3";"10";"63";"62939"
"3";"3";"0";"10";"63";"62940"
"7";"2";"5";"10";"63";"62945"
"3";"1";"2";"10";"63";"62947"
"2";"0";"2";"10";"63";"62949"
"18";"5";"13";"10";"63";"62951"
"2";"0";"2";"10";"63";"62954"
"2";"1";"1";"10";"63";"62955"
"3";"1";"2";"10";"63";"62957"
"2";"1";"1";"10";"63";"62958"
"1";"1";"0";"10";"63";"62960"
"2";"0";"2";"10";"63";"62962"
"4";"0";"4";"10";"63";"62967"
"5";"2";"3";"10";"63";"62969"
"3";"1";"2";"10";"63";"62970"
"3";"0";"3";"10";"63";"62971"
"3";"0";"3";"10";"63";"62973"
"1";"0";"1";"10";"63";"62976"
"1";"0";"1";"10";"63";"62978"
"2";"2";"0";"10";"63";"62982"
"5";"1";"4";"10";"63";"62983"
"3";"1";"2";"10";"63";"62984"
"7";"2";"5";"10";"63";"62985"
"4";"1";"3";"10";"63";"62987"
"20";"4";"16";"10";"63";"62988"
"3";"0";"3";"10";"63";"62993"
"6";"1";"5";"10";"63";"62994"
"1";"0";"1";"10";"63";"62995"
"5";"0";"5";"10";"63";"62996"
"4";"1";"3";"10";"63";"62997"
"1";"0";"1";"10";"63";"62999"
"20";"8";"12";"10";"63";"63000"
"5";"1";"4";"10";"63";"63001"
"3";"0";"3";"10";"63";"63005"
"7";"0";"7";"10";"63";"63006"
"2";"1";"1";"10";"63";"63007"
"2";"0";"2";"10";"63";"63011"
"2";"1";"1";"10";"63";"63013"
"1";"0";"1";"10";"63";"63015"
"4";"1";"3";"10";"63";"63018"
"1";"0";"1";"10";"63";"63020"
"5";"0";"5";"10";"63";"63021"
"1";"0";"1";"10";"63";"63023"
"5";"1";"4";"10";"63";"63025"
"3";"1";"2";"10";"63";"63026"
"6";"2";"4";"10";"63";"63032"
"12";"1";"11";"10";"63";"63034"
"3";"0";"3";"10";"63";"63036"
"1";"1";"0";"10";"63";"63037"
"3";"1";"2";"10";"63";"63038"
"2";"1";"1";"10";"63";"63043"
"1";"0";"1";"10";"63";"63045"
"2";"0";"2";"10";"63";"63046"
"10";"4";"6";"10";"63";"63048"
"2";"1";"1";"10";"63";"63049"
"2";"1";"1";"10";"63";"63052"
"9";"3";"6";"10";"63";"63054"
"7";"1";"6";"10";"63";"63055"
"1";"0";"1";"10";"63";"63057"
"3";"1";"2";"10";"63";"63058"
"2";"1";"1";"10";"63";"63061"
"32";"9";"23";"10";"63";"63062"
"2";"0";"2";"10";"63";"63063"
"4";"1";"3";"10";"63";"63065"
"3";"1";"2";"10";"63";"63066"
"1";"1";"0";"10";"63";"63067"
"5";"1";"4";"10";"63";"63068"
"6";"1";"5";"10";"63";"63069"
"14";"4";"10";"10";"63";"63071"
"9";"0";"9";"10";"63";"63073"
"1";"1";"0";"10";"63";"63074"
"3";"0";"3";"10";"63";"63077"
"1";"0";"1";"10";"63";"63080"
"6";"2";"4";"10";"63";"63081"
"3";"1";"2";"10";"63";"63082"
"1";"0";"1";"10";"63";"63084"
"13";"1";"12";"10";"63";"63087"
"6";"0";"6";"10";"63";"63088"
"1";"0";"1";"10";"63";"63089"
"3";"0";"3";"10";"63";"63090"
"4";"1";"3";"10";"63";"63091"
"2";"0";"2";"10";"63";"63096"
"3";"3";"0";"10";"63";"63098"
"6";"1";"5";"10";"63";"63100"
"3";"1";"2";"10";"63";"63103"
"2";"0";"2";"10";"63";"63105"
"7";"5";"2";"10";"63";"63106"
"2";"1";"1";"10";"63";"63107"
"1";"0";"1";"10";"63";"63109"
"5";"2";"3";"10";"63";"63110"
"2";"1";"1";"10";"63";"63112"
"1";"1";"0";"10";"63";"63116"
"4";"1";"3";"10";"63";"63118"
"4";"1";"3";"10";"63";"63120"
"2";"0";"2";"10";"63";"63122"
"7";"1";"6";"10";"63";"63123"
"1";"1";"0";"10";"63";"63124"
"4";"2";"2";"10";"63";"63127"
"5";"2";"3";"10";"63";"63128"
"3";"1";"2";"10";"63";"63129"
"6";"2";"4";"10";"63";"63130"
"2";"0";"2";"10";"63";"63131"
"16";"2";"14";"10";"63";"63132"
"7";"3";"4";"10";"63";"63134"
"27";"2";"25";"10";"63";"63135"
"2";"0";"2";"10";"63";"63139"
"14";"3";"11";"10";"63";"63140"
"11";"10";"1";"10";"63";"63142"
"3";"0";"3";"10";"63";"63143"
"5";"1";"4";"10";"63";"63151"
"2";"0";"2";"10";"63";"63152"
"1";"1";"0";"10";"63";"63153"
"1";"1";"0";"10";"63";"63154"
"1";"1";"0";"10";"63";"63155"
"2";"0";"2";"10";"63";"63157"
"1";"1";"0";"10";"63";"63158"
"3";"0";"3";"10";"63";"63164"
"16";"4";"12";"10";"63";"63165"
"3";"1";"2";"10";"63";"63166"
"9";"1";"8";"10";"63";"63167"
"2";"1";"1";"10";"63";"63169"
"4";"0";"4";"10";"63";"63170"
"3";"1";"2";"10";"63";"63171"
"5";"1";"4";"10";"63";"63172"
"6";"1";"5";"10";"63";"63174"
"6";"1";"5";"10";"63";"63176"
"3";"0";"3";"10";"63";"63177"
"1";"1";"0";"10";"63";"63181"
"2";"0";"2";"10";"63";"63182"
"1";"1";"0";"10";"63";"63184"
"4";"1";"3";"10";"63";"63186"
"3";"1";"2";"10";"63";"63189"
"2";"0";"2";"10";"63";"63196"
"7";"0";"7";"10";"63";"63198"
"1";"0";"1";"10";"63";"63200"
"1";"0";"1";"10";"63";"63201"
"5";"1";"4";"10";"63";"63202"
"11";"4";"7";"10";"63";"63203"
"9";"2";"7";"10";"63";"63207"
"3";"0";"3";"10";"63";"63208"
"4";"1";"3";"10";"63";"63210"
"6";"2";"4";"10";"63";"63211"
"1";"0";"1";"10";"63";"63212"
"5";"1";"4";"10";"63";"63213"
"7";"4";"3";"10";"63";"63214"
"6";"0";"6";"10";"63";"63217"
"1";"1";"0";"10";"63";"63218"
"6";"1";"5";"10";"63";"63219"
"4";"1";"3";"10";"63";"63220"
"4";"1";"3";"10";"63";"63221"
"13";"7";"6";"10";"63";"63222"
"58";"44";"14";"10";"63";"63225"
"5";"2";"3";"10";"63";"63227"
"4";"2";"2";"10";"63";"63228"
"3";"1";"2";"10";"63";"63229"
"2";"0";"2";"10";"63";"63230"
"6";"1";"5";"10";"63";"63231"
"16";"5";"11";"10";"63";"63233"
"10";"2";"8";"10";"63";"63235"
"2";"2";"0";"10";"63";"63238"
"5";"1";"4";"10";"63";"63240"
"4";"1";"3";"10";"63";"63241"
"2";"0";"2";"10";"63";"63245"
"2";"1";"1";"10";"63";"63248"
"1";"1";"0";"10";"63";"63249"
"6";"1";"5";"10";"63";"63251"
"9";"1";"8";"10";"63";"63252"
"3";"0";"3";"10";"63";"63253"
"4";"0";"4";"10";"63";"63254"
"1";"1";"0";"10";"63";"63257"
"13";"4";"9";"10";"63";"63259"
"60";"33";"27";"10";"63";"63260"
"2";"1";"1";"10";"63";"63261"
"12";"4";"8";"10";"63";"63262"
"10";"2";"8";"10";"63";"63264"
"5";"3";"2";"10";"63";"63265"
"8";"0";"8";"10";"63";"63266"
"18";"13";"5";"10";"63";"63271"
"19";"2";"17";"10";"63";"63273"
"3";"0";"3";"10";"63";"63274"
"8";"2";"6";"10";"63";"63275"
"1";"0";"1";"10";"63";"63277"
"2";"1";"1";"10";"63";"63279"
"25";"15";"10";"10";"63";"63280"
"10";"3";"7";"10";"63";"63282"
"1";"0";"1";"10";"63";"63285"
"5";"2";"3";"10";"63";"63287"
"9";"4";"5";"10";"63";"63288"
"1";"0";"1";"10";"63";"63289"
"6";"1";"5";"10";"63";"63290"
"5";"0";"5";"10";"63";"63293"
"4";"1";"3";"10";"63";"63295"
"6";"2";"4";"10";"63";"63299"
"2";"0";"2";"10";"63";"63301"
"2";"2";"0";"10";"63";"63302"
"18";"1";"17";"10";"63";"63306"
"2";"0";"2";"10";"63";"63307"
"2";"1";"1";"10";"63";"63309"
"2";"0";"2";"10";"63";"63311"
"5";"3";"2";"10";"63";"63315"
"7";"2";"5";"10";"63";"63317"
"3";"1";"2";"10";"63";"63320"
"2";"0";"2";"10";"63";"63321"
"10";"2";"8";"10";"63";"63322"
"3";"1";"2";"10";"63";"63323"
"2";"1";"1";"10";"63";"63324"
"3";"1";"2";"10";"63";"63325"
"1";"0";"1";"10";"63";"63326"
"13";"0";"13";"10";"63";"63327"
"2";"0";"2";"10";"63";"63330"
"2";"2";"0";"10";"63";"63332"
"3";"1";"2";"10";"63";"63333"
"3";"1";"2";"10";"63";"63335"
"1";"0";"1";"10";"63";"63336"
"1";"1";"0";"10";"63";"63339"
"1";"1";"0";"10";"63";"63341"
"1";"0";"1";"10";"63";"63343"
"2";"1";"1";"10";"63";"63345"
"1";"0";"1";"10";"63";"63347"
"16";"2";"14";"10";"63";"63349"
"2";"2";"0";"10";"63";"63350"
"1";"1";"0";"10";"63";"63351"
"2";"1";"1";"10";"63";"63352"
"6";"0";"6";"10";"63";"63354"
"4";"1";"3";"10";"63";"63355"
"5";"1";"4";"10";"63";"63357"
"3";"1";"2";"10";"63";"63359"
"20";"9";"11";"10";"63";"63362"
"4";"1";"3";"10";"63";"63373"
"2";"1";"1";"10";"63";"63375"
"4";"2";"2";"10";"63";"63379"
"17";"10";"7";"10";"63";"63380"
"6";"2";"4";"10";"63";"63383"
"1";"0";"1";"10";"63";"63384"
"3";"0";"3";"10";"63";"63385"
"7";"2";"5";"10";"63";"63390"
"18";"2";"16";"10";"63";"63392"
"1";"0";"1";"10";"63";"63393"
"1";"0";"1";"10";"63";"63395"
"10";"3";"7";"10";"63";"63396"
"5";"2";"3";"10";"63";"63397"
"3";"1";"2";"10";"63";"63398"
"4";"0";"4";"10";"63";"63399"
"1";"1";"0";"10";"63";"63400"
"16";"2";"14";"10";"63";"63401"
"2";"2";"0";"10";"63";"63402"
"3";"1";"2";"10";"63";"63403"
"1";"1";"0";"10";"63";"63404"
"1";"0";"1";"10";"63";"63406"
"10";"0";"10";"10";"63";"63409"
"14";"9";"5";"10";"63";"63410"
"6";"2";"4";"10";"63";"63414"
"1";"1";"0";"10";"63";"63418"
"2";"1";"1";"10";"63";"63423"
"1";"0";"1";"10";"63";"63424"
"14";"1";"13";"10";"63";"63425"
"1";"1";"0";"10";"63";"63430"
"7";"3";"4";"10";"63";"63431"
"1";"0";"1";"10";"63";"63432"
"5";"0";"5";"10";"63";"63433"
"2";"1";"1";"10";"63";"63434"
"2";"1";"1";"10";"63";"63436"
"4";"2";"2";"10";"63";"63437"
"2";"0";"2";"10";"63";"63438"
"2";"1";"1";"10";"63";"63440"
"95";"46";"49";"10";"63";"63441"
"20";"7";"13";"10";"63";"63443"
"3";"0";"3";"10";"63";"63445"
"1";"1";"0";"10";"63";"63446"
"6";"0";"6";"10";"63";"63447"
"15";"4";"11";"10";"63";"63448"
"4";"1";"3";"10";"63";"63450"
"45";"28";"17";"10";"63";"63451"
"12";"2";"10";"10";"63";"63453"
"4";"1";"3";"10";"63";"63456"
"9";"4";"5";"10";"63";"63458"
"8";"2";"6";"10";"63";"63459"
"8";"1";"7";"10";"63";"63464"
"1";"0";"1";"10";"63";"63465"
"2";"1";"1";"10";"63";"63466"
"24";"7";"17";"10";"63";"63470"
"23";"11";"12";"10";"63";"63471"
"2";"1";"1";"10";"63";"63472"
"4";"0";"4";"10";"63";"63475"
"1";"0";"1";"10";"63";"63476"
"3";"1";"2";"10";"63";"63477"
"1";"1";"0";"10";"63";"63478"
"3";"1";"2";"10";"63";"63481"
"1";"0";"1";"10";"63";"63482"
"1";"1";"0";"10";"63";"63484"
"3";"0";"3";"10";"63";"63485"
"5";"1";"4";"10";"63";"63486"
"8";"4";"4";"10";"63";"63488"
"5";"1";"4";"10";"63";"63489"
"3";"0";"3";"10";"63";"63494"
"2";"1";"1";"10";"63";"63496"
"1";"0";"1";"10";"63";"63500"
"12";"7";"5";"10";"63";"63501"
"1";"0";"1";"10";"63";"63504"
"12";"7";"5";"10";"63";"63506"
"11";"6";"5";"10";"63";"63507"
"4";"1";"3";"10";"63";"63508"
"1";"0";"1";"10";"63";"63509"
"2";"0";"2";"10";"63";"63510"
"22";"17";"5";"10";"63";"63512"
"6";"0";"6";"10";"63";"63513"
"6";"2";"4";"10";"63";"63514"
"5";"3";"2";"10";"63";"63515"
"1";"1";"0";"10";"63";"63517"
"1";"1";"0";"10";"63";"63520"
"8";"1";"7";"10";"63";"63521"
"6";"0";"6";"10";"63";"63523"
"2";"0";"2";"10";"63";"63524"
"3";"0";"3";"10";"63";"63525"
"2";"1";"1";"10";"63";"63528"
"2";"1";"1";"10";"63";"63530"
"1";"0";"1";"10";"63";"63531"
"3";"0";"3";"10";"63";"63532"
"7";"1";"6";"10";"63";"63533"
"2";"1";"1";"10";"63";"63535"
"3";"2";"1";"10";"63";"63536"
"3";"1";"2";"10";"63";"63537"
"1";"0";"1";"10";"63";"63542"
"3";"0";"3";"10";"63";"63543"
"3";"0";"3";"10";"63";"63545"
"3";"1";"2";"10";"63";"63546"
"5";"2";"3";"10";"63";"63547"
"4";"1";"3";"10";"63";"63551"
"7";"2";"5";"10";"63";"63552"
"4";"1";"3";"10";"63";"63554"
"6";"1";"5";"10";"63";"63556"
"2";"0";"2";"10";"63";"63557"
"1";"1";"0";"10";"63";"63560"
"3";"0";"3";"10";"63";"63562"
"9";"1";"8";"10";"63";"63563"
"118";"72";"46";"10";"63";"63571"
"2";"0";"2";"10";"63";"63575"
"3";"0";"3";"10";"63";"63579"
"10";"2";"8";"10";"63";"63581"
"2";"1";"1";"10";"63";"63586"
"3";"0";"3";"10";"63";"63587"
"1";"0";"1";"10";"63";"63589"
"2";"1";"1";"10";"63";"63590"
"3";"1";"2";"10";"63";"63591"
"2";"0";"2";"10";"63";"63593"
"3";"0";"3";"10";"63";"63594"
"2";"0";"2";"10";"63";"63595"
"4";"0";"4";"10";"63";"63598"
"2";"2";"0";"10";"63";"63600"
"1";"1";"0";"10";"63";"63601"
"1";"1";"0";"10";"63";"63602"
"8";"2";"6";"10";"63";"63603"
"11";"3";"8";"10";"63";"63606"
"26";"12";"14";"10";"63";"63608"
"1";"0";"1";"10";"63";"63610"
"30";"14";"16";"10";"63";"63612"
"2";"0";"2";"10";"63";"63613"
"1";"0";"1";"10";"63";"63616"
"6";"1";"5";"10";"63";"63618"
"2";"0";"2";"10";"63";"63619"
"3";"0";"3";"10";"63";"63620"
"3";"1";"2";"10";"63";"63623"
"4";"1";"3";"10";"63";"63625"
"8";"2";"6";"10";"63";"63632"
"5";"1";"4";"10";"63";"63634"
"3";"1";"2";"10";"63";"63635"
"4";"1";"3";"10";"63";"63638"
"3";"0";"3";"10";"63";"63640"
"2";"0";"2";"10";"63";"63642"
"2";"0";"2";"10";"63";"63645"
"1";"0";"1";"10";"63";"63650"
"2";"1";"1";"10";"63";"63651"
"5";"1";"4";"10";"63";"63652"
"3";"0";"3";"10";"63";"63660"
"3";"1";"2";"10";"63";"63661"
"2";"0";"2";"10";"63";"63663"
"4";"1";"3";"10";"63";"63664"
"4";"1";"3";"10";"63";"63665"
"4";"1";"3";"10";"63";"63667"
"2";"0";"2";"10";"63";"63671"
"9";"1";"8";"10";"63";"63676"
"5";"2";"3";"10";"63";"63681"
"6";"1";"5";"10";"63";"63682"
"1";"0";"1";"10";"63";"63684"
"12";"8";"4";"10";"63";"63687"
"2";"0";"2";"10";"63";"63692"
"5";"1";"4";"10";"63";"63693"
"4";"1";"3";"10";"63";"63695"
"3";"1";"2";"10";"63";"63698"
"4";"0";"4";"10";"63";"63700"
"2";"1";"1";"10";"63";"63701"
"3";"0";"3";"10";"63";"63703"
"4";"0";"4";"10";"63";"63705"
"1";"0";"1";"10";"63";"63706"
"8";"0";"8";"10";"63";"63709"
"2";"1";"1";"10";"63";"63710"
"6";"1";"5";"10";"63";"63711"
"4";"1";"3";"10";"63";"63712"
"6";"1";"5";"10";"63";"63714"
"1";"0";"1";"10";"63";"63718"
"2";"0";"2";"10";"63";"63719"
"23";"21";"2";"10";"63";"63721"
"4";"2";"2";"10";"63";"63722"
"4";"0";"4";"10";"63";"63723"
"3";"0";"3";"10";"63";"63729"
"1";"1";"0";"10";"63";"63731"
"3";"0";"3";"10";"63";"63732"
"9";"2";"7";"10";"63";"63733"
"4";"1";"3";"10";"63";"63735"
"2";"0";"2";"10";"63";"63737"
"6";"1";"5";"10";"63";"63739"
"1";"1";"0";"10";"63";"63740"
"5";"3";"2";"10";"63";"63741"
"2";"0";"2";"10";"63";"63746"
"1";"1";"0";"10";"63";"63749"
"1";"1";"0";"10";"63";"63750"
"1";"1";"0";"10";"63";"63751"
"2";"0";"2";"10";"63";"63752"
"5";"2";"3";"10";"63";"63758"
"29";"20";"9";"10";"63";"63760"
"3";"1";"2";"10";"63";"63763"
"111";"52";"59";"10";"63";"63764"
"6";"2";"4";"10";"63";"63765"
"5";"1";"4";"10";"63";"63766"
"2";"1";"1";"10";"63";"63767"
"3";"2";"1";"10";"63";"63769"
"5";"1";"4";"10";"63";"63774"
"3";"0";"3";"10";"63";"63775"
"3";"0";"3";"10";"63";"63776"
"2";"1";"1";"10";"63";"63777"
"3";"1";"2";"10";"63";"63778"
"6";"2";"4";"10";"63";"63784"
"13";"3";"10";"10";"63";"63787"
"6";"0";"6";"10";"63";"63795"
"7";"5";"2";"10";"63";"63796"
"5";"2";"3";"10";"63";"63798"
"5";"0";"5";"10";"63";"63799"
"10";"2";"8";"10";"63";"63800"
"3";"0";"3";"10";"63";"63801"
"24";"9";"15";"10";"63";"63802"
"5";"2";"3";"10";"63";"63805"
"6";"1";"5";"10";"63";"63807"
"10";"3";"7";"10";"63";"63808"
"1";"0";"1";"10";"63";"63810"
"33";"4";"29";"10";"63";"63811"
"2";"0";"2";"10";"63";"63812"
"2";"2";"0";"10";"63";"63813"
"4";"3";"1";"10";"63";"63814"
"9";"7";"2";"10";"63";"63815"
"1";"1";"0";"10";"63";"63816"
"4";"0";"4";"10";"63";"63818"
"1";"1";"0";"10";"63";"63821"
"3";"0";"3";"10";"63";"63822"
"78";"49";"29";"10";"63";"63824"
"2";"1";"1";"10";"63";"63826"
"1";"0";"1";"10";"63";"63829"
"2";"0";"2";"10";"63";"63830"
"4";"0";"4";"10";"63";"63834"
"2";"0";"2";"10";"63";"63840"
"2";"0";"2";"10";"63";"63844"
"2";"2";"0";"10";"63";"63845"
"12";"4";"8";"10";"63";"63852"
"5";"1";"4";"10";"63";"63853"
"4";"2";"2";"10";"63";"63854"
"1";"1";"0";"10";"63";"63855"
"2";"1";"1";"10";"63";"63860"
"15";"3";"12";"10";"63";"63861"
"13";"4";"9";"10";"63";"63863"
"5";"2";"3";"10";"63";"63864"
"3";"0";"3";"10";"63";"63865"
"2";"0";"2";"10";"63";"63866"
"5";"0";"5";"10";"63";"63869"
"7";"2";"5";"10";"63";"63870"
"5";"2";"3";"10";"63";"63871"
"20";"3";"17";"10";"63";"63873"
"6";"1";"5";"10";"63";"63874"
"1";"0";"1";"10";"63";"63882"
"5";"1";"4";"10";"63";"63883"
"1";"1";"0";"10";"63";"63884"
"7";"2";"5";"10";"63";"63893"
"3";"0";"3";"10";"63";"63895"
"5";"1";"4";"10";"63";"63897"
"3";"0";"3";"10";"63";"63898"
"11";"0";"11";"10";"63";"63901"
"3";"0";"3";"10";"63";"63903"
"2";"0";"2";"10";"63";"63907"
"3";"0";"3";"10";"63";"63908"
"7";"1";"6";"10";"63";"63909"
"1";"0";"1";"10";"63";"63911"
"3";"1";"2";"10";"63";"63912"
"7";"1";"6";"10";"63";"63914"
"5";"2";"3";"10";"63";"63915"
"4";"0";"4";"10";"63";"63917"
"1";"0";"1";"10";"63";"63923"
"2";"1";"1";"10";"63";"63925"
"2";"0";"2";"10";"63";"63927"
"18";"6";"12";"10";"63";"63928"
"3";"0";"3";"10";"63";"63929"
"3";"0";"3";"10";"63";"63931"
"1";"0";"1";"10";"63";"63932"
"4";"1";"3";"10";"63";"63934"
"2";"1";"1";"10";"63";"63936"
"2";"0";"2";"10";"63";"63942"
"1";"1";"0";"10";"63";"63944"
"29";"9";"20";"10";"63";"63945"
"1";"1";"0";"10";"63";"63946"
"6";"2";"4";"10";"63";"63947"
"2";"1";"1";"10";"63";"63949"
"2";"2";"0";"10";"63";"63953"
"6";"1";"5";"10";"63";"63955"
"1";"0";"1";"10";"63";"63956"
"2";"0";"2";"10";"63";"63957"
"1";"0";"1";"10";"63";"63959"
"1";"0";"1";"10";"63";"63960"
"2";"0";"2";"10";"63";"63962"
"6";"3";"3";"10";"63";"63964"
"12";"9";"3";"10";"63";"63965"
"4";"2";"2";"10";"63";"63967"
"5";"2";"3";"10";"63";"63973"
"2";"0";"2";"10";"63";"63975"
"2";"1";"1";"10";"63";"63976"
"8";"3";"5";"10";"63";"63977"
"3";"0";"3";"10";"63";"63978"
"2";"0";"2";"10";"63";"63979"
"3";"0";"3";"10";"63";"63981"
"3";"0";"3";"10";"63";"63982"
"5";"2";"3";"10";"63";"63984"
"2";"0";"2";"10";"63";"63985"
"2";"1";"1";"10";"63";"63987"
"1";"0";"1";"10";"63";"63988"
"5";"1";"4";"10";"63";"63991"
"3";"0";"3";"10";"63";"63993"
"1";"1";"0";"10";"63";"63996"
"1";"1";"0";"10";"63";"64004"
"4";"1";"3";"10";"63";"64005"
"1";"1";"0";"10";"63";"64006"
"38";"26";"12";"10";"63";"64007"
"2";"0";"2";"10";"63";"64010"
"5";"1";"4";"10";"63";"64013"
"1";"1";"0";"10";"63";"64019"
"3";"1";"2";"10";"63";"64022"
"2";"0";"2";"10";"63";"64025"
"2";"0";"2";"10";"63";"64028"
"3";"1";"2";"10";"63";"64029"
"2";"0";"2";"10";"63";"64031"
"2";"1";"1";"10";"63";"64032"
"5";"1";"4";"10";"63";"64034"
"17";"1";"16";"10";"63";"64038"
"10";"3";"7";"10";"63";"64040"
"19";"4";"15";"10";"63";"64041"
"4";"1";"3";"10";"63";"64043"
"2";"0";"2";"10";"63";"64044"
"2";"0";"2";"10";"63";"64045"
"4";"1";"3";"10";"63";"64048"
"5";"0";"5";"10";"63";"64049"
"2";"0";"2";"10";"63";"64052"
"1";"1";"0";"10";"63";"64054"
"4";"2";"2";"10";"63";"64055"
"5";"1";"4";"10";"63";"64056"
"15";"3";"12";"10";"63";"64057"
"1";"1";"0";"10";"63";"64058"
"6";"6";"0";"10";"63";"64063"
"5";"3";"2";"10";"63";"64065"
"3";"0";"3";"10";"63";"64068"
"3";"1";"2";"10";"63";"64069"
"6";"2";"4";"10";"63";"64071"
"8";"1";"7";"10";"63";"64073"
"6";"0";"6";"10";"63";"64076"
"1";"0";"1";"10";"63";"64078"
"3";"1";"2";"10";"63";"64082"
"5";"1";"4";"10";"63";"64083"
"2";"1";"1";"10";"63";"64085"
"1";"0";"1";"10";"63";"64088"
"2";"0";"2";"10";"63";"64090"
"8";"0";"8";"10";"63";"64091"
"1";"0";"1";"10";"63";"64093"
"1";"0";"1";"10";"63";"64094"
"3";"0";"3";"10";"63";"64097"
"1";"1";"0";"10";"63";"64099"
"1";"1";"0";"10";"63";"64100"
"3";"0";"3";"10";"63";"64101"
"7";"2";"5";"10";"63";"64104"
"2";"0";"2";"10";"63";"64105"
"1";"0";"1";"10";"63";"64106"
"5";"0";"5";"10";"63";"64107"
"8";"1";"7";"10";"63";"64108"
"2";"1";"1";"10";"63";"64110"
"1";"0";"1";"10";"63";"64111"
"4";"1";"3";"10";"63";"64112"
"3";"0";"3";"10";"63";"64113"
"4";"2";"2";"10";"63";"64114"
"3";"1";"2";"10";"63";"64116"
"4";"1";"3";"10";"63";"64118"
"3";"1";"2";"10";"63";"64123"
"5";"2";"3";"10";"63";"64125"
"2";"0";"2";"10";"63";"64127"
"5";"1";"4";"10";"63";"64130"
"2";"0";"2";"10";"63";"64133"
"7";"1";"6";"10";"63";"64139"
"2";"0";"2";"10";"63";"64140"
"6";"2";"4";"10";"63";"64141"
"7";"0";"7";"10";"63";"64145"
"6";"1";"5";"10";"63";"64146"
"3";"1";"2";"10";"63";"64147"
"12";"1";"11";"10";"63";"64148"
"1";"1";"0";"10";"63";"64152"
"1";"1";"0";"10";"63";"64155"
"3";"0";"3";"10";"63";"64156"
"6";"2";"4";"10";"63";"64161"
"4";"1";"3";"10";"63";"64162"
"3";"0";"3";"10";"63";"64164"
"2";"0";"2";"10";"63";"64166"
"8";"1";"7";"10";"63";"64169"
"3";"1";"2";"10";"63";"64171"
"2";"0";"2";"10";"63";"64173"
"18";"4";"14";"10";"63";"64175"
"3";"1";"2";"10";"63";"64176"
"22";"5";"17";"10";"63";"64177"
"5";"1";"4";"10";"63";"64178"
"2";"0";"2";"10";"63";"64183"
"6";"0";"6";"10";"63";"64184"
"7";"1";"6";"10";"63";"64186"
"12";"0";"12";"10";"63";"64188"
"12";"4";"8";"10";"63";"64190"
"1";"0";"1";"10";"63";"64191"
"3";"1";"2";"10";"63";"64192"
"13";"2";"11";"10";"63";"64193"
"1";"0";"1";"10";"63";"64197"
"6";"6";"0";"10";"63";"64199"
"8";"3";"5";"10";"63";"64200"
"11";"2";"9";"10";"63";"64203"
"12";"2";"10";"10";"63";"64208"
"5";"1";"4";"10";"63";"64209"
"5";"0";"5";"10";"63";"64211"
"3";"1";"2";"10";"63";"64212"
"2";"0";"2";"10";"63";"64214"
"8";"1";"7";"10";"63";"64215"
"1";"1";"0";"10";"63";"64216"
"1";"1";"0";"10";"63";"64217"
"2";"1";"1";"10";"63";"64218"
"14";"2";"12";"10";"63";"64219"
"1";"0";"1";"10";"63";"64220"
"2";"0";"2";"10";"63";"64221"
"2";"0";"2";"10";"63";"64222"
"2";"0";"2";"10";"63";"64223"
"10";"3";"7";"10";"63";"64225"
"3";"0";"3";"10";"63";"64226"
"3";"0";"3";"10";"63";"64230"
"3";"0";"3";"10";"63";"64231"
"2";"0";"2";"10";"63";"64232"
"1";"0";"1";"10";"63";"64233"
"5";"1";"4";"10";"63";"64235"
"5";"0";"5";"10";"63";"64236"
"4";"2";"2";"10";"63";"64237"
"1";"0";"1";"10";"63";"64239"
"11";"4";"7";"10";"63";"64242"
"7";"1";"6";"10";"63";"64243"
"6";"2";"4";"10";"63";"64244"
"8";"1";"7";"10";"63";"64247"
"7";"0";"7";"10";"63";"64249"
"5";"0";"5";"10";"63";"64250"
"1";"0";"1";"10";"63";"64251"
"7";"3";"4";"10";"63";"64252"
"2";"1";"1";"10";"63";"64254"
"2";"0";"2";"10";"63";"64255"
"2";"1";"1";"10";"63";"64257"
"1";"0";"1";"10";"63";"64258"
"2";"2";"0";"10";"63";"64259"
"2";"0";"2";"10";"63";"64260"
"7";"1";"6";"10";"63";"64263"
"6";"1";"5";"10";"63";"64264"
"10";"4";"6";"10";"63";"64265"
"4";"1";"3";"10";"63";"64271"
"4";"0";"4";"10";"63";"64274"
"4";"0";"4";"10";"63";"64276"
"1";"0";"1";"10";"63";"64278"
"9";"3";"6";"10";"63";"64284"
"5";"0";"5";"10";"63";"64286"
"2";"1";"1";"10";"63";"64289"
"6";"1";"5";"10";"63";"64294"
"3";"1";"2";"10";"63";"64295"
"4";"2";"2";"10";"63";"64297"
"5";"3";"2";"10";"63";"64300"
"11";"5";"6";"10";"63";"64301"
"3";"1";"2";"10";"63";"64302"
"1";"1";"0";"10";"63";"64308"
"1";"1";"0";"10";"63";"64309"
"2";"0";"2";"10";"63";"64311"
"1";"0";"1";"10";"63";"64312"
"2";"0";"2";"10";"63";"64315"
"1";"1";"0";"10";"63";"64319"
"5";"2";"3";"10";"63";"64325"
"12";"2";"10";"10";"63";"64326"
"3";"0";"3";"10";"63";"64327"
"2";"0";"2";"10";"63";"64328"
"4";"2";"2";"10";"63";"64329"
"5";"1";"4";"10";"63";"64335"
"4";"1";"3";"10";"63";"64336"
"2";"0";"2";"10";"63";"64338"
"7";"1";"6";"10";"63";"64339"
"1";"0";"1";"10";"63";"64340"
"3";"0";"3";"10";"63";"64343"
"1";"0";"1";"10";"63";"64344"
"6";"0";"6";"10";"63";"64345"
"2";"0";"2";"10";"63";"64347"
"1";"0";"1";"10";"63";"64350"
"2";"0";"2";"10";"63";"64352"
"3";"0";"3";"10";"63";"64353"
"2";"0";"2";"10";"63";"64354"
"3";"1";"2";"10";"63";"64358"
"2";"2";"0";"10";"63";"64359"
"1";"0";"1";"10";"63";"64363"
"3";"1";"2";"10";"63";"64364"
"1";"0";"1";"10";"63";"64369"
"1";"0";"1";"10";"63";"64375"
"2";"0";"2";"10";"63";"64376"
"4";"1";"3";"10";"63";"64377"
"46";"32";"14";"10";"63";"64378"
"8";"2";"6";"10";"63";"64379"
"2";"1";"1";"10";"63";"64380"
"2";"0";"2";"10";"63";"64381"
"9";"2";"7";"10";"63";"64382"
"5";"2";"3";"10";"63";"64383"
"7";"3";"4";"10";"63";"64385"
"20";"6";"14";"10";"63";"64389"
"1";"0";"1";"10";"63";"64391"
"3";"1";"2";"10";"63";"64393"
"2";"1";"1";"10";"63";"64395"
"4";"1";"3";"10";"63";"64399"
"4";"0";"4";"10";"63";"64402"
"2";"0";"2";"10";"63";"64403"
"1";"1";"0";"10";"63";"64407"
"4";"0";"4";"10";"63";"64409"
"22";"7";"15";"10";"63";"64412"
"1";"1";"0";"10";"63";"64413"
"5";"1";"4";"10";"63";"64419"
"6";"2";"4";"10";"63";"64420"
"2";"0";"2";"10";"63";"64421"
"1";"0";"1";"10";"63";"64423"
"8";"2";"6";"10";"63";"64424"
"5";"1";"4";"10";"63";"64431"
"1";"0";"1";"10";"63";"64434"
"2";"0";"2";"10";"63";"64439"
"3";"0";"3";"10";"63";"64441"
"2";"1";"1";"10";"63";"64442"
"4";"0";"4";"10";"63";"64445"
"3";"1";"2";"10";"63";"64446"
"6";"3";"3";"10";"63";"64451"
"1";"0";"1";"10";"63";"64452"
"5";"1";"4";"10";"63";"64458"
"2";"0";"2";"10";"63";"64459"
"3";"0";"3";"10";"63";"64460"
"5";"1";"4";"10";"63";"64462"
"2";"0";"2";"10";"63";"64463"
"3";"1";"2";"10";"63";"64464"
"1";"0";"1";"10";"63";"64468"
"4";"2";"2";"10";"63";"64469"
"1";"0";"1";"10";"63";"64470"
"7";"1";"6";"10";"63";"64473"
"4";"1";"3";"10";"63";"64479"
"6";"1";"5";"10";"63";"64483"
"4";"1";"3";"10";"63";"64484"
"3";"0";"3";"10";"63";"64486"
"39";"21";"18";"10";"63";"64494"
"6";"1";"5";"10";"63";"64498"
"1";"1";"0";"10";"63";"64502"
"2";"0";"2";"10";"63";"64504"
"2";"1";"1";"10";"63";"64506"
"2";"1";"1";"10";"63";"64507"
"1";"0";"1";"10";"63";"64509"
"1";"0";"1";"10";"63";"64510"
"4";"1";"3";"10";"63";"64511"
"3";"1";"2";"10";"63";"64513"
"1";"0";"1";"10";"63";"64520"
"2";"1";"1";"10";"63";"64522"
"1";"0";"1";"10";"63";"64523"
"6";"1";"5";"10";"63";"64525"
"3";"1";"2";"10";"63";"64527"
"7";"2";"5";"10";"63";"64534"
"1";"0";"1";"10";"63";"64535"
"16";"6";"10";"10";"63";"64538"
"1";"0";"1";"10";"63";"64544"
"1";"0";"1";"10";"63";"64547"
"15";"3";"12";"10";"63";"64550"
"5";"2";"3";"10";"63";"64552"
"4";"0";"4";"10";"63";"64558"
"1";"0";"1";"10";"63";"64559"
"2";"1";"1";"10";"63";"64563"
"11";"4";"7";"10";"63";"64566"
"3";"0";"3";"10";"63";"64569"
"7";"2";"5";"10";"63";"64575"
"1";"1";"0";"10";"63";"64576"
"6";"0";"6";"10";"63";"64577"
"4";"1";"3";"10";"63";"64578"
"3";"1";"2";"10";"63";"64579"
"12";"0";"12";"10";"63";"64585"
"46";"15";"31";"10";"63";"64588"
"1";"1";"0";"10";"63";"64592"
"10";"4";"6";"10";"63";"64593"
"1";"1";"0";"10";"63";"64595"
"6";"1";"5";"10";"63";"64597"
"5";"0";"5";"10";"63";"64598"
"2";"0";"2";"10";"63";"64599"
"3";"1";"2";"10";"63";"64603"
"10";"8";"2";"10";"63";"64604"
"1";"1";"0";"10";"63";"64605"
"5";"3";"2";"10";"63";"64608"
"1";"1";"0";"10";"63";"64612"
"2";"0";"2";"10";"63";"64614"
"67";"26";"41";"10";"63";"64615"
"1";"0";"1";"10";"63";"64618"
"2";"0";"2";"10";"63";"64619"
"1";"1";"0";"10";"63";"64621"
"6";"2";"4";"10";"63";"64622"
"11";"0";"11";"10";"63";"64623"
"45";"18";"27";"10";"63";"64625"
"8";"0";"8";"10";"63";"64632"
"3";"1";"2";"10";"63";"64633"
"1";"1";"0";"10";"63";"64635"
"1";"1";"0";"10";"63";"64639"
"3";"0";"3";"10";"63";"64640"
"1";"1";"0";"10";"63";"64651"
"1";"1";"0";"10";"63";"64653"
"6";"2";"4";"10";"63";"64655"
"2";"1";"1";"10";"63";"64658"
"4";"2";"2";"10";"63";"64659"
"1";"1";"0";"10";"63";"64660"
"8";"3";"5";"10";"63";"64664"
"6";"2";"4";"10";"63";"64666"
"1";"0";"1";"10";"63";"64670"
"2";"1";"1";"10";"63";"64671"
"1";"0";"1";"10";"63";"64672"
"3";"2";"1";"10";"63";"64673"
"4";"0";"4";"10";"63";"64675"
"4";"1";"3";"10";"63";"64676"
"7";"2";"5";"10";"63";"64677"
"1";"1";"0";"10";"63";"64679"
"8";"1";"7";"10";"63";"64681"
"1";"1";"0";"10";"63";"64683"
"5";"0";"5";"10";"63";"64686"
"3";"0";"3";"10";"63";"64688"
"1";"1";"0";"10";"63";"64689"
"2";"0";"2";"10";"63";"64691"
"89";"53";"36";"10";"63";"64695"
"9";"1";"8";"10";"63";"64699"
"1";"0";"1";"10";"63";"64703"
"6";"3";"3";"10";"63";"64707"
"5";"2";"3";"10";"63";"64710"
"1";"1";"0";"10";"63";"64712"
"3";"1";"2";"10";"63";"64713"
"7";"3";"4";"10";"63";"64715"
"2";"0";"2";"10";"63";"64721"
"1";"1";"0";"10";"63";"64722"
"8";"1";"7";"10";"63";"64728"
"4";"1";"3";"10";"63";"64730"
"1";"0";"1";"10";"63";"64733"
"1";"0";"1";"10";"63";"64736"
"5";"0";"5";"10";"63";"64740"
"4";"0";"4";"10";"63";"64741"
"3";"0";"3";"10";"63";"64744"
"1";"1";"0";"10";"63";"64747"
"10";"3";"7";"10";"63";"64748"
"2";"1";"1";"10";"63";"64749"
"3";"1";"2";"10";"63";"64750"
"2";"2";"0";"10";"63";"64753"
"32";"24";"8";"10";"63";"64756"
"11";"4";"7";"10";"63";"64757"
"8";"4";"4";"10";"63";"64758"
"4";"0";"4";"10";"63";"64761"
"2";"1";"1";"10";"63";"64764"
"2";"1";"1";"10";"63";"64765"
"9";"1";"8";"10";"63";"64766"
"1";"0";"1";"10";"63";"64767"
"4";"1";"3";"10";"63";"64770"
"4";"1";"3";"10";"63";"64774"
"11";"2";"9";"10";"63";"64778"
"1";"0";"1";"10";"63";"64780"
"3";"0";"3";"10";"63";"64782"
"3";"1";"2";"10";"63";"64785"
"1";"0";"1";"10";"63";"64789"
"16";"1";"15";"10";"63";"64793"
"3";"1";"2";"10";"63";"64794"
"1";"1";"0";"10";"63";"64803"
"5";"1";"4";"10";"63";"64806"
"8";"4";"4";"10";"63";"64810"
"8";"3";"5";"10";"63";"64812"
"1";"0";"1";"10";"63";"64814"
"37";"7";"30";"10";"63";"64824"
"1";"1";"0";"10";"63";"64827"
"3";"1";"2";"10";"63";"64828"
"4";"0";"4";"10";"63";"64830"
"4";"0";"4";"10";"63";"64831"
"2";"1";"1";"10";"63";"64837"
"12";"3";"9";"10";"63";"64838"
"4";"1";"3";"10";"63";"64841"
"2";"2";"0";"10";"63";"64847"
"1";"1";"0";"10";"63";"64851"
"1";"1";"0";"10";"63";"64853"
"54";"30";"24";"10";"63";"64860"
"6";"1";"5";"10";"63";"64862"
"1";"0";"1";"10";"63";"64863"
"1";"0";"1";"10";"63";"64864"
"2";"0";"2";"10";"63";"64865"
"11";"4";"7";"10";"63";"64869"
"1";"0";"1";"10";"63";"64870"
"3";"0";"3";"10";"63";"64874"
"7";"2";"5";"10";"63";"64877"
"5";"1";"4";"10";"63";"64879"
"3";"0";"3";"10";"63";"64880"
"3";"0";"3";"10";"63";"64881"
"3";"1";"2";"10";"63";"64884"
"5";"1";"4";"10";"63";"64887"
"2";"2";"0";"10";"63";"64889"
"4";"1";"3";"10";"63";"64890"
"2";"0";"2";"10";"63";"64891"
"8";"5";"3";"10";"63";"64893"
"3";"0";"3";"10";"63";"64895"
"4";"1";"3";"10";"63";"64897"
"4";"1";"3";"10";"63";"64898"
"49";"49";"0";"10";"63";"64901"
"3";"1";"2";"10";"63";"64905"
"18";"9";"9";"10";"63";"64912"
"4";"1";"3";"10";"63";"64914"
"3";"1";"2";"10";"63";"64916"
"1";"1";"0";"10";"63";"64917"
"91";"18";"73";"10";"63";"64918"
"3";"1";"2";"10";"63";"64921"
"4";"0";"4";"10";"63";"64922"
"2";"1";"1";"10";"63";"64923"
"1";"1";"0";"10";"63";"64924"
"4";"1";"3";"10";"63";"64927"
"3";"1";"2";"10";"63";"64931"
"6";"3";"3";"10";"63";"64932"
"6";"1";"5";"10";"63";"64939"
"13";"1";"12";"10";"63";"64940"
"4";"0";"4";"10";"63";"64942"
"1";"1";"0";"10";"63";"64944"
"7";"2";"5";"10";"63";"64946"
"2";"0";"2";"10";"63";"64949"
"1";"1";"0";"10";"63";"64954"
"4";"2";"2";"10";"63";"64958"
"4";"0";"4";"10";"63";"64961"
"2";"0";"2";"10";"63";"64962"
"10";"3";"7";"10";"63";"64965"
"1";"1";"0";"10";"63";"64968"
"1";"0";"1";"10";"63";"64974"
"2";"0";"2";"10";"63";"64975"
"4";"1";"3";"10";"63";"64977"
"3";"0";"3";"10";"63";"64982"
"3";"1";"2";"10";"63";"64983"
"5";"3";"2";"10";"63";"64985"
"44";"12";"32";"10";"63";"64986"
"6";"2";"4";"10";"63";"64988"
"2";"1";"1";"10";"63";"64989"
"5";"1";"4";"10";"63";"64990"
"5";"1";"4";"10";"63";"64992"
"8";"1";"7";"10";"63";"64996"
"2";"0";"2";"10";"63";"64997"
"2";"1";"1";"10";"63";"64999"
"6";"2";"4";"10";"63";"65002"
"7";"1";"6";"10";"63";"65007"
"2";"1";"1";"10";"63";"65009"
"8";"2";"6";"10";"63";"65011"
"2";"1";"1";"10";"63";"65013"
"5";"1";"4";"10";"63";"65017"
"3";"0";"3";"10";"63";"65018"
"5";"2";"3";"10";"63";"65022"
"11";"6";"5";"10";"63";"65023"
"2";"0";"2";"10";"63";"65024"
"8";"1";"7";"10";"63";"65025"
"6";"2";"4";"10";"63";"65028"
"13";"4";"9";"10";"63";"65029"
"1";"0";"1";"10";"63";"65030"
"2";"0";"2";"10";"63";"65032"
"3";"2";"1";"10";"63";"65034"
"13";"5";"8";"10";"63";"65035"
"6";"2";"4";"10";"63";"65036"
"6";"2";"4";"10";"63";"65037"
"1";"0";"1";"10";"63";"65039"
"35";"16";"19";"10";"63";"65042"
"3";"1";"2";"10";"63";"65046"
"7";"3";"4";"10";"63";"65055"
"5";"2";"3";"10";"63";"65057"
"5";"1";"4";"10";"63";"65062"
"16";"5";"11";"10";"63";"65064"
"2";"1";"1";"10";"63";"65068"
"2";"0";"2";"10";"63";"65069"
"4";"0";"4";"10";"63";"65070"
"12";"5";"7";"10";"63";"65072"
"1";"1";"0";"10";"63";"65074"
"7";"3";"4";"10";"63";"65079"
"4";"1";"3";"10";"63";"65080"
"2";"0";"2";"10";"63";"65081"
"2";"0";"2";"10";"63";"65083"
"1";"0";"1";"10";"63";"65086"
"8";"1";"7";"10";"63";"65087"
"707";"612";"95";"10";"63";"65088"
"1";"0";"1";"10";"63";"65089"
"2";"1";"1";"10";"63";"65092"
"3";"1";"2";"10";"63";"65093"
"5";"1";"4";"10";"63";"65098"
"10";"5";"5";"10";"63";"65100"
"1";"0";"1";"10";"63";"65102"
"6";"2";"4";"10";"63";"65106"
"2";"1";"1";"10";"63";"65107"
"5";"1";"4";"10";"63";"65108"
"9";"3";"6";"10";"63";"65109"
"1";"1";"0";"10";"63";"65111"
"22";"5";"17";"10";"63";"65112"
"15";"4";"11";"10";"63";"65113"
"5";"1";"4";"10";"63";"65117"
"10";"4";"6";"10";"63";"65119"
"2";"0";"2";"10";"63";"65121"
"2";"0";"2";"10";"63";"65125"
"13";"4";"9";"10";"63";"65126"
"2";"0";"2";"10";"63";"65127"
"3";"0";"3";"10";"63";"65129"
"3";"1";"2";"10";"63";"65130"
"1";"0";"1";"10";"63";"65134"
"5";"1";"4";"10";"63";"65141"
"2";"0";"2";"10";"63";"65142"
"2";"0";"2";"10";"63";"65144"
"1";"0";"1";"10";"63";"65145"
"1";"1";"0";"10";"63";"65146"
"4";"0";"4";"10";"63";"65150"
"3";"0";"3";"10";"63";"65153"
"9";"2";"7";"10";"63";"65155"
"1";"0";"1";"10";"63";"65157"
"1";"0";"1";"10";"63";"65159"
"2";"1";"1";"10";"63";"65161"
"4";"0";"4";"10";"63";"65162"
"2";"1";"1";"10";"63";"65164"
"8";"2";"6";"10";"63";"65165"
"1";"0";"1";"10";"63";"65166"
"3";"1";"2";"10";"63";"65173"
"6";"1";"5";"10";"63";"65183"
"5";"3";"2";"10";"63";"65184"
"3";"0";"3";"10";"63";"65187"
"2";"0";"2";"10";"63";"65188"
"3";"1";"2";"10";"63";"65190"
"2";"0";"2";"10";"63";"65192"
"2";"0";"2";"10";"63";"65195"
"4";"1";"3";"10";"63";"65196"
"76";"55";"21";"10";"63";"65197"
"2";"0";"2";"10";"63";"65200"
"29";"17";"12";"10";"63";"65202"
"1";"1";"0";"10";"63";"65203"
"4";"1";"3";"10";"63";"65204"
"4";"1";"3";"10";"63";"65206"
"3";"1";"2";"10";"63";"65211"
"2";"1";"1";"10";"63";"65212"
"1";"0";"1";"10";"63";"65219"
"17";"5";"12";"10";"63";"65221"
"2";"1";"1";"10";"63";"65223"
"2";"2";"0";"10";"63";"65225"
"2";"0";"2";"10";"63";"65226"
"8";"2";"6";"10";"63";"65229"
"2";"0";"2";"10";"63";"65230"
"4";"0";"4";"10";"63";"65232"
"2";"1";"1";"10";"63";"65234"
"1";"0";"1";"10";"63";"65236"
"4";"1";"3";"10";"63";"65237"
"1";"1";"0";"10";"63";"65238"
"9";"1";"8";"10";"63";"65242"
"2";"0";"2";"10";"63";"65243"
"1";"0";"1";"10";"63";"65245"
"1";"1";"0";"10";"63";"65247"
"3";"0";"3";"10";"63";"65248"
"2";"1";"1";"10";"63";"65256"
"1";"1";"0";"10";"63";"65257"
"1";"0";"1";"10";"63";"65258"
"1";"0";"1";"10";"63";"65264"
"2";"0";"2";"10";"63";"65266"
"1";"1";"0";"10";"63";"65270"
"3";"1";"2";"10";"63";"65271"
"1";"0";"1";"10";"63";"65272"
"6";"0";"6";"10";"63";"65273"
"1";"1";"0";"10";"63";"65275"
"1";"0";"1";"10";"63";"65276"
"4";"1";"3";"10";"63";"65277"
"17";"14";"3";"10";"63";"65279"
"4";"2";"2";"10";"63";"65280"
"4";"0";"4";"10";"63";"65281"
"5";"3";"2";"10";"63";"65285"
"4";"0";"4";"10";"63";"65286"
"3";"1";"2";"10";"63";"65291"
"19";"8";"11";"10";"63";"65292"
"12";"2";"10";"10";"63";"65296"
"10";"1";"9";"10";"63";"65298"
"1";"1";"0";"10";"63";"65300"
"6";"1";"5";"10";"63";"65301"
"8";"1";"7";"10";"63";"65302"
"3";"0";"3";"10";"63";"65303"
"4";"0";"4";"10";"63";"65308"
"1";"0";"1";"10";"63";"65309"
"4";"2";"2";"10";"63";"65310"
"5";"1";"4";"10";"63";"65318"
"1";"0";"1";"10";"63";"65319"
"32";"22";"10";"10";"63";"65320"
"3";"1";"2";"10";"63";"65325"
"2";"0";"2";"10";"63";"65326"
"7";"2";"5";"10";"63";"65327"
"2";"0";"2";"10";"63";"65328"
"6";"1";"5";"10";"63";"65331"
"6";"2";"4";"10";"63";"65332"
"8";"1";"7";"10";"63";"65333"
"4";"0";"4";"10";"63";"65335"
"3";"1";"2";"10";"63";"65339"
"1";"0";"1";"10";"63";"65340"
"3";"3";"0";"10";"63";"65344"
"23";"3";"20";"10";"63";"65346"
"2";"0";"2";"10";"63";"65347"
"5";"1";"4";"10";"63";"65348"
"1";"1";"0";"10";"63";"65350"
"1";"0";"1";"10";"63";"65351"
"4";"1";"3";"10";"63";"65352"
"4";"1";"3";"10";"63";"65354"
"4";"0";"4";"10";"63";"65356"
"1";"1";"0";"10";"63";"65357"
"2";"1";"1";"10";"63";"65360"
"4";"0";"4";"10";"63";"65363"
"3";"1";"2";"10";"63";"65366"
"6";"2";"4";"10";"63";"65367"
"2";"0";"2";"10";"63";"65370"
"1";"1";"0";"10";"63";"65371"
"3";"2";"1";"10";"63";"65373"
"12";"2";"10";"10";"63";"65376"
"3";"1";"2";"10";"63";"65377"
"6";"0";"6";"10";"63";"65378"
"45";"10";"35";"10";"63";"65384"
"1";"0";"1";"10";"63";"65385"
"34";"3";"31";"10";"63";"65387"
"2";"1";"1";"10";"63";"65388"
"2";"0";"2";"10";"63";"65389"
"3";"1";"2";"10";"63";"65393"
"3";"0";"3";"10";"63";"65394"
"2";"0";"2";"10";"63";"65395"
"3";"0";"3";"10";"63";"65396"
"1";"0";"1";"10";"63";"65397"
"1";"1";"0";"10";"63";"65399"
"3";"1";"2";"10";"63";"65402"
"2";"2";"0";"10";"63";"65403"
"17";"7";"10";"10";"63";"65404"
"1";"1";"0";"10";"63";"65406"
"2";"1";"1";"10";"63";"65409"
"1";"0";"1";"10";"63";"65410"
"4";"0";"4";"10";"63";"65411"
"2";"0";"2";"10";"63";"65412"
"7";"5";"2";"10";"63";"65413"
"13";"5";"8";"10";"63";"65416"
"7";"1";"6";"10";"63";"65417"
"7";"1";"6";"10";"63";"65418"
"4";"2";"2";"10";"63";"65419"
"12";"3";"9";"10";"63";"65420"
"72";"50";"22";"10";"63";"65421"
"4";"0";"4";"10";"63";"65422"
"2";"1";"1";"10";"63";"65424"
"2";"1";"1";"10";"63";"65430"
"1";"0";"1";"10";"63";"65431"
"2";"2";"0";"10";"63";"65432"
"1";"1";"0";"10";"63";"65433"
"2";"0";"2";"10";"63";"65434"
"2";"2";"0";"10";"63";"65441"
"1";"1";"0";"10";"63";"65444"
"4";"1";"3";"10";"63";"65446"
"3";"1";"2";"10";"63";"65452"
"5";"3";"2";"10";"63";"65453"
"5";"3";"2";"10";"63";"65454"
"1";"1";"0";"10";"63";"65456"
"5";"1";"4";"10";"63";"65457"
"2";"1";"1";"10";"63";"65459"
"4";"0";"4";"10";"63";"65460"
"2";"0";"2";"10";"63";"65461"
"3";"0";"3";"10";"63";"65465"
"4";"0";"4";"10";"63";"65466"
"21";"15";"6";"10";"63";"65468"
"1";"1";"0";"10";"63";"65469"
"13";"3";"10";"10";"63";"65470"
"2";"0";"2";"10";"63";"65472"
"2";"0";"2";"10";"63";"65473"
"7";"0";"7";"10";"63";"65474"
"30";"19";"11";"10";"63";"65475"
"1";"1";"0";"10";"63";"65476"
"3";"1";"2";"10";"63";"65477"
"2";"1";"1";"10";"63";"65479"
"3";"0";"3";"10";"63";"65480"
"3";"2";"1";"10";"63";"65483"
"2";"0";"2";"10";"63";"65485"
"2";"0";"2";"10";"63";"65486"
"3";"0";"3";"10";"63";"65490"
"1";"0";"1";"10";"63";"65492"
"1";"0";"1";"10";"63";"65493"
"3";"1";"2";"10";"63";"65494"
"9";"0";"9";"10";"63";"65497"
"1";"1";"0";"10";"63";"65499"
"2";"0";"2";"10";"63";"65500"
"3";"1";"2";"10";"63";"65503"
"1";"1";"0";"10";"63";"65507"
"2";"0";"2";"10";"63";"65510"
"2";"0";"2";"10";"63";"65511"
"1";"1";"0";"10";"63";"65512"
"1";"0";"1";"10";"63";"65513"
"2";"2";"0";"10";"63";"65514"
"1";"1";"0";"10";"63";"65517"
"1";"1";"0";"10";"63";"65519"
"6";"1";"5";"10";"63";"65521"
"6";"1";"5";"10";"63";"65522"
"4";"2";"2";"10";"63";"65523"
"1";"1";"0";"10";"63";"65524"
"1";"0";"1";"10";"63";"65525"
"1";"0";"1";"10";"63";"65528"
"3";"0";"3";"10";"63";"65529"
"1";"0";"1";"10";"63";"65530"
"1";"0";"1";"10";"63";"65532"
"4";"3";"1";"10";"63";"65533"
"2";"1";"1";"10";"63";"65536"
"5";"1";"4";"10";"63";"65537"
"2";"0";"2";"10";"63";"65539"
"2";"1";"1";"10";"63";"65540"
"8";"2";"6";"10";"63";"65541"
"6";"3";"3";"10";"63";"65544"
"3";"1";"2";"10";"63";"65546"
"2";"1";"1";"10";"63";"65547"
"2";"1";"1";"10";"63";"65548"
"5";"0";"5";"10";"63";"65549"
"1";"0";"1";"10";"63";"65552"
"1";"0";"1";"10";"63";"65556"
"2";"0";"2";"10";"63";"65558"
"2";"0";"2";"10";"63";"65560"
"8";"1";"7";"10";"63";"65561"
"10";"1";"9";"10";"63";"65562"
"2";"1";"1";"10";"63";"65563"
"16";"10";"6";"10";"63";"65568"
"1";"0";"1";"10";"63";"65569"
"5";"1";"4";"10";"63";"65571"
"3";"0";"3";"10";"63";"65572"
"7";"1";"6";"10";"63";"65574"
"2";"0";"2";"10";"63";"65580"
"1";"1";"0";"10";"63";"65583"
"1";"1";"0";"10";"63";"65584"
"6";"1";"5";"10";"63";"65586"
"4";"1";"3";"10";"63";"65587"
"1";"1";"0";"10";"63";"65589"
"11";"2";"9";"10";"63";"65590"
"1";"1";"0";"10";"63";"65591"
"8";"2";"6";"10";"63";"65592"
"4";"0";"4";"10";"63";"65595"
"1";"1";"0";"10";"63";"65596"
"5";"1";"4";"10";"63";"65600"
"4";"1";"3";"10";"63";"65603"
"3";"1";"2";"10";"63";"65604"
"3";"1";"2";"10";"63";"65606"
"2";"0";"2";"10";"63";"65609"
"4";"1";"3";"10";"63";"65612"
"3";"1";"2";"10";"63";"65617"
"1";"1";"0";"10";"63";"65619"
"4";"1";"3";"10";"63";"65620"
"23";"5";"18";"10";"63";"65621"
"6";"2";"4";"10";"63";"65622"
"4";"1";"3";"10";"63";"65623"
"6";"2";"4";"10";"63";"65624"
"4";"0";"4";"10";"63";"65625"
"4";"0";"4";"10";"63";"65630"
"2";"1";"1";"10";"63";"65631"
"2";"0";"2";"10";"63";"65633"
"15";"2";"13";"10";"63";"65637"
"5";"0";"5";"10";"63";"65640"
"4";"1";"3";"10";"63";"65641"
"1";"1";"0";"10";"63";"65642"
"22";"9";"13";"10";"63";"65645"
"2";"0";"2";"10";"63";"65646"
"34";"9";"25";"10";"63";"65649"
"111";"86";"25";"10";"63";"65650"
"6";"1";"5";"10";"63";"65652"
"3";"1";"2";"10";"63";"65653"
"2";"1";"1";"10";"63";"65657"
"17";"5";"12";"10";"63";"65658"
"4";"2";"2";"10";"63";"65659"
"1";"1";"0";"10";"63";"65664"
"2";"1";"1";"10";"63";"65665"
"2";"0";"2";"10";"63";"65666"
"1";"1";"0";"10";"63";"65669"
"5";"0";"5";"10";"63";"65670"
"5";"0";"5";"10";"63";"65674"
"4";"3";"1";"10";"63";"65676"
"4";"1";"3";"10";"63";"65677"
"1";"0";"1";"10";"63";"65678"
"4";"2";"2";"10";"63";"65681"
"1";"0";"1";"10";"63";"65682"
"2";"0";"2";"10";"63";"65684"
"3";"1";"2";"10";"63";"65687"
"3";"1";"2";"10";"63";"65689"
"2";"0";"2";"10";"63";"65692"
"5";"1";"4";"10";"63";"65695"
"3";"0";"3";"10";"63";"65697"
"5";"1";"4";"10";"63";"65698"
"8";"4";"4";"10";"63";"65699"
"2";"1";"1";"10";"63";"65701"
"2";"1";"1";"10";"63";"65702"
"1";"0";"1";"10";"63";"65703"
"1";"1";"0";"10";"63";"65705"
"6";"1";"5";"10";"63";"65706"
"7";"2";"5";"10";"63";"65713"
"8";"2";"6";"10";"63";"65714"
"2";"0";"2";"10";"63";"65720"
"3";"1";"2";"10";"63";"65721"
"3";"0";"3";"10";"63";"65724"
"1";"0";"1";"10";"63";"65726"
"2";"1";"1";"10";"63";"65729"
"3";"1";"2";"10";"63";"65730"
"4";"2";"2";"10";"63";"65732"
"2";"0";"2";"10";"63";"65733"
"2";"0";"2";"10";"63";"65736"
"2";"1";"1";"10";"63";"65739"
"17";"7";"10";"10";"63";"65740"
"5";"0";"5";"10";"63";"65742"
"5";"3";"2";"10";"63";"65744"
"2";"1";"1";"10";"63";"65747"
"4";"0";"4";"10";"63";"65753"
"3";"2";"1";"10";"63";"65759"
"2";"1";"1";"10";"63";"65760"
"2";"1";"1";"10";"63";"65763"
"5";"0";"5";"10";"63";"65765"
"23";"8";"15";"10";"63";"65768"
"7";"2";"5";"10";"63";"65770"
"1";"0";"1";"10";"63";"65775"
"1";"0";"1";"10";"63";"65776"
"2";"1";"1";"10";"63";"65778"
"3";"0";"3";"10";"63";"65782"
"3";"1";"2";"10";"63";"65783"
"1";"1";"0";"10";"63";"65784"
"2";"0";"2";"10";"63";"65785"
"2";"0";"2";"10";"63";"65788"
"25";"17";"8";"10";"63";"65789"
"3";"1";"2";"10";"63";"65793"
"2";"0";"2";"10";"63";"65796"
"2";"1";"1";"10";"63";"65799"
"3";"1";"2";"10";"63";"65802"
"4";"1";"3";"10";"63";"65804"
"2";"1";"1";"10";"63";"65809"
"2";"1";"1";"10";"63";"65811"
"7";"2";"5";"10";"63";"65813"
"24";"4";"20";"10";"63";"65816"
"1";"1";"0";"10";"63";"65817"
"3";"0";"3";"10";"63";"65818"
"2";"0";"2";"10";"63";"65819"
"3";"0";"3";"10";"63";"65821"
"15";"7";"8";"10";"63";"65828"
"3";"0";"3";"10";"63";"65829"
"4";"1";"3";"10";"63";"65832"
"46";"18";"28";"10";"63";"65833"
"2";"1";"1";"10";"63";"65834"
"3";"2";"1";"10";"63";"65835"
"1";"1";"0";"10";"63";"65836"
"23";"3";"20";"10";"63";"65837"
"59";"17";"42";"10";"63";"65841"
"12";"2";"10";"10";"63";"65843"
"7";"3";"4";"10";"63";"65845"
"16";"3";"13";"10";"63";"65846"
"11";"1";"10";"10";"63";"65848"
"10";"6";"4";"10";"63";"65853"
"5";"1";"4";"10";"63";"65854"
"10";"7";"3";"10";"63";"65857"
"2";"0";"2";"10";"63";"65862"
"4";"0";"4";"10";"63";"65863"
"2";"2";"0";"10";"63";"65866"
"5";"2";"3";"10";"63";"65867"
"2";"0";"2";"10";"63";"65870"
"10";"2";"8";"10";"63";"65872"
"43";"23";"20";"10";"63";"65873"
"1";"0";"1";"10";"63";"65875"
"2";"0";"2";"10";"63";"65876"
"1";"1";"0";"10";"63";"65880"
"2";"1";"1";"10";"63";"65882"
"2";"1";"1";"10";"63";"65884"
"12";"2";"10";"10";"63";"65886"
"2";"0";"2";"10";"63";"65889"
"24";"3";"21";"10";"63";"65893"
"3";"0";"3";"10";"63";"65895"
"8";"2";"6";"10";"63";"65896"
"101";"21";"80";"10";"63";"65899"
"2";"0";"2";"10";"63";"65903"
"1";"1";"0";"10";"63";"65904"
"6";"2";"4";"10";"63";"65905"
"2";"0";"2";"10";"63";"65908"
"7";"1";"6";"10";"63";"65909"
"13";"4";"9";"10";"63";"65913"
"1";"0";"1";"10";"63";"65914"
"9";"3";"6";"10";"63";"65915"
"9";"1";"8";"10";"63";"65919"
"1";"1";"0";"10";"63";"65923"
"2";"1";"1";"10";"63";"65925"
"5";"0";"5";"10";"63";"65927"
"3";"0";"3";"10";"63";"65933"
"2";"1";"1";"10";"63";"65934"
"2";"1";"1";"10";"63";"65935"
"3";"1";"2";"10";"63";"65937"
"1";"0";"1";"10";"63";"65938"
"2";"2";"0";"10";"63";"65939"
"1";"0";"1";"10";"63";"65940"
"3";"0";"3";"10";"63";"65943"
"4";"1";"3";"10";"63";"65944"
"3";"0";"3";"10";"63";"65945"
"2";"0";"2";"10";"63";"65948"
"25";"11";"14";"10";"63";"65950"
"1";"0";"1";"10";"63";"65952"
"11";"1";"10";"10";"63";"65954"
"1";"0";"1";"10";"63";"65960"
"1";"1";"0";"10";"63";"65961"
"12";"3";"9";"10";"63";"65963"
"3";"0";"3";"10";"63";"65965"
"2";"0";"2";"10";"63";"65966"
"18";"8";"10";"10";"63";"65968"
"4";"0";"4";"10";"63";"65969"
"6";"2";"4";"10";"63";"65970"
"1";"0";"1";"10";"63";"65973"
"3";"0";"3";"10";"63";"65974"
"1";"0";"1";"10";"63";"65975"
"4";"1";"3";"10";"63";"65977"
"5";"1";"4";"10";"63";"65978"
"2";"0";"2";"10";"63";"65979"
"4";"0";"4";"10";"63";"65982"
"2";"0";"2";"10";"63";"65983"
"2";"1";"1";"10";"63";"65984"
"2";"0";"2";"10";"63";"65985"
"4";"1";"3";"10";"63";"65986"
"1";"1";"0";"10";"63";"65994"
"5";"0";"5";"10";"63";"65998"
"5";"1";"4";"10";"63";"66000"
"2";"0";"2";"10";"63";"66001"
"2";"0";"2";"10";"63";"66004"
"1";"0";"1";"10";"63";"66007"
"9";"3";"6";"10";"63";"66012"
"7";"4";"3";"10";"63";"66016"
"9";"4";"5";"10";"63";"66017"
"3";"2";"1";"10";"63";"66023"
"3";"1";"2";"10";"63";"66025"
"2";"0";"2";"10";"63";"66028"
"3";"0";"3";"10";"63";"66030"
"2";"1";"1";"10";"63";"66031"
"1";"0";"1";"10";"63";"66032"
"3";"1";"2";"10";"63";"66034"
"1";"1";"0";"10";"63";"66035"
"165";"108";"57";"10";"63";"66036"
"10";"3";"7";"10";"63";"66039"
"1";"1";"0";"10";"63";"66040"
"5";"2";"3";"10";"63";"66041"
"3";"0";"3";"10";"63";"66043"
"2";"1";"1";"10";"63";"66044"
"4";"0";"4";"10";"63";"66045"
"3";"1";"2";"10";"63";"66046"
"99";"83";"16";"10";"63";"66050"
"4";"0";"4";"10";"63";"66051"
"3";"0";"3";"10";"63";"66052"
"2";"0";"2";"10";"63";"66053"
"3";"1";"2";"10";"63";"66054"
"3";"0";"3";"10";"63";"66056"
"2";"2";"0";"10";"63";"66057"
"1";"1";"0";"10";"63";"66058"
"15";"2";"13";"10";"63";"66059"
"2";"0";"2";"10";"63";"66060"
"1";"1";"0";"10";"63";"66065"
"1";"0";"1";"10";"63";"66066"
"3";"0";"3";"10";"63";"66068"
"2";"0";"2";"10";"63";"66069"
"4";"0";"4";"10";"63";"66070"
"15";"8";"7";"10";"63";"66071"
"8";"2";"6";"10";"63";"66072"
"2";"1";"1";"10";"63";"66074"
"43";"14";"29";"10";"63";"66076"
"6";"1";"5";"10";"63";"66078"
"16";"3";"13";"10";"63";"66080"
"7";"2";"5";"10";"63";"66083"
"10";"4";"6";"10";"63";"66086"
"6";"1";"5";"10";"63";"66089"
"1";"1";"0";"10";"63";"66090"
"1";"1";"0";"10";"63";"66094"
"38";"12";"26";"10";"63";"66099"
"2";"0";"2";"10";"63";"66100"
"7";"2";"5";"10";"63";"66102"
"1";"1";"0";"10";"63";"66105"
"1";"0";"1";"10";"63";"66107"
"9";"2";"7";"10";"63";"66111"
"74";"45";"29";"10";"63";"66114"
"2";"1";"1";"10";"63";"66115"
"13";"5";"8";"10";"63";"66119"
"1";"0";"1";"10";"63";"66121"
"5";"0";"5";"10";"63";"66122"
"1";"0";"1";"10";"63";"66123"
"4";"0";"4";"10";"63";"66130"
"32";"6";"26";"10";"63";"66133"
"9";"5";"4";"10";"63";"66137"
"8";"2";"6";"10";"63";"66138"
"2";"1";"1";"10";"63";"66140"
"1";"0";"1";"10";"63";"66141"
"4";"1";"3";"10";"63";"66142"
"19";"3";"16";"10";"63";"66143"
"4";"1";"3";"10";"63";"66145"
"1";"0";"1";"10";"63";"66148"
"7";"5";"2";"10";"63";"66149"
"3";"1";"2";"10";"63";"66150"
"9";"1";"8";"10";"63";"66151"
"3";"0";"3";"10";"63";"66153"
"2";"1";"1";"10";"63";"66154"
"17";"4";"13";"10";"63";"66157"
"80";"56";"24";"10";"63";"66160"
"1";"1";"0";"10";"63";"66162"
"1";"1";"0";"10";"63";"66164"
"4";"1";"3";"10";"63";"66166"
"3";"0";"3";"10";"63";"66171"
"5";"0";"5";"10";"63";"66173"
"3";"2";"1";"10";"63";"66174"
"1";"1";"0";"10";"63";"66175"
"1";"0";"1";"10";"63";"66176"
"16";"1";"15";"10";"63";"66179"
"5";"1";"4";"10";"63";"66181"
"3";"0";"3";"10";"63";"66185"
"4";"2";"2";"10";"63";"66186"
"3";"1";"2";"10";"63";"66188"
"6";"1";"5";"10";"63";"66189"
"1";"0";"1";"10";"63";"66190"
"2";"0";"2";"10";"63";"66192"
"3";"2";"1";"10";"63";"66193"
"2";"0";"2";"10";"63";"66194"
"5";"0";"5";"10";"63";"66195"
"6";"2";"4";"10";"63";"66196"
"1";"0";"1";"10";"63";"66198"
"8";"2";"6";"10";"63";"66199"
"4";"1";"3";"10";"63";"66201"
"3";"0";"3";"10";"63";"66202"
"3";"0";"3";"10";"63";"66204"
"4";"1";"3";"10";"63";"66207"
"5";"2";"3";"10";"63";"66208"
"14";"8";"6";"10";"63";"66209"
"1";"1";"0";"10";"63";"66210"
"3";"0";"3";"10";"63";"66212"
"8";"3";"5";"10";"63";"66213"
"3";"0";"3";"10";"63";"66214"
"1";"1";"0";"10";"63";"66215"
"1";"1";"0";"10";"63";"66220"
"5";"0";"5";"10";"63";"66221"
"60";"30";"30";"10";"63";"66227"
"7";"4";"3";"10";"63";"66229"
"2";"0";"2";"10";"63";"66235"
"8";"5";"3";"10";"63";"66237"
"1";"0";"1";"10";"63";"66240"
"5";"1";"4";"10";"63";"66243"
"3";"0";"3";"10";"63";"66249"
"4";"4";"0";"10";"63";"66250"
"1";"1";"0";"10";"63";"66251"
"7";"2";"5";"10";"63";"66254"
"2";"1";"1";"10";"63";"66256"
"5";"1";"4";"10";"63";"66259"
"3";"0";"3";"10";"63";"66260"
"4";"0";"4";"10";"63";"66262"
"2";"0";"2";"10";"63";"66263"
"5";"1";"4";"10";"63";"66267"
"3";"0";"3";"10";"63";"66271"
"2";"0";"2";"10";"63";"66273"
"2";"0";"2";"10";"63";"66274"
"8";"3";"5";"10";"63";"66275"
"1";"1";"0";"10";"63";"66281"
"3";"1";"2";"10";"63";"66286"
"25";"7";"18";"10";"63";"66287"
"4";"4";"0";"10";"63";"66288"
"8";"2";"6";"10";"63";"66290"
"1";"0";"1";"10";"63";"66294"
"4";"0";"4";"10";"63";"66295"
"1";"0";"1";"10";"63";"66304"
"1";"0";"1";"10";"63";"66307"
"3";"0";"3";"10";"63";"66309"
"6";"2";"4";"10";"63";"66312"
"13";"8";"5";"10";"63";"66313"
"1";"0";"1";"10";"63";"66314"
"91";"28";"63";"10";"63";"66316"
"5";"3";"2";"10";"63";"66317"
"6";"1";"5";"10";"63";"66319"
"6";"1";"5";"10";"63";"66325"
"3";"0";"3";"10";"63";"66327"
"1";"0";"1";"10";"63";"66328"
"7";"1";"6";"10";"63";"66329"
"3";"1";"2";"10";"63";"66335"
"50";"31";"19";"10";"63";"66336"
"2";"1";"1";"10";"63";"66339"
"1";"1";"0";"10";"63";"66342"
"2";"0";"2";"10";"63";"66343"
"1";"0";"1";"10";"63";"66346"
"10";"1";"9";"10";"63";"66349"
"3";"0";"3";"10";"63";"66352"
"4";"3";"1";"10";"63";"66356"
"4";"1";"3";"10";"63";"66362"
"3";"2";"1";"10";"63";"66366"
"5";"0";"5";"10";"63";"66368"
"2";"1";"1";"10";"63";"66369"
"4";"1";"3";"10";"63";"66371"
"3";"1";"2";"10";"63";"66372"
"14";"3";"11";"10";"63";"66373"
"6";"1";"5";"10";"63";"66381"
"6";"3";"3";"10";"63";"66385"
"1";"0";"1";"10";"63";"66387"
"3";"0";"3";"10";"63";"66391"
"12";"3";"9";"10";"63";"66393"
"2";"1";"1";"10";"63";"66394"
"1";"0";"1";"10";"63";"66395"
"5";"2";"3";"10";"63";"66396"
"31";"6";"25";"10";"63";"66399"
"4";"0";"4";"10";"63";"66402"
"2";"1";"1";"10";"63";"66403"
"2";"1";"1";"10";"63";"66405"
"2";"1";"1";"10";"63";"66406"
"2";"0";"2";"10";"63";"66407"
"6";"1";"5";"10";"63";"66414"
"1";"0";"1";"10";"63";"66416"
"1";"0";"1";"10";"63";"66423"
"15";"2";"13";"10";"63";"66425"
"1";"1";"0";"10";"63";"66426"
"3";"1";"2";"10";"63";"66428"
"1";"0";"1";"10";"63";"66429"
"3";"1";"2";"10";"63";"66434"
"1";"0";"1";"10";"63";"66435"
"3";"1";"2";"10";"63";"66441"
"40";"10";"30";"10";"63";"66444"
"10";"2";"8";"10";"63";"66445"
"3";"0";"3";"10";"63";"66449"
"19";"15";"4";"10";"63";"66451"
"15";"1";"14";"10";"63";"66457"
"4";"4";"0";"10";"63";"66458"
"19";"12";"7";"10";"63";"66459"
"2";"0";"2";"10";"63";"66462"
"5";"0";"5";"10";"63";"66463"
"5";"2";"3";"10";"63";"66465"
"4";"1";"3";"10";"63";"66466"
"2";"1";"1";"10";"63";"66468"
"15";"12";"3";"10";"63";"66470"
"13";"11";"2";"10";"63";"66471"
"2";"0";"2";"10";"63";"66475"
"2";"0";"2";"10";"63";"66476"
"1";"0";"1";"10";"63";"66477"
"8";"3";"5";"10";"63";"66479"
"3";"0";"3";"10";"63";"66486"
"3";"0";"3";"10";"63";"66487"
"1";"1";"0";"10";"63";"66489"
"3";"1";"2";"10";"63";"66491"
"3";"0";"3";"10";"63";"66495"
"1";"0";"1";"10";"63";"66496"
"22";"2";"20";"10";"63";"66499"
"7";"3";"4";"10";"63";"66502"
"4";"0";"4";"10";"63";"66503"
"13";"9";"4";"10";"63";"66505"
"2";"0";"2";"10";"63";"66506"
"9";"2";"7";"10";"63";"66508"
"5";"1";"4";"10";"63";"66511"
"3";"0";"3";"10";"63";"66513"
"6";"2";"4";"10";"63";"66515"
"4";"1";"3";"10";"63";"66518"
"1";"0";"1";"10";"63";"66520"
"4";"1";"3";"10";"63";"66522"
"2";"0";"2";"10";"63";"66523"
"9";"0";"9";"10";"63";"66526"
"1";"0";"1";"10";"63";"66527"
"7";"2";"5";"10";"63";"66528"
"1";"1";"0";"10";"63";"66529"
"1";"1";"0";"10";"63";"66533"
"2";"1";"1";"10";"63";"66535"
"5";"2";"3";"10";"63";"66537"
"8";"3";"5";"10";"63";"66546"
"4";"1";"3";"10";"63";"66547"
"5";"5";"0";"10";"63";"66548"
"1";"0";"1";"10";"63";"66549"
"40";"7";"33";"10";"63";"66550"
"8";"6";"2";"10";"63";"66557"
"16";"2";"14";"10";"63";"66558"
"4";"1";"3";"10";"63";"66564"
"1";"1";"0";"10";"63";"66566"
"4";"1";"3";"10";"63";"66573"
"16";"5";"11";"10";"63";"66574"
"50";"18";"32";"10";"63";"66575"
"12";"1";"11";"10";"63";"66576"
"1";"0";"1";"10";"63";"66578"
"1";"0";"1";"10";"63";"66579"
"3";"0";"3";"10";"63";"66580"
"4";"0";"4";"10";"63";"66582"
"10";"4";"6";"10";"63";"66587"
"27";"18";"9";"10";"63";"66588"
"10";"6";"4";"10";"63";"66589"
"1";"0";"1";"10";"63";"66599"
"1";"0";"1";"10";"63";"66603"
"2";"0";"2";"10";"63";"66606"
"4";"1";"3";"10";"63";"66607"
"2";"2";"0";"10";"63";"66609"
"1";"1";"0";"10";"63";"66610"
"5";"2";"3";"10";"63";"66612"
"3";"0";"3";"10";"63";"66614"
"7";"1";"6";"10";"63";"66616"
"2";"1";"1";"10";"63";"66617"
"41";"24";"17";"10";"63";"66618"
"2";"1";"1";"10";"63";"66620"
"1";"1";"0";"10";"63";"66621"
"7";"2";"5";"10";"63";"66622"
"11";"5";"6";"10";"63";"66623"
"1";"1";"0";"10";"63";"66625"
"2";"1";"1";"10";"63";"66630"
"8";"1";"7";"10";"63";"66631"
"2";"0";"2";"10";"63";"66632"
"2";"0";"2";"10";"63";"66633"
"4";"0";"4";"10";"63";"66636"
"9";"3";"6";"10";"63";"66637"
"5";"2";"3";"10";"63";"66639"
"13";"3";"10";"10";"63";"66645"
"3";"0";"3";"10";"63";"66647"
"5";"1";"4";"10";"63";"66653"
"7";"0";"7";"10";"63";"66654"
"2";"1";"1";"10";"63";"66655"
"21";"15";"6";"10";"63";"66656"
"4";"1";"3";"10";"63";"66658"
"1";"0";"1";"10";"63";"66659"
"7";"1";"6";"10";"63";"66664"
"2";"0";"2";"10";"63";"66666"
"4";"1";"3";"10";"63";"66667"
"1";"1";"0";"10";"63";"66672"
"3";"0";"3";"10";"63";"66673"
"1";"0";"1";"10";"63";"66675"
"4";"1";"3";"10";"63";"66678"
"1";"0";"1";"10";"63";"66679"
"1";"0";"1";"10";"63";"66680"
"3";"1";"2";"10";"63";"66681"
"2";"1";"1";"10";"63";"66682"
"1";"0";"1";"10";"63";"66688"
"26";"19";"7";"10";"63";"66689"
"21";"16";"5";"10";"63";"66690"
"12";"4";"8";"10";"63";"66691"
"257";"112";"145";"10";"63";"66693"
"4";"1";"3";"10";"63";"66694"
"1";"0";"1";"10";"63";"66695"
"15";"2";"13";"10";"63";"66697"
"2";"1";"1";"10";"63";"66698"
"6";"0";"6";"10";"63";"66699"
"2";"0";"2";"10";"63";"66701"
"5";"1";"4";"10";"63";"66703"
"1";"0";"1";"10";"63";"66705"
"1";"1";"0";"10";"63";"66706"
"1";"1";"0";"10";"63";"66710"
"11";"3";"8";"10";"63";"66714"
"7";"1";"6";"10";"63";"66715"
"4";"1";"3";"10";"63";"66716"
"4";"1";"3";"10";"63";"66721"
"9";"3";"6";"10";"63";"66723"
"2";"2";"0";"10";"63";"66725"
"11";"2";"9";"10";"63";"66726"
"1";"0";"1";"10";"63";"66727"
"2";"1";"1";"10";"63";"66729"
"2";"0";"2";"10";"63";"66730"
"4";"2";"2";"10";"63";"66734"
"4";"0";"4";"10";"63";"66736"
"7";"5";"2";"10";"63";"66737"
"9";"5";"4";"10";"63";"66738"
"2";"0";"2";"10";"63";"66739"
"6";"1";"5";"10";"63";"66742"
"1";"0";"1";"10";"63";"66743"
"1";"1";"0";"10";"63";"66745"
"3";"1";"2";"10";"63";"66748"
"1";"0";"1";"10";"63";"66750"
"1";"1";"0";"10";"63";"66753"
"5";"2";"3";"10";"63";"66756"
"3";"1";"2";"10";"63";"66757"
"2";"0";"2";"10";"63";"66759"
"1";"1";"0";"10";"63";"66764"
"14";"3";"11";"10";"63";"66770"
"4";"2";"2";"10";"63";"66771"
"2";"1";"1";"10";"63";"66772"
"6";"2";"4";"10";"63";"66776"
"2";"0";"2";"10";"63";"66778"
"5";"0";"5";"10";"63";"66783"
"6";"1";"5";"10";"63";"66785"
"7";"3";"4";"10";"63";"66788"
"2";"0";"2";"10";"63";"66789"
"2";"0";"2";"10";"63";"66790"
"1";"0";"1";"10";"63";"66791"
"3";"0";"3";"10";"63";"66794"
"1";"0";"1";"10";"63";"66796"
"1";"0";"1";"10";"63";"66803"
"2";"0";"2";"10";"63";"66807"
"7";"2";"5";"10";"63";"66808"
"4";"0";"4";"10";"63";"66813"
"1";"1";"0";"10";"63";"66815"
"2";"0";"2";"10";"63";"66817"
"4";"1";"3";"10";"63";"66819"
"4";"1";"3";"10";"63";"66820"
"2";"0";"2";"10";"63";"66821"
"3";"1";"2";"10";"63";"66822"
"4";"1";"3";"10";"63";"66824"
"2";"0";"2";"10";"63";"66825"
"2";"1";"1";"10";"63";"66827"
"5";"2";"3";"10";"63";"66828"
"2";"0";"2";"10";"63";"66829"
"15";"9";"6";"10";"63";"66832"
"1";"0";"1";"10";"63";"66833"
"4";"1";"3";"10";"63";"66834"
"15";"6";"9";"10";"63";"66837"
"1";"1";"0";"10";"63";"66839"
"5";"1";"4";"10";"63";"66842"
"1";"0";"1";"10";"63";"66843"
"6";"0";"6";"10";"63";"66844"
"5";"0";"5";"10";"63";"66848"
"9";"4";"5";"10";"63";"66854"
"4";"3";"1";"10";"63";"66855"
"2";"0";"2";"10";"63";"66857"
"3";"0";"3";"10";"63";"66861"
"4";"1";"3";"10";"63";"66862"
"3";"1";"2";"10";"63";"66863"
"1";"0";"1";"10";"63";"66867"
"3";"0";"3";"10";"63";"66868"
"2";"0";"2";"10";"63";"66869"
"51";"29";"22";"10";"63";"66871"
"19";"10";"9";"10";"63";"66874"
"4";"0";"4";"10";"63";"66878"
"6";"0";"6";"10";"63";"66879"
"2";"1";"1";"10";"63";"66885"
"3";"2";"1";"10";"63";"66887"
"4";"0";"4";"10";"63";"66889"
"5";"2";"3";"10";"63";"66893"
"6";"1";"5";"10";"63";"66894"
"17";"8";"9";"10";"63";"66898"
"2";"1";"1";"10";"63";"66900"
"3";"1";"2";"10";"63";"66902"
"8";"1";"7";"10";"63";"66905"
"1";"0";"1";"10";"63";"66906"
"92";"44";"48";"10";"63";"66908"
"10";"3";"7";"10";"63";"66909"
"3";"0";"3";"10";"63";"66910"
"4";"0";"4";"10";"63";"66918"
"3";"1";"2";"10";"63";"66919"
"37";"27";"10";"10";"63";"66920"
"5";"1";"4";"10";"63";"66921"
"1";"0";"1";"10";"63";"66922"
"2";"1";"1";"10";"63";"66925"
"16";"8";"8";"10";"63";"66927"
"3";"0";"3";"10";"63";"66928"
"9";"2";"7";"10";"63";"66929"
"5";"3";"2";"10";"63";"66930"
"5";"2";"3";"10";"63";"66933"
"293";"229";"64";"10";"63";"66934"
"1";"0";"1";"10";"63";"66935"
"3";"0";"3";"10";"63";"66937"
"4";"1";"3";"10";"63";"66938"
"3";"1";"2";"10";"63";"66939"
"1";"1";"0";"10";"63";"66941"
"4";"1";"3";"10";"63";"66942"
"3";"1";"2";"10";"63";"66945"
"4";"1";"3";"10";"63";"66946"
"6";"1";"5";"10";"63";"66948"
"5";"1";"4";"10";"63";"66949"
"6";"2";"4";"10";"63";"66950"
"3";"1";"2";"10";"63";"66951"
"1";"1";"0";"10";"63";"66952"
"3";"0";"3";"10";"63";"66954"
"1";"0";"1";"10";"63";"66955"
"5";"0";"5";"10";"63";"66956"
"3";"1";"2";"10";"63";"66957"
"3";"0";"3";"10";"63";"66958"
"1";"1";"0";"10";"63";"66960"
"1";"1";"0";"10";"63";"66961"
"7";"1";"6";"10";"63";"66966"
"5";"1";"4";"10";"63";"66967"
"2";"1";"1";"10";"63";"66974"
"4";"1";"3";"10";"63";"66975"
"1";"1";"0";"10";"63";"66976"
"3";"0";"3";"10";"63";"66977"
"9";"3";"6";"10";"63";"66980"
"13";"3";"10";"10";"63";"66981"
"2";"1";"1";"10";"63";"66982"
"8";"0";"8";"10";"63";"66983"
"2";"1";"1";"10";"63";"66984"
"4";"1";"3";"10";"63";"66985"
"5";"0";"5";"10";"63";"66994"
"4";"1";"3";"10";"63";"66996"
"3";"0";"3";"10";"63";"66997"
"4";"0";"4";"10";"63";"66998"
"10";"2";"8";"10";"63";"66999"
"1";"1";"0";"10";"63";"67000"
"4";"1";"3";"10";"63";"67005"
"2";"0";"2";"10";"63";"67006"
"7";"2";"5";"10";"63";"67008"
"2";"0";"2";"10";"63";"67009"
"7";"1";"6";"10";"63";"67010"
"9";"2";"7";"10";"63";"67011"
"2";"0";"2";"10";"63";"67013"
"4";"0";"4";"10";"63";"67014"
"13";"3";"10";"10";"63";"67015"
"5";"1";"4";"10";"63";"67018"
"6";"2";"4";"10";"63";"67021"
"1";"0";"1";"10";"63";"67022"
"1";"0";"1";"10";"63";"67023"
"1";"1";"0";"10";"63";"67024"
"2";"2";"0";"10";"63";"67026"
"1";"1";"0";"10";"63";"67027"
"2";"1";"1";"10";"63";"67028"
"14";"2";"12";"10";"63";"67029"
"3";"1";"2";"10";"63";"67031"
"1";"1";"0";"10";"63";"67032"
"9";"2";"7";"10";"63";"67034"
"2";"1";"1";"10";"63";"67037"
"3";"1";"2";"10";"63";"67039"
"3";"2";"1";"10";"63";"67040"
"4";"1";"3";"10";"63";"67043"
"1";"1";"0";"10";"63";"67044"
"1";"1";"0";"10";"63";"67045"
"4";"1";"3";"10";"63";"67046"
"6";"2";"4";"10";"63";"67048"
"1";"0";"1";"10";"63";"67049"
"2";"0";"2";"10";"63";"67052"
"6";"2";"4";"10";"63";"67056"
"1";"0";"1";"10";"63";"67063"
"2";"0";"2";"10";"63";"67067"
"3";"1";"2";"10";"63";"67076"
"2";"1";"1";"10";"63";"67078"
"3";"1";"2";"10";"63";"67079"
"8";"0";"8";"10";"63";"67080"
"5";"2";"3";"10";"63";"67087"
"2";"0";"2";"10";"63";"67088"
"6";"1";"5";"10";"63";"67090"
"3";"0";"3";"10";"63";"67091"
"13";"1";"12";"10";"63";"67093"
"10";"2";"8";"10";"63";"67094"
"4";"1";"3";"10";"63";"67096"
"6";"1";"5";"10";"63";"67097"
"2";"0";"2";"10";"63";"67101"
"1";"0";"1";"10";"63";"67102"
"4";"0";"4";"10";"63";"67103"
"6";"1";"5";"10";"63";"67105"
"5";"1";"4";"10";"63";"67106"
"4";"1";"3";"10";"63";"67110"
"3";"0";"3";"10";"63";"67115"
"6";"1";"5";"10";"63";"67116"
"2";"1";"1";"10";"63";"67117"
"2";"0";"2";"10";"63";"67118"
"2";"1";"1";"10";"63";"67120"
"4";"0";"4";"10";"63";"67123"
"1";"0";"1";"10";"63";"67130"
"10";"1";"9";"10";"63";"67131"
"2";"1";"1";"10";"63";"67133"
"1";"0";"1";"10";"63";"67134"
"3";"1";"2";"10";"63";"67135"
"2";"0";"2";"10";"63";"67136"
"1";"0";"1";"10";"63";"67137"
"15";"3";"12";"10";"63";"67138"
"11";"5";"6";"10";"63";"67142"
"17";"1";"16";"10";"63";"67144"
"4";"0";"4";"10";"63";"67146"
"1";"1";"0";"10";"63";"67147"
"1";"0";"1";"10";"63";"67149"
"38";"13";"25";"10";"63";"67150"
"4";"1";"3";"10";"63";"67151"
"2";"0";"2";"10";"63";"67158"
"3";"1";"2";"10";"63";"67159"
"4";"2";"2";"10";"63";"67161"
"2";"0";"2";"10";"63";"67164"
"3";"0";"3";"10";"63";"67166"
"5";"1";"4";"10";"63";"67167"
"7";"2";"5";"10";"63";"67168"
"15";"2";"13";"10";"63";"67170"
"3";"1";"2";"10";"63";"67176"
"1";"1";"0";"10";"63";"67177"
"2";"1";"1";"10";"63";"67181"
"1";"0";"1";"10";"63";"67184"
"2";"0";"2";"10";"63";"67186"
"1";"0";"1";"10";"63";"67187"
"11";"1";"10";"10";"63";"67188"
"4";"1";"3";"10";"63";"67192"
"2";"1";"1";"10";"63";"67194"
"2";"0";"2";"10";"63";"67196"
"2";"0";"2";"10";"63";"67199"
"1";"1";"0";"10";"63";"67200"
"1";"1";"0";"10";"63";"67201"
"5";"1";"4";"10";"63";"67202"
"5";"1";"4";"10";"63";"67206"
"6";"2";"4";"10";"63";"67208"
"2";"0";"2";"10";"63";"67209"
"2";"1";"1";"10";"63";"67210"
"2";"1";"1";"10";"63";"67215"
"7";"0";"7";"10";"63";"67216"
"1";"0";"1";"10";"63";"67219"
"4";"4";"0";"10";"63";"67220"
"2";"1";"1";"10";"63";"67221"
"8";"1";"7";"10";"63";"67222"
"4";"2";"2";"10";"63";"67223"
"4";"1";"3";"10";"63";"67226"
"7";"1";"6";"10";"63";"67227"
"2";"0";"2";"10";"63";"67228"
"5";"0";"5";"10";"63";"67230"
"3";"1";"2";"10";"63";"67231"
"6";"2";"4";"10";"63";"67232"
"2";"0";"2";"10";"63";"67233"
"1";"1";"0";"10";"63";"67234"
"5";"1";"4";"10";"63";"67237"
"4";"1";"3";"10";"63";"67239"
"1";"1";"0";"10";"63";"67241"
"60";"36";"24";"10";"63";"67242"
"18";"8";"10";"10";"63";"67244"
"3";"1";"2";"10";"63";"67246"
"14";"3";"11";"10";"63";"67249"
"3";"0";"3";"10";"63";"67253"
"1";"0";"1";"10";"63";"67254"
"5";"1";"4";"10";"63";"67255"
"2";"1";"1";"10";"63";"67256"
"3";"1";"2";"10";"63";"67257"
"2";"1";"1";"10";"63";"67260"
"5";"0";"5";"10";"63";"67262"
"4";"1";"3";"10";"63";"67268"
"4";"2";"2";"10";"63";"67269"
"2";"0";"2";"10";"63";"67270"
"1";"1";"0";"10";"63";"67271"
"19";"5";"14";"10";"63";"67273"
"2";"0";"2";"10";"63";"67279"
"5";"0";"5";"10";"63";"67283"
"2";"0";"2";"10";"63";"67285"
"4";"0";"4";"10";"63";"67286"
"1";"0";"1";"10";"63";"67289"
"2";"0";"2";"10";"63";"67292"
"3";"0";"3";"10";"63";"67293"
"1";"0";"1";"10";"63";"67295"
"4";"1";"3";"10";"63";"67296"
"2";"1";"1";"10";"63";"67298"
"2";"1";"1";"10";"63";"67299"
"2";"1";"1";"10";"63";"67302"
"8";"3";"5";"10";"63";"67303"
"5";"0";"5";"10";"63";"67307"
"1";"0";"1";"10";"63";"67308"
"3";"1";"2";"10";"63";"67311"
"2";"1";"1";"10";"63";"67318"
"3";"0";"3";"10";"63";"67319"
"10";"6";"4";"10";"63";"67320"
"2";"0";"2";"10";"63";"67322"
"10";"1";"9";"10";"63";"67325"
"6";"1";"5";"10";"63";"67329"
"1";"1";"0";"10";"63";"67333"
"2";"0";"2";"10";"63";"67335"
"4";"0";"4";"10";"63";"67336"
"1";"0";"1";"10";"63";"67337"
"1";"1";"0";"10";"63";"67340"
"3";"1";"2";"10";"63";"67341"
"2";"0";"2";"10";"63";"67342"
"4";"1";"3";"10";"63";"67345"
"4";"0";"4";"10";"63";"67352"
"52";"42";"10";"10";"63";"67353"
"1";"1";"0";"10";"63";"67357"
"4";"2";"2";"10";"63";"67359"
"1";"0";"1";"10";"63";"67363"
"1";"0";"1";"10";"63";"67364"
"2";"0";"2";"10";"63";"67365"
"1";"0";"1";"10";"63";"67366"
"2";"0";"2";"10";"63";"67369"
"22";"5";"17";"10";"63";"67370"
"3";"3";"0";"10";"63";"67374"
"2";"0";"2";"10";"63";"67375"
"1";"1";"0";"10";"63";"67381"
"4";"1";"3";"10";"63";"67382"
"7";"2";"5";"10";"63";"67384"
"7";"3";"4";"10";"63";"67386"
"1";"0";"1";"10";"63";"67389"
"4";"1";"3";"10";"63";"67390"
"5";"1";"4";"10";"63";"67394"
"7";"3";"4";"10";"63";"67395"
"1";"0";"1";"10";"63";"67396"
"21";"5";"16";"10";"63";"67397"
"4";"0";"4";"10";"63";"67398"
"4";"1";"3";"10";"63";"67399"
"1";"0";"1";"10";"63";"67403"
"6";"1";"5";"10";"63";"67404"
"2";"0";"2";"10";"63";"67405"
"1";"1";"0";"10";"63";"67406"
"4";"0";"4";"10";"63";"67411"
"5";"0";"5";"10";"63";"67412"
"1";"1";"0";"10";"63";"67413"
"9";"2";"7";"10";"63";"67414"
"1";"0";"1";"10";"63";"67416"
"3";"1";"2";"10";"63";"67428"
"3";"2";"1";"10";"63";"67430"
"3";"0";"3";"10";"63";"67433"
"7";"1";"6";"10";"63";"67434"
"1";"0";"1";"10";"63";"67435"
"4";"1";"3";"10";"63";"67437"
"18";"2";"16";"10";"63";"67438"
"1";"0";"1";"10";"63";"67445"
"1";"1";"0";"10";"63";"67448"
"9";"1";"8";"10";"63";"67451"
"1";"0";"1";"10";"63";"67453"
"5";"2";"3";"10";"63";"67456"
"4";"0";"4";"10";"63";"67458"
"8";"2";"6";"10";"63";"67461"
"3";"1";"2";"10";"63";"67462"
"4";"1";"3";"10";"63";"67468"
"3";"1";"2";"10";"63";"67473"
"3";"0";"3";"10";"63";"67474"
"2";"1";"1";"10";"63";"67476"
"2";"2";"0";"10";"63";"67483"
"3";"1";"2";"10";"63";"67485"
"3";"1";"2";"10";"63";"67486"
"2";"2";"0";"10";"63";"67488"
"10";"3";"7";"10";"63";"67489"
"3";"0";"3";"10";"63";"67491"
"61";"41";"20";"10";"63";"67493"
"3";"0";"3";"10";"63";"67494"
"1";"0";"1";"10";"63";"67496"
"8";"1";"7";"10";"63";"67498"
"3";"0";"3";"10";"63";"67499"
"2";"1";"1";"10";"63";"67501"
"9";"2";"7";"10";"63";"67503"
"75";"37";"38";"10";"63";"67505"
"3";"0";"3";"10";"63";"67510"
"8";"1";"7";"10";"63";"67513"
"5";"1";"4";"10";"63";"67514"
"5";"0";"5";"10";"63";"67515"
"6";"1";"5";"10";"63";"67516"
"4";"0";"4";"10";"63";"67518"
"6";"2";"4";"10";"63";"67521"
"4";"1";"3";"10";"63";"67522"
"3";"1";"2";"10";"63";"67524"
"4";"1";"3";"10";"63";"67525"
"4";"1";"3";"10";"63";"67526"
"2";"0";"2";"10";"63";"67527"
"7";"1";"6";"10";"63";"67528"
"2";"2";"0";"10";"63";"67529"
"4";"1";"3";"10";"63";"67533"
"6";"2";"4";"10";"63";"67534"
"9";"6";"3";"10";"63";"67535"
"3";"0";"3";"10";"63";"67537"
"5";"1";"4";"10";"63";"67543"
"8";"1";"7";"10";"63";"67544"
"2";"0";"2";"10";"63";"67545"
"22";"17";"5";"10";"63";"67547"
"3";"0";"3";"10";"63";"67548"
"25";"2";"23";"10";"63";"67550"
"4";"2";"2";"10";"63";"67552"
"1";"0";"1";"10";"63";"67556"
"4";"1";"3";"10";"63";"67557"
"4";"2";"2";"10";"63";"67561"
"2";"0";"2";"10";"63";"67564"
"3";"1";"2";"10";"63";"67566"
"2";"1";"1";"10";"63";"67569"
"3";"1";"2";"10";"63";"67570"
"7";"1";"6";"10";"63";"67572"
"1";"1";"0";"10";"63";"67579"
"2";"1";"1";"10";"63";"67583"
"4";"0";"4";"10";"63";"67584"
"1";"1";"0";"10";"63";"67586"
"1";"1";"0";"10";"63";"67588"
"1";"0";"1";"10";"63";"67590"
"1";"0";"1";"10";"63";"67593"
"14";"6";"8";"10";"63";"67595"
"1";"0";"1";"10";"63";"67598"
"1";"0";"1";"10";"63";"67601"
"7";"1";"6";"10";"63";"67603"
"2";"0";"2";"10";"63";"67604"
"2";"2";"0";"10";"63";"67605"
"9";"2";"7";"10";"63";"67606"
"6";"0";"6";"10";"63";"67608"
"2";"0";"2";"10";"63";"67611"
"4";"0";"4";"10";"63";"67617"
"35";"10";"25";"10";"63";"67618"
"7";"3";"4";"10";"63";"67620"
"3";"1";"2";"10";"63";"67621"
"1";"1";"0";"10";"63";"67622"
"12";"1";"11";"10";"63";"67625"
"655";"562";"93";"10";"63";"67626"
"3";"0";"3";"10";"63";"67627"
"3";"1";"2";"10";"63";"67628"
"1";"1";"0";"10";"63";"67630"
"1";"0";"1";"10";"63";"67632"
"1";"1";"0";"10";"63";"67634"
"4";"1";"3";"10";"63";"67637"
"2";"1";"1";"10";"63";"67638"
"7";"0";"7";"10";"63";"67640"
"1";"0";"1";"10";"63";"67641"
"3";"1";"2";"10";"63";"67642"
"2";"1";"1";"10";"63";"67645"
"1";"1";"0";"10";"63";"67646"
"12";"3";"9";"10";"63";"67647"
"8";"1";"7";"10";"63";"67648"
"3";"1";"2";"10";"63";"67649"
"3";"1";"2";"10";"63";"67650"
"5";"1";"4";"10";"63";"67654"
"4";"1";"3";"10";"63";"67655"
"1";"0";"1";"10";"63";"67656"
"4";"2";"2";"10";"63";"67662"
"2";"0";"2";"10";"63";"67663"
"1";"0";"1";"10";"63";"67664"
"5";"0";"5";"10";"63";"67666"
"2";"0";"2";"10";"63";"67668"
"2";"0";"2";"10";"63";"67670"
"5";"2";"3";"10";"63";"67672"
"46";"27";"19";"10";"63";"67673"
"1";"1";"0";"10";"63";"67674"
"5";"2";"3";"10";"63";"67675"
"2";"0";"2";"10";"63";"67676"
"2";"1";"1";"10";"63";"67677"
"4";"2";"2";"10";"63";"67679"
"11";"8";"3";"10";"63";"67682"
"2";"0";"2";"10";"63";"67685"
"2";"1";"1";"10";"63";"67687"
"13";"3";"10";"10";"63";"67688"
"9";"3";"6";"10";"63";"67689"
"4";"0";"4";"10";"63";"67690"
"5";"2";"3";"10";"63";"67691"
"6";"0";"6";"10";"63";"67692"
"10";"3";"7";"10";"63";"67695"
"1";"0";"1";"10";"63";"67698"
"1";"0";"1";"10";"63";"67699"
"3";"1";"2";"10";"63";"67700"
"2";"1";"1";"10";"63";"67701"
"5";"0";"5";"10";"63";"67702"
"1";"0";"1";"10";"63";"67704"
"5";"0";"5";"10";"63";"67707"
"2";"0";"2";"10";"63";"67712"
"5";"0";"5";"10";"63";"67713"
"11";"2";"9";"10";"63";"67714"
"4";"3";"1";"10";"63";"67715"
"14";"4";"10";"10";"63";"67716"
"2";"0";"2";"10";"63";"67719"
"2";"1";"1";"10";"63";"67720"
"1";"1";"0";"10";"63";"67721"
"3";"0";"3";"10";"63";"67722"
"5";"3";"2";"10";"63";"67723"
"6";"1";"5";"10";"63";"67727"
"4";"0";"4";"10";"63";"67729"
"1";"0";"1";"10";"63";"67732"
"2";"0";"2";"10";"63";"67734"
"2";"0";"2";"10";"63";"67735"
"5";"1";"4";"10";"63";"67736"
"33";"12";"21";"10";"63";"67737"
"2";"0";"2";"10";"63";"67739"
"3";"0";"3";"10";"63";"67740"
"7";"1";"6";"10";"63";"67742"
"2";"0";"2";"10";"63";"67743"
"8";"1";"7";"10";"63";"67744"
"1";"1";"0";"10";"63";"67745"
"2";"1";"1";"10";"63";"67752"
"6";"2";"4";"10";"63";"67753"
"1";"1";"0";"10";"63";"67755"
"2";"0";"2";"10";"63";"67757"
"3";"1";"2";"10";"63";"67758"
"1";"0";"1";"10";"63";"67759"
"1";"0";"1";"10";"63";"67760"
"1";"0";"1";"10";"63";"67762"
"2";"0";"2";"10";"63";"67764"
"2";"1";"1";"10";"63";"67765"
"7";"2";"5";"10";"63";"67769"
"3";"1";"2";"10";"63";"67772"
"2";"0";"2";"10";"63";"67774"
"3";"0";"3";"10";"63";"67775"
"10";"4";"6";"10";"63";"67776"
"1";"0";"1";"10";"63";"67777"
"7";"0";"7";"10";"63";"67781"
"6";"1";"5";"10";"63";"67786"
"5";"0";"5";"10";"63";"67788"
"1";"0";"1";"10";"63";"67791"
"2";"0";"2";"10";"63";"67795"
"21";"12";"9";"10";"63";"67796"
"4";"1";"3";"10";"63";"67800"
"1";"1";"0";"10";"63";"67801"
"1";"1";"0";"10";"63";"67803"
"4";"1";"3";"10";"63";"67804"
"6";"1";"5";"10";"63";"67806"
"2";"0";"2";"10";"63";"67807"
"7";"3";"4";"10";"63";"67812"
"3";"0";"3";"10";"63";"67817"
"4";"1";"3";"10";"63";"67819"
"9";"1";"8";"10";"63";"67820"
"2";"1";"1";"10";"63";"67823"
"4";"4";"0";"10";"63";"67824"
"11";"1";"10";"10";"63";"67829"
"1";"1";"0";"10";"63";"67830"
"4";"1";"3";"10";"63";"67831"
"15";"1";"14";"10";"63";"67834"
"2";"1";"1";"10";"63";"67840"
"4";"1";"3";"10";"63";"67842"
"6";"0";"6";"10";"63";"67843"
"4";"1";"3";"10";"63";"67847"
"5";"1";"4";"10";"63";"67849"
"2";"0";"2";"10";"63";"67850"
"1";"0";"1";"10";"63";"67851"
"1";"1";"0";"10";"63";"67853"
"65";"28";"37";"10";"63";"67854"
"2";"0";"2";"10";"63";"67858"
"1";"1";"0";"10";"63";"67867"
"6";"2";"4";"10";"63";"67870"
"3";"2";"1";"10";"63";"67875"
"3";"0";"3";"10";"63";"67879"
"11";"3";"8";"10";"63";"67882"
"1";"0";"1";"10";"63";"67885"
"2";"0";"2";"10";"63";"67886"
"1";"1";"0";"10";"63";"67888"
"1";"1";"0";"10";"63";"67894"
"1";"1";"0";"10";"63";"67895"
"2";"0";"2";"10";"63";"67897"
"2";"2";"0";"10";"63";"67901"
"21";"11";"10";"10";"63";"67902"
"29";"12";"17";"10";"63";"67904"
"2";"0";"2";"10";"63";"67910"
"2";"0";"2";"10";"63";"67918"
"5";"3";"2";"10";"63";"67922"
"4";"1";"3";"10";"63";"67924"
"5";"2";"3";"10";"63";"67935"
"5";"0";"5";"10";"63";"67939"
"1";"1";"0";"10";"63";"67941"
"1";"1";"0";"10";"63";"67950"
"1";"1";"0";"10";"63";"67952"
"6";"0";"6";"10";"63";"67953"
"2";"2";"0";"10";"63";"67955"
"2";"2";"0";"10";"63";"67957"
"1";"1";"0";"10";"63";"67961"
"6";"1";"5";"10";"63";"67963"
"5";"0";"5";"10";"63";"67965"
"2";"2";"0";"10";"63";"67968"
"5";"4";"1";"10";"63";"67977"
"5";"0";"5";"10";"63";"67981"
"1";"1";"0";"10";"63";"67983"
"1";"1";"0";"10";"63";"67987"
"2";"1";"1";"10";"63";"67988"
"4";"3";"1";"10";"63";"67989"
"1";"1";"0";"10";"63";"67990"
"3";"1";"2";"10";"63";"67993"
"4";"2";"2";"10";"63";"67996"
"12";"2";"10";"10";"63";"67998"
"4";"2";"2";"10";"63";"67999"
"2";"0";"2";"10";"63";"68000"
"24";"11";"13";"10";"63";"68003"
"8";"4";"4";"10";"63";"68006"
"1";"0";"1";"10";"63";"68011"
"2";"2";"0";"10";"63";"68015"
"19";"8";"11";"10";"63";"68016"
"5";"2";"3";"10";"63";"68018"
"8";"3";"5";"10";"63";"68021"
"15";"3";"12";"10";"63";"68022"
"7";"4";"3";"10";"63";"68033"
"2";"0";"2";"10";"63";"68035"
"11";"2";"9";"10";"63";"68036"
"1";"1";"0";"10";"63";"68041"
"14";"5";"9";"10";"63";"68046"
"16";"3";"13";"10";"63";"68047"
"12";"1";"11";"10";"63";"68049"
"2";"1";"1";"10";"63";"68050"
"8";"1";"7";"10";"63";"68055"
"4";"1";"3";"10";"63";"68056"
"2";"0";"2";"10";"63";"68057"
"2";"1";"1";"10";"63";"68061"
"1";"1";"0";"10";"63";"68062"
"7";"1";"6";"10";"63";"68063"
"4";"0";"4";"10";"63";"68064"
"2";"0";"2";"10";"63";"68065"
"2";"0";"2";"10";"63";"68069"
"2";"0";"2";"10";"63";"68074"
"2";"0";"2";"10";"63";"68075"
"5";"1";"4";"10";"63";"68079"
"3";"0";"3";"10";"63";"68082"
"1";"1";"0";"10";"63";"68085"
"1";"0";"1";"10";"63";"68087"
"9";"1";"8";"10";"63";"68088"
"8";"3";"5";"10";"63";"68089"
"10";"3";"7";"10";"63";"68090"
"3";"0";"3";"10";"63";"68093"
"7";"2";"5";"10";"63";"68094"
"1";"1";"0";"10";"63";"68100"
"6";"2";"4";"10";"63";"68103"
"4";"0";"4";"10";"63";"68106"
"2";"0";"2";"10";"63";"68107"
"7";"4";"3";"10";"63";"68108"
"1";"1";"0";"10";"63";"68109"
"6";"0";"6";"10";"63";"68110"
"2";"0";"2";"10";"63";"68115"
"1";"1";"0";"10";"63";"68118"
"2";"2";"0";"10";"63";"68121"
"3";"1";"2";"10";"63";"68128"
"4";"0";"4";"10";"63";"68129"
"1";"1";"0";"10";"63";"68131"
"6";"1";"5";"10";"63";"68135"
"2";"1";"1";"10";"63";"68136"
"1";"0";"1";"10";"63";"68141"
"2";"0";"2";"10";"63";"68146"
"6";"1";"5";"10";"63";"68147"
"3";"0";"3";"10";"63";"68149"
"3";"0";"3";"10";"63";"68150"
"2";"1";"1";"10";"63";"68153"
"1";"0";"1";"10";"63";"68156"
"1";"1";"0";"10";"63";"68157"
"4";"0";"4";"10";"63";"68158"
"2";"1";"1";"10";"63";"68159"
"2";"0";"2";"10";"63";"68162"
"1";"0";"1";"10";"63";"68166"
"3";"1";"2";"10";"63";"68167"
"3";"0";"3";"10";"63";"68168"
"1";"0";"1";"10";"63";"68172"
"10";"3";"7";"10";"63";"68174"
"1";"1";"0";"10";"63";"68175"
"1";"0";"1";"10";"63";"68180"
"2";"0";"2";"10";"63";"68181"
"2";"1";"1";"10";"63";"68182"
"1";"1";"0";"10";"63";"68185"
"1";"1";"0";"10";"63";"68192"
"1";"1";"0";"10";"63";"68195"
"1";"1";"0";"10";"63";"68198"
"7";"2";"5";"10";"63";"68200"
"2";"0";"2";"10";"63";"68202"
"6";"1";"5";"10";"63";"68203"
"2";"0";"2";"10";"63";"68204"
"3";"1";"2";"10";"63";"68205"
"7";"2";"5";"10";"63";"68206"
"5";"2";"3";"10";"63";"68207"
"1";"0";"1";"10";"63";"68212"
"5";"1";"4";"10";"63";"68213"
"4";"1";"3";"10";"63";"68218"
"6";"0";"6";"10";"63";"68219"
"6";"1";"5";"10";"63";"68221"
"4";"0";"4";"10";"63";"68222"
"1";"1";"0";"10";"63";"68225"
"1";"0";"1";"10";"63";"68237"
"2";"0";"2";"10";"63";"68239"
"1";"0";"1";"10";"63";"68240"
"2";"1";"1";"10";"63";"68243"
"4";"1";"3";"10";"63";"68244"
"9";"1";"8";"10";"63";"68247"
"5";"1";"4";"10";"63";"68250"
"8";"2";"6";"10";"63";"68264"
"4";"0";"4";"10";"63";"68265"
"4";"1";"3";"10";"63";"68268"
"2";"0";"2";"10";"63";"68270"
"3";"3";"0";"10";"63";"68272"
"6";"4";"2";"10";"63";"68275"
"1";"0";"1";"10";"63";"68279"
"1";"1";"0";"10";"63";"68280"
"4";"0";"4";"10";"63";"68281"
"5";"1";"4";"10";"63";"68282"
"2";"1";"1";"10";"63";"68283"
"8";"1";"7";"10";"63";"68286"
"1";"1";"0";"10";"63";"68289"
"1";"1";"0";"10";"63";"68297"
"7";"1";"6";"10";"63";"68299"
"3";"0";"3";"10";"63";"68303"
"2";"0";"2";"10";"63";"68305"
"3";"0";"3";"10";"63";"68307"
"3";"0";"3";"10";"63";"68311"
"1";"0";"1";"10";"63";"68312"
"1";"0";"1";"10";"63";"68316"
"2";"0";"2";"10";"63";"68319"
"4";"0";"4";"10";"63";"68322"
"55";"30";"25";"10";"63";"68323"
"3";"1";"2";"10";"63";"68326"
"2";"1";"1";"10";"63";"68327"
"2";"1";"1";"10";"63";"68329"
"5";"2";"3";"10";"63";"68332"
"4";"0";"4";"10";"63";"68334"
"3";"1";"2";"10";"63";"68344"
"14";"3";"11";"10";"63";"68352"
"7";"2";"5";"10";"63";"68353"
"7";"0";"7";"10";"63";"68354"
"8";"2";"6";"10";"63";"68358"
"3";"1";"2";"10";"63";"68359"
"1";"0";"1";"10";"63";"68361"
"5";"2";"3";"10";"63";"68363"
"1";"0";"1";"10";"63";"68366"
"3";"1";"2";"10";"63";"68367"
"10";"6";"4";"10";"63";"68368"
"1";"1";"0";"10";"63";"68372"
"2";"1";"1";"10";"63";"68374"
"1";"0";"1";"10";"63";"68375"
"2";"0";"2";"10";"63";"68378"
"5";"1";"4";"10";"63";"68379"
"1";"0";"1";"10";"63";"68382"
"2";"0";"2";"10";"63";"68386"
"1";"0";"1";"10";"63";"68388"
"3";"1";"2";"10";"63";"68389"
"1";"0";"1";"10";"63";"68390"
"1";"1";"0";"10";"63";"68393"
"1";"1";"0";"10";"63";"68396"
"2";"0";"2";"10";"63";"68398"
"1";"0";"1";"10";"63";"68400"
"2";"1";"1";"10";"63";"68402"
"2";"0";"2";"10";"63";"68404"
"4";"2";"2";"10";"63";"68405"
"4";"1";"3";"10";"63";"68407"
"2";"1";"1";"10";"63";"68409"
"1";"1";"0";"10";"63";"68410"
"2";"1";"1";"10";"63";"68411"
"11";"6";"5";"10";"63";"68415"
"2";"0";"2";"10";"63";"68418"
"8";"2";"6";"10";"63";"68419"
"2";"0";"2";"10";"63";"68421"
"2";"0";"2";"10";"63";"68427"
"3";"0";"3";"10";"63";"68430"
"6";"1";"5";"10";"63";"68433"
"11";"4";"7";"10";"63";"68435"
"5";"0";"5";"10";"63";"68437"
"7";"1";"6";"10";"63";"68440"
"2";"0";"2";"10";"63";"68441"
"1";"1";"0";"10";"63";"68446"
"23";"3";"20";"10";"63";"68451"
"2";"1";"1";"10";"63";"68454"
"1";"0";"1";"10";"63";"68456"
"2";"0";"2";"10";"63";"68464"
"3";"2";"1";"10";"63";"68470"
"3";"1";"2";"10";"63";"68475"
"2";"0";"2";"10";"63";"68477"
"1";"0";"1";"10";"63";"68478"
"6";"2";"4";"10";"63";"68479"
"5";"0";"5";"10";"63";"68481"
"6";"2";"4";"10";"63";"68483"
"2";"0";"2";"10";"63";"68493"
"1";"0";"1";"10";"63";"68500"
"1";"1";"0";"10";"63";"68513"
"9";"2";"7";"10";"63";"68514"
"2";"1";"1";"10";"63";"68525"
"1";"1";"0";"10";"63";"68528"
"4";"0";"4";"10";"63";"68534"
"1";"0";"1";"10";"63";"68537"
"5";"1";"4";"10";"63";"68541"
"1";"1";"0";"10";"63";"68543"
"14";"5";"9";"10";"63";"68547"
"2";"0";"2";"10";"63";"68554"
"2";"1";"1";"10";"63";"68557"
"2";"0";"2";"10";"63";"68560"
"1";"1";"0";"10";"63";"68561"
"3";"1";"2";"10";"63";"68574"
"7";"3";"4";"10";"63";"68579"
"1";"1";"0";"10";"63";"68580"
"4";"1";"3";"10";"63";"68584"
"37";"29";"8";"10";"63";"68586"
"2";"0";"2";"10";"63";"68591"
"1";"1";"0";"10";"63";"68592"
"1";"1";"0";"10";"63";"68597"
"22";"9";"13";"10";"63";"68599"
"1";"1";"0";"10";"63";"68600"
"23";"5";"18";"10";"63";"68601"
"3";"0";"3";"10";"63";"68603"
"3";"0";"3";"10";"63";"68605"
"1";"0";"1";"10";"63";"68614"
"2";"0";"2";"10";"63";"68616"
"8";"0";"8";"10";"63";"68619"
"6";"0";"6";"10";"63";"68629"
"1";"1";"0";"10";"63";"68631"
"2";"1";"1";"10";"63";"68637"
"1";"1";"0";"10";"63";"68640"
"4";"2";"2";"10";"63";"68659"
"2";"0";"2";"10";"63";"68661"
"1";"1";"0";"10";"63";"68662"
"1";"0";"1";"10";"63";"68669"
"3";"1";"2";"10";"63";"68676"
"1";"0";"1";"10";"63";"68679"
"1";"1";"0";"10";"63";"68686"
"6";"2";"4";"10";"63";"68698"
"4";"1";"3";"10";"63";"68708"
"2";"1";"1";"10";"63";"68710"
"7";"2";"5";"10";"63";"68712"
"5";"1";"4";"10";"63";"68715"
"1";"0";"1";"10";"63";"68719"
"3";"0";"3";"10";"63";"68724"
"1";"0";"1";"10";"63";"68730"
"1";"1";"0";"10";"63";"68735"
"3";"1";"2";"10";"63";"68737"
"3";"1";"2";"10";"63";"68738"
"2";"0";"2";"10";"63";"68739"
"1";"0";"1";"10";"63";"68741"
"1";"0";"1";"10";"63";"68745"
"1";"1";"0";"10";"63";"68747"
"1";"0";"1";"10";"63";"68752"
"87";"73";"14";"10";"63";"68764"
"3";"0";"3";"10";"63";"68765"
"6";"1";"5";"10";"63";"68768"
"2";"1";"1";"10";"63";"68771"
"12";"5";"7";"10";"63";"68776"
"1";"1";"0";"10";"63";"68777"
"1";"1";"0";"10";"63";"68781"
"1";"1";"0";"10";"63";"68788"
"1";"1";"0";"10";"63";"68789"
"1";"1";"0";"10";"63";"68798"
"1";"0";"1";"10";"63";"68799"
"7";"1";"6";"10";"63";"68805"
"1";"0";"1";"10";"63";"68814"
"2";"1";"1";"10";"63";"68816"
"1";"1";"0";"10";"63";"68820"
"10";"6";"4";"10";"63";"68821"
"3";"1";"2";"10";"63";"68829"
"1";"0";"1";"10";"63";"68831"
"1";"1";"0";"10";"63";"68832"
"3";"1";"2";"10";"63";"68837"
"2";"1";"1";"10";"63";"68856"
"5";"1";"4";"10";"63";"68859"
"2";"0";"2";"10";"63";"68860"
"3";"1";"2";"10";"63";"68861"
"2";"0";"2";"10";"63";"68873"
"8";"5";"3";"10";"63";"68882"
"2";"0";"2";"10";"63";"68884"
"10";"2";"8";"10";"63";"68887"
"7";"2";"5";"10";"63";"68897"
"6";"1";"5";"10";"63";"68910"
"2";"0";"2";"10";"63";"68913"
"2";"0";"2";"10";"63";"68915"
"2";"0";"2";"10";"63";"68920"
"3";"0";"3";"10";"63";"68922"
"6";"2";"4";"10";"63";"68923"
"9";"2";"7";"10";"63";"68924"
"13";"6";"7";"10";"63";"68926"
"126";"81";"45";"10";"63";"68933"
"2";"1";"1";"10";"63";"68937"
"4";"3";"1";"10";"63";"68940"
"2";"0";"2";"10";"63";"68941"
"6";"0";"6";"10";"63";"68942"
"1";"1";"0";"10";"63";"68945"
"1";"1";"0";"10";"63";"68946"
"2";"1";"1";"10";"63";"68953"
"1";"1";"0";"10";"63";"68960"
"7";"1";"6";"10";"63";"68961"
"2";"0";"2";"10";"63";"68966"
"4";"1";"3";"10";"63";"68968"
"4";"2";"2";"10";"63";"68969"
"1";"0";"1";"10";"63";"68971"
"2";"0";"2";"10";"63";"68985"
"3";"0";"3";"10";"63";"68988"
"5";"2";"3";"10";"63";"68995"
"3";"0";"3";"10";"63";"69002"
"3";"1";"2";"10";"63";"69005"
"3";"1";"2";"10";"63";"69016"
"1";"0";"1";"10";"63";"69024"
"9";"0";"9";"10";"63";"69025"
"2";"0";"2";"10";"63";"69038"
"1";"0";"1";"10";"63";"69042"
"2";"2";"0";"10";"63";"69043"
"1";"0";"1";"10";"63";"69047"
"2";"0";"2";"10";"63";"69048"
"4";"1";"3";"10";"63";"69050"
"2";"0";"2";"10";"63";"69056"
"2";"1";"1";"10";"63";"69057"
"3";"1";"2";"10";"63";"69063"
"1";"0";"1";"10";"63";"69067"
"2";"1";"1";"10";"63";"69068"
"2";"0";"2";"10";"63";"69080"
"7";"2";"5";"10";"63";"69084"
"2";"0";"2";"10";"63";"69088"
"5";"1";"4";"10";"63";"69089"
"2";"1";"1";"10";"63";"69094"
"1";"1";"0";"10";"63";"69099"
"1";"0";"1";"10";"63";"69103"
"3";"2";"1";"10";"63";"69104"
"2";"0";"2";"10";"63";"69109"
"3";"1";"2";"10";"63";"69111"
"2";"1";"1";"10";"63";"69124"
"5";"1";"4";"10";"63";"69128"
"3";"0";"3";"10";"63";"69130"
"4";"2";"2";"10";"63";"69137"
"2";"1";"1";"10";"63";"69138"
"3";"0";"3";"10";"63";"69139"
"6";"0";"6";"10";"63";"69141"
"1";"0";"1";"10";"63";"69143"
"1";"0";"1";"10";"63";"69148"
"6";"1";"5";"10";"63";"69151"
"2";"0";"2";"10";"63";"69154"
"8";"0";"8";"10";"63";"69155"
"1";"1";"0";"10";"63";"69157"
"4";"2";"2";"10";"63";"69159"
"1";"0";"1";"10";"63";"69160"
"1";"0";"1";"10";"63";"69162"
"2";"1";"1";"10";"63";"69163"
"1";"0";"1";"10";"63";"69164"
"13";"3";"10";"10";"63";"69165"
"14";"3";"11";"10";"63";"69173"
"3";"1";"2";"10";"63";"69175"
"1";"0";"1";"10";"63";"69180"
"7";"1";"6";"10";"63";"69182"
"3";"0";"3";"10";"63";"69188"
"4";"0";"4";"10";"63";"69199"
"12";"2";"10";"10";"63";"69200"
"2";"1";"1";"10";"63";"69202"
"1";"0";"1";"10";"63";"69209"
"1";"0";"1";"10";"63";"69214"
"2";"1";"1";"10";"63";"69215"
"2";"1";"1";"10";"63";"69218"
"6";"1";"5";"10";"63";"69219"
"4";"1";"3";"10";"63";"69220"
"5";"1";"4";"10";"63";"69233"
"1";"1";"0";"10";"63";"69236"
"1";"0";"1";"10";"63";"69241"
"1";"1";"0";"10";"63";"69246"
"2";"0";"2";"10";"63";"69253"
"1";"1";"0";"10";"63";"69254"
"4";"1";"3";"10";"63";"69255"
"1";"0";"1";"10";"63";"69261"
"6";"2";"4";"10";"63";"69267"
"1";"1";"0";"10";"63";"69268"
"1";"1";"0";"10";"63";"69282"
"2";"1";"1";"10";"63";"69289"
"2";"0";"2";"10";"63";"69290"
"3";"2";"1";"10";"63";"69291"
"5";"1";"4";"10";"63";"69299"
"1";"1";"0";"10";"63";"69306"
"1";"1";"0";"10";"63";"69311"
"2";"0";"2";"10";"63";"69312"
"1";"1";"0";"10";"63";"69328"
"4";"0";"4";"10";"63";"69332"
"3";"1";"2";"10";"63";"69337"
"5";"1";"4";"10";"63";"69339"
"5";"1";"4";"10";"63";"69340"
"32";"3";"29";"10";"63";"69346"
"2";"1";"1";"10";"63";"69348"
"2";"0";"2";"10";"63";"69353"
"2";"0";"2";"10";"63";"69359"
"24";"4";"20";"10";"63";"69369"
"3";"1";"2";"10";"63";"69376"
"22";"4";"18";"10";"63";"69377"
"7";"2";"5";"10";"63";"69379"
"8";"4";"4";"10";"63";"69381"
"1";"0";"1";"10";"63";"69382"
"2";"0";"2";"10";"63";"69383"
"1";"0";"1";"10";"63";"69385"
"5";"1";"4";"10";"63";"69388"
"2";"0";"2";"10";"63";"69390"
"1";"1";"0";"10";"63";"69394"
"1";"0";"1";"10";"63";"69399"
"11";"0";"11";"10";"63";"69402"
"2";"1";"1";"10";"63";"69405"
"4";"0";"4";"10";"63";"69407"
"5";"2";"3";"10";"63";"69410"
"3";"1";"2";"10";"63";"69411"
"10";"1";"9";"10";"63";"69416"
"2";"2";"0";"10";"63";"69418"
"1";"1";"0";"10";"63";"69419"
"1";"1";"0";"10";"63";"69422"
"2";"0";"2";"10";"63";"69423"
"1";"0";"1";"10";"63";"69426"
"4";"0";"4";"10";"63";"69428"
"1";"0";"1";"10";"63";"69430"
"5";"1";"4";"10";"63";"69445"
"3";"1";"2";"10";"63";"69446"
"4";"1";"3";"10";"63";"69447"
"6";"2";"4";"10";"63";"69450"
"4";"1";"3";"10";"63";"69451"
"10";"2";"8";"10";"63";"69457"
"1";"0";"1";"10";"63";"69466"
"6";"2";"4";"10";"63";"69470"
"3";"1";"2";"10";"63";"69476"
"1";"0";"1";"10";"63";"69483"
"14";"9";"5";"10";"63";"69486"
"50";"7";"43";"10";"63";"69496"
"6";"1";"5";"10";"63";"69500"
"2";"1";"1";"10";"63";"69504"
"2";"1";"1";"10";"63";"69508"
"5";"0";"5";"10";"63";"69517"
"1";"0";"1";"10";"63";"69530"
"3";"0";"3";"10";"63";"69531"
"1";"1";"0";"10";"63";"69534"
"2";"1";"1";"10";"63";"69535"
"5";"1";"4";"10";"63";"69536"
"1";"0";"1";"10";"63";"69540"
"3";"1";"2";"10";"63";"69545"
"5";"1";"4";"10";"63";"69553"
"3";"1";"2";"10";"63";"69557"
"1";"1";"0";"10";"63";"69558"
"2";"0";"2";"10";"63";"69560"
"1";"1";"0";"10";"63";"69564"
"2";"0";"2";"10";"63";"69566"
"10";"2";"8";"10";"63";"69572"
"3";"0";"3";"10";"63";"69573"
"2";"1";"1";"10";"63";"69584"
"3";"0";"3";"10";"63";"69585"
"2";"1";"1";"10";"63";"69586"
"1";"1";"0";"10";"63";"69587"
"3";"1";"2";"10";"63";"69590"
"2";"1";"1";"10";"63";"69592"
"3";"1";"2";"10";"63";"69601"
"2";"0";"2";"10";"63";"69602"
"4";"0";"4";"10";"63";"69612"
"2";"0";"2";"10";"63";"69613"
"14";"3";"11";"10";"63";"69614"
"4";"2";"2";"10";"63";"69623"
"6";"1";"5";"10";"63";"69625"
"1";"1";"0";"10";"63";"69627"
"1";"1";"0";"10";"63";"69630"
"4";"1";"3";"10";"63";"69631"
"2";"0";"2";"10";"63";"69633"
"4";"2";"2";"10";"63";"69639"
"1";"1";"0";"10";"63";"69642"
"9";"3";"6";"10";"63";"69656"
"6";"1";"5";"10";"63";"69660"
"1";"1";"0";"10";"63";"69661"
"6";"2";"4";"10";"63";"69666"
"6";"1";"5";"10";"63";"69670"
"20";"15";"5";"10";"63";"69671"
"3";"0";"3";"10";"63";"69678"
"5";"1";"4";"10";"63";"69681"
"1";"0";"1";"10";"63";"69690"
"90";"65";"25";"10";"63";"69693"
"4";"0";"4";"10";"63";"69696"
"3";"1";"2";"10";"63";"69702"
"2";"0";"2";"10";"63";"69703"
"5";"4";"1";"10";"63";"69706"
"7";"1";"6";"10";"63";"69711"
"3";"0";"3";"10";"63";"69712"
"1";"0";"1";"10";"63";"69716"
"1";"1";"0";"10";"63";"69717"
"2";"1";"1";"10";"63";"69727"
"3";"1";"2";"10";"63";"69728"
"1";"1";"0";"10";"63";"69729"
"1";"0";"1";"10";"63";"69730"
"1";"1";"0";"10";"63";"69732"
"1";"1";"0";"10";"63";"69733"
"1";"0";"1";"10";"63";"69736"
"3";"1";"2";"10";"63";"69740"
"1";"0";"1";"10";"63";"69745"
"2";"0";"2";"10";"63";"69747"
"2";"1";"1";"10";"63";"69754"
"1";"0";"1";"10";"63";"69756"
"2";"1";"1";"10";"63";"69762"
"4";"0";"4";"10";"63";"69763"
"1";"1";"0";"10";"63";"69764"
"16";"9";"7";"10";"63";"69768"
"8";"2";"6";"10";"63";"69772"
"13";"9";"4";"10";"63";"69787"
"1";"1";"0";"10";"63";"69792"
"4";"1";"3";"10";"63";"69795"
"1";"0";"1";"10";"63";"69797"
"1";"1";"0";"10";"63";"69800"
"2";"0";"2";"10";"63";"69805"
"7";"1";"6";"10";"63";"69814"
"3";"1";"2";"10";"63";"69816"
"3";"1";"2";"10";"63";"69818"
"2";"0";"2";"10";"63";"69827"
"2";"0";"2";"10";"63";"69828"
"1";"0";"1";"10";"63";"69830"
"2";"0";"2";"10";"63";"69840"
"2";"2";"0";"10";"63";"69843"
"3";"1";"2";"10";"63";"69846"
"15";"3";"12";"10";"63";"69849"
"11";"4";"7";"10";"63";"69850"
"4";"0";"4";"10";"63";"69854"
"2";"0";"2";"10";"63";"69856"
"2";"0";"2";"10";"63";"69859"
"5";"1";"4";"10";"63";"69863"
"1";"0";"1";"10";"63";"69865"
"1";"1";"0";"10";"63";"69874"
"7";"1";"6";"10";"63";"69877"
"6";"1";"5";"10";"63";"69878"
"2";"0";"2";"10";"63";"69879"
"1";"0";"1";"10";"63";"69890"
"4";"2";"2";"10";"63";"69897"
"3";"0";"3";"10";"63";"69901"
"6";"0";"6";"10";"63";"69905"
"2";"0";"2";"10";"63";"69911"
"5";"1";"4";"10";"63";"69913"
"1";"0";"1";"10";"63";"69919"
"3";"0";"3";"10";"63";"69920"
"4";"0";"4";"10";"63";"69922"
"1";"0";"1";"10";"63";"69933"
"1";"0";"1";"10";"63";"69934"
"8";"2";"6";"10";"63";"69944"
"1";"1";"0";"10";"63";"69946"
"2";"0";"2";"10";"63";"69953"
"8";"1";"7";"10";"63";"69956"
"1";"1";"0";"10";"63";"69964"
"1";"1";"0";"10";"63";"69965"
"5";"1";"4";"10";"63";"69970"
"2";"1";"1";"10";"63";"69978"
"1";"0";"1";"10";"63";"69991"
"1";"0";"1";"10";"63";"69994"
"2";"1";"1";"10";"63";"69999"
"4";"2";"2";"10";"63";"70001"
"3";"0";"3";"10";"63";"70003"
"1";"1";"0";"10";"63";"70004"
"1";"1";"0";"10";"63";"70007"
"1";"0";"1";"10";"63";"70010"
"4";"1";"3";"10";"63";"70014"
"6";"2";"4";"10";"63";"70015"
"1";"1";"0";"10";"63";"70016"
"8";"2";"6";"10";"63";"70020"
"1";"0";"1";"10";"63";"70023"
"2";"0";"2";"10";"63";"70024"
"2";"2";"0";"10";"63";"70025"
"3";"1";"2";"10";"63";"70026"
"1";"1";"0";"10";"63";"70031"
"5";"1";"4";"10";"63";"70044"
"7";"2";"5";"10";"63";"70053"
"3";"1";"2";"10";"63";"70054"
"1";"1";"0";"10";"63";"70059"
"3";"0";"3";"10";"63";"70062"
"8";"0";"8";"10";"63";"70063"
"2";"0";"2";"10";"63";"70069"
"1";"1";"0";"10";"63";"70075"
"5";"1";"4";"10";"63";"70076"
"7";"1";"6";"10";"63";"70077"
"2";"0";"2";"10";"63";"70078"
"3";"0";"3";"10";"63";"70079"
"38";"32";"6";"10";"63";"70085"
"5";"2";"3";"10";"63";"70086"
"2";"0";"2";"10";"63";"70088"
"1";"1";"0";"10";"63";"70089"
"1";"1";"0";"10";"63";"70094"
"7";"2";"5";"10";"63";"70096"
"1";"0";"1";"10";"63";"70097"
"5";"1";"4";"10";"63";"70100"
"4";"0";"4";"10";"63";"70112"
"4";"1";"3";"10";"63";"70118"
"4";"1";"3";"10";"63";"70127"
"10";"2";"8";"10";"63";"70128"
"5";"1";"4";"10";"63";"70129"
"3";"0";"3";"10";"63";"70136"
"9";"2";"7";"10";"63";"70137"
"8";"3";"5";"10";"63";"70140"
"4";"2";"2";"10";"63";"70143"
"5";"3";"2";"10";"63";"70144"
"1";"0";"1";"10";"63";"70145"
"5";"1";"4";"10";"63";"70149"
"1";"1";"0";"10";"63";"70150"
"1";"1";"0";"10";"63";"70151"
"1";"1";"0";"10";"63";"70156"
"10";"2";"8";"10";"63";"70158"
"6";"1";"5";"10";"63";"70160"
"3";"1";"2";"10";"63";"70168"
"5";"1";"4";"10";"63";"70173"
"5";"1";"4";"10";"63";"70175"
"10";"1";"9";"10";"63";"70176"
"9";"2";"7";"10";"63";"70181"
"34";"10";"24";"10";"63";"70185"
"3";"0";"3";"10";"63";"70188"
"1";"0";"1";"10";"63";"70190"
"3";"0";"3";"10";"63";"70195"
"1";"0";"1";"10";"63";"70199"
"4";"1";"3";"10";"63";"70203"
"1";"1";"0";"10";"63";"70204"
"6";"1";"5";"10";"63";"70206"
"2";"0";"2";"10";"63";"70208"
"1";"0";"1";"10";"63";"70216"
"2";"0";"2";"10";"63";"70219"
"1";"1";"0";"10";"63";"70221"
"10";"1";"9";"10";"63";"70231"
"4";"1";"3";"10";"63";"70234"
"4";"0";"4";"10";"63";"70245"
"1";"1";"0";"10";"63";"70248"
"16";"5";"11";"10";"63";"70254"
"3";"0";"3";"10";"63";"70255"
"2";"1";"1";"10";"63";"70259"
"6";"3";"3";"10";"63";"70260"
"8";"1";"7";"10";"63";"70265"
"1";"0";"1";"10";"63";"70269"
"9";"4";"5";"10";"63";"70271"
"10";"7";"3";"10";"63";"70273"
"105";"85";"20";"10";"63";"70279"
"2";"1";"1";"10";"63";"70286"
"4";"1";"3";"10";"63";"70287"
"4";"1";"3";"10";"63";"70288"
"1";"0";"1";"10";"63";"70291"
"3";"0";"3";"10";"63";"70298"
"4";"2";"2";"10";"63";"70299"
"1";"0";"1";"10";"63";"70300"
"1";"0";"1";"10";"63";"70306"
"2";"2";"0";"10";"63";"70320"
"1";"0";"1";"10";"63";"70328"
"1";"1";"0";"10";"63";"70330"
"3";"0";"3";"10";"63";"70335"
"1";"1";"0";"10";"63";"70346"
"1";"0";"1";"10";"63";"70347"
"2";"1";"1";"10";"63";"70349"
"7";"1";"6";"10";"63";"70350"
"1";"0";"1";"10";"63";"70359"
"1";"1";"0";"10";"63";"70367"
"10";"5";"5";"10";"63";"70371"
"5";"2";"3";"10";"63";"70374"
"1";"0";"1";"10";"63";"70376"
"2";"0";"2";"10";"63";"70381"
"1";"0";"1";"10";"63";"70383"
"3";"0";"3";"10";"63";"70385"
"7";"3";"4";"10";"63";"70388"
"7";"2";"5";"10";"63";"70394"
"3";"0";"3";"10";"63";"70405"
"1";"1";"0";"10";"63";"70406"
"3";"1";"2";"10";"63";"70417"
"3";"3";"0";"10";"63";"70423"
"2";"0";"2";"10";"63";"70424"
"3";"1";"2";"10";"63";"70434"
"2";"1";"1";"10";"63";"70445"
"2";"0";"2";"10";"63";"70447"
"2";"1";"1";"10";"63";"70448"
"1";"1";"0";"10";"63";"70449"
"6";"1";"5";"10";"63";"70452"
"8";"2";"6";"10";"63";"70455"
"1";"1";"0";"10";"63";"70461"
"5";"1";"4";"10";"63";"70462"
"3";"0";"3";"10";"63";"70463"
"7";"1";"6";"10";"63";"70465"
"1";"0";"1";"10";"63";"70467"
"33";"12";"21";"10";"63";"70469"
"1";"0";"1";"10";"63";"70472"
"3";"0";"3";"10";"63";"70474"
"11";"1";"10";"10";"63";"70475"
"2";"0";"2";"10";"63";"70477"
"2";"0";"2";"10";"63";"70479"
"2";"0";"2";"10";"63";"70487"
"1";"1";"0";"10";"63";"70490"
"4";"2";"2";"10";"63";"70492"
"1";"1";"0";"10";"63";"70493"
"1";"1";"0";"10";"63";"70495"
"3";"1";"2";"10";"63";"70497"
"14";"2";"12";"10";"63";"70504"
"52";"31";"21";"10";"63";"70508"
"8";"2";"6";"10";"63";"70514"
"3";"1";"2";"10";"63";"70518"
"1";"1";"0";"10";"63";"70519"
"1";"1";"0";"10";"63";"70521"
"3";"1";"2";"10";"63";"70523"
"28";"20";"8";"10";"63";"70524"
"4";"1";"3";"10";"63";"70526"
"2";"0";"2";"10";"63";"70527"
"7";"2";"5";"10";"63";"70529"
"1";"1";"0";"10";"63";"70534"
"8";"7";"1";"10";"63";"70546"
"1";"1";"0";"10";"63";"70554"
"2";"0";"2";"10";"63";"70560"
"10";"3";"7";"10";"63";"70561"
"6";"1";"5";"10";"63";"70562"
"2";"0";"2";"10";"63";"70569"
"2";"1";"1";"10";"63";"70579"
"2";"1";"1";"10";"63";"70580"
"4";"1";"3";"10";"63";"70583"
"7";"1";"6";"10";"63";"70586"
"1";"0";"1";"10";"63";"70587"
"3";"0";"3";"10";"63";"70588"
"1";"0";"1";"10";"63";"70592"
"1";"0";"1";"10";"63";"70593"
"2";"0";"2";"10";"63";"70594"
"2";"0";"2";"10";"63";"70598"
"4";"0";"4";"10";"63";"70599"
"4";"1";"3";"10";"63";"70604"
"2";"1";"1";"10";"63";"70605"
"5";"1";"4";"10";"63";"70606"
"1";"1";"0";"10";"63";"70607"
"2";"0";"2";"10";"63";"70608"
"5";"1";"4";"10";"63";"70610"
"3";"0";"3";"10";"63";"70612"
"8";"1";"7";"10";"63";"70617"
"1";"0";"1";"10";"63";"70619"
"5";"1";"4";"10";"63";"70621"
"1";"1";"0";"10";"63";"70622"
"1";"1";"0";"10";"63";"70627"
"6";"1";"5";"10";"63";"70628"
"1";"1";"0";"10";"63";"70631"
"69";"62";"7";"10";"63";"70637"
"4";"0";"4";"10";"63";"70638"
"1";"0";"1";"10";"63";"70644"
"1";"1";"0";"10";"63";"70651"
"11";"2";"9";"10";"63";"70653"
"3";"0";"3";"10";"63";"70656"
"4";"1";"3";"10";"63";"70686"
"1";"1";"0";"10";"63";"70696"
"6";"1";"5";"10";"63";"70699"
"23";"8";"15";"10";"63";"70700"
"2";"0";"2";"10";"63";"70701"
"4";"1";"3";"10";"63";"70702"
"7";"1";"6";"10";"63";"70703"
"4";"1";"3";"10";"63";"70704"
"7";"2";"5";"10";"63";"70705"
"1";"1";"0";"10";"63";"70710"
"1";"1";"0";"10";"63";"70713"
"1";"1";"0";"10";"63";"70719"
"2";"0";"2";"10";"63";"70720"
"76";"46";"30";"10";"63";"70721"
"2";"0";"2";"10";"63";"70723"
"3";"0";"3";"10";"63";"70736"
"2";"1";"1";"10";"63";"70739"
"1";"1";"0";"10";"63";"70741"
"1";"1";"0";"10";"63";"70743"
"5";"2";"3";"10";"63";"70745"
"1";"1";"0";"10";"63";"70748"
"25";"13";"12";"10";"63";"70755"
"8";"1";"7";"10";"63";"70758"
"1";"1";"0";"10";"63";"70765"
"3";"2";"1";"10";"63";"70766"
"5";"4";"1";"10";"63";"70768"
"2";"1";"1";"10";"63";"70771"
"1";"1";"0";"10";"63";"70778"
"6";"2";"4";"10";"63";"70780"
"2";"0";"2";"10";"63";"70785"
"6";"1";"5";"10";"63";"70787"
"23";"9";"14";"10";"63";"70795"
"1";"1";"0";"10";"63";"70800"
"5";"2";"3";"10";"63";"70805"
"5";"2";"3";"10";"63";"70810"
"1";"1";"0";"10";"63";"70811"
"1";"1";"0";"10";"63";"70814"
"1";"1";"0";"10";"63";"70819"
"2";"0";"2";"10";"63";"70820"
"1";"1";"0";"10";"63";"70821"
"7";"1";"6";"10";"63";"70823"
"1";"1";"0";"10";"63";"70825"
"8";"1";"7";"10";"63";"70826"
"1";"0";"1";"10";"63";"70829"
"11";"2";"9";"10";"63";"70832"
"4";"2";"2";"10";"63";"70837"
"2";"1";"1";"10";"63";"70840"
"4";"1";"3";"10";"63";"70841"
"1";"1";"0";"10";"63";"70842"
"1";"1";"0";"10";"63";"70843"
"2";"2";"0";"10";"63";"70845"
"1";"1";"0";"10";"63";"70846"
"18";"5";"13";"10";"63";"70847"
"1";"1";"0";"10";"63";"70848"
"11";"4";"7";"10";"63";"70855"
"1";"1";"0";"10";"63";"70861"
"4";"0";"4";"10";"63";"70862"
"4";"0";"4";"10";"63";"70863"
"3";"0";"3";"10";"63";"70867"
"9";"3";"6";"10";"63";"70869"
"4";"2";"2";"10";"63";"70870"
"1";"1";"0";"10";"63";"70872"
"1";"1";"0";"10";"63";"70879"
"24";"6";"18";"10";"63";"70880"
"2";"0";"2";"10";"63";"70883"
"1";"1";"0";"10";"63";"70884"
"1";"0";"1";"10";"63";"70890"
"40";"31";"9";"10";"63";"70892"
"1";"1";"0";"10";"63";"70893"
"1";"1";"0";"10";"63";"70895"
"1";"0";"1";"10";"63";"70902"
"4";"4";"0";"10";"63";"70904"
"1";"1";"0";"10";"63";"70912"
"2";"0";"2";"10";"63";"70913"
"14";"3";"11";"10";"63";"70921"
"1";"0";"1";"10";"63";"70927"
"9";"2";"7";"10";"63";"70929"
"1";"0";"1";"10";"63";"70935"
"3";"0";"3";"10";"63";"70936"
"9";"2";"7";"10";"63";"70941"
"4";"0";"4";"10";"63";"70943"
"1";"0";"1";"10";"63";"70945"
"1";"1";"0";"10";"63";"70948"
"1";"1";"0";"10";"63";"70951"
"3";"1";"2";"10";"63";"70952"
"3";"0";"3";"10";"63";"70958"
"21";"1";"20";"10";"63";"70967"
"1";"1";"0";"10";"63";"70975"
"1";"1";"0";"10";"63";"70978"
"1";"0";"1";"10";"63";"70979"
"1";"1";"0";"10";"63";"70980"
"9";"2";"7";"10";"63";"70986"
"4";"0";"4";"10";"63";"70991"
"6";"2";"4";"10";"63";"70992"
"3";"1";"2";"10";"63";"70994"
"4";"1";"3";"10";"63";"70996"
"1";"1";"0";"10";"63";"70998"
"1";"0";"1";"10";"63";"71000"
"3";"0";"3";"10";"63";"71001"
"8";"1";"7";"10";"63";"71003"
"5";"1";"4";"10";"63";"71004"
"4";"1";"3";"10";"63";"71005"
"3";"0";"3";"10";"63";"71007"
"11";"0";"11";"10";"63";"71012"
"1";"1";"0";"10";"63";"71013"
"4";"2";"2";"10";"63";"71014"
"796";"697";"99";"10";"63";"71015"
"2";"0";"2";"10";"63";"71024"
"1";"1";"0";"10";"63";"71028"
"2";"0";"2";"10";"63";"71032"
"15";"2";"13";"10";"63";"71036"
"1";"0";"1";"10";"63";"71041"
"1";"1";"0";"10";"63";"71042"
"2";"0";"2";"10";"63";"71043"
"5";"0";"5";"10";"63";"71044"
"1";"0";"1";"10";"63";"71047"
"4";"1";"3";"10";"63";"71054"
"13";"0";"13";"10";"63";"71062"
"1";"0";"1";"10";"63";"71071"
"3";"0";"3";"10";"63";"71076"
"1";"1";"0";"10";"63";"71080"
"10";"1";"9";"10";"63";"71087"
"1";"1";"0";"10";"63";"71091"
"1";"0";"1";"10";"63";"71095"
"1";"0";"1";"10";"63";"71102"
"2";"0";"2";"10";"63";"71103"
"9";"1";"8";"10";"63";"71105"
"1";"1";"0";"10";"63";"71108"
"8";"3";"5";"10";"63";"71109"
"2";"1";"1";"10";"63";"71111"
"1";"0";"1";"10";"63";"71112"
"4";"1";"3";"10";"63";"71119"
"2";"1";"1";"10";"63";"71127"
"3";"0";"3";"10";"63";"71131"
"5";"0";"5";"10";"63";"71147"
"2";"0";"2";"10";"63";"71151"
"3";"1";"2";"10";"63";"71156"
"2";"2";"0";"10";"63";"71161"
"1";"0";"1";"10";"63";"71162"
"2";"0";"2";"10";"63";"71172"
"2";"1";"1";"10";"63";"71173"
"1";"0";"1";"10";"63";"71175"
"1";"0";"1";"10";"63";"71182"
"1";"1";"0";"10";"63";"71184"
"10";"1";"9";"10";"63";"71187"
"3";"1";"2";"10";"63";"71189"
"11";"3";"8";"10";"63";"71190"
"1";"0";"1";"10";"63";"71192"
"6";"2";"4";"10";"63";"71193"
"2";"0";"2";"10";"63";"71194"
"1";"0";"1";"10";"63";"71196"
"19";"1";"18";"10";"63";"71197"
"7";"2";"5";"10";"63";"71203"
"1";"1";"0";"10";"63";"71205"
"2";"1";"1";"10";"63";"71206"
"1";"0";"1";"10";"63";"71208"
"1";"1";"0";"10";"63";"71209"
"3";"0";"3";"10";"63";"71211"
"4";"1";"3";"10";"63";"71214"
"3";"1";"2";"10";"63";"71216"
"5";"2";"3";"10";"63";"71217"
"7";"1";"6";"10";"63";"71220"
"2";"1";"1";"10";"63";"71221"
"2";"0";"2";"10";"63";"71222"
"2";"0";"2";"10";"63";"71223"
"2";"1";"1";"10";"63";"71227"
"2";"1";"1";"10";"63";"71234"
"6";"2";"4";"10";"63";"71235"
"1";"0";"1";"10";"63";"71238"
"5";"1";"4";"10";"63";"71243"
"24";"14";"10";"10";"63";"71248"
"7";"1";"6";"10";"63";"71249"
"1";"1";"0";"10";"63";"71263"
"4";"1";"3";"10";"63";"71264"
"3";"1";"2";"10";"63";"71266"
"5";"2";"3";"10";"63";"71267"
"2";"1";"1";"10";"63";"71271"
"7";"1";"6";"10";"63";"71274"
"7";"2";"5";"10";"63";"71279"
"4";"1";"3";"10";"63";"71284"
"2";"2";"0";"10";"63";"71289"
"3";"1";"2";"10";"63";"71290"
"3";"3";"0";"10";"63";"71295"
"1";"1";"0";"10";"63";"71298"
"1";"0";"1";"10";"63";"71299"
"6";"2";"4";"10";"63";"71300"
"2";"0";"2";"10";"63";"71301"
"2";"0";"2";"10";"63";"71303"
"1";"1";"0";"10";"63";"71305"
"5";"0";"5";"10";"63";"71311"
"1";"1";"0";"10";"63";"71316"
"4";"0";"4";"10";"63";"71318"
"3";"1";"2";"10";"63";"71319"
"1";"1";"0";"10";"63";"71320"
"5";"1";"4";"10";"63";"71324"
"3";"1";"2";"10";"63";"71325"
"2";"0";"2";"10";"63";"71326"
"3";"3";"0";"10";"63";"71327"
"6";"2";"4";"10";"63";"71329"
"10";"2";"8";"10";"63";"71330"
"1";"0";"1";"10";"63";"71332"
"3";"0";"3";"10";"63";"71333"
"1";"0";"1";"10";"63";"71335"
"2";"0";"2";"10";"63";"71337"
"3";"1";"2";"10";"63";"71338"
"1";"0";"1";"10";"63";"71340"
"4";"1";"3";"10";"63";"71342"
"2";"0";"2";"10";"63";"71344"
"14";"3";"11";"10";"63";"71345"
"3";"0";"3";"10";"63";"71348"
"1";"0";"1";"10";"63";"71350"
"23";"16";"7";"10";"63";"71357"
"5";"2";"3";"10";"63";"71358"
"2";"0";"2";"10";"63";"71360"
"5";"0";"5";"10";"63";"71361"
"1";"1";"0";"10";"63";"71363"
"6";"2";"4";"10";"63";"71365"
"6";"2";"4";"10";"63";"71366"
"9";"2";"7";"10";"63";"71375"
"14";"8";"6";"10";"63";"71380"
"5";"1";"4";"10";"63";"71381"
"23";"7";"16";"10";"63";"71390"
"7";"2";"5";"10";"63";"71396"
"1";"1";"0";"10";"63";"71400"
"2";"0";"2";"10";"63";"71410"
"1";"1";"0";"10";"63";"71419"
"23";"4";"19";"10";"63";"71424"
"2";"1";"1";"10";"63";"71427"
"6";"1";"5";"10";"63";"71430"
"2";"1";"1";"10";"63";"71432"
"5";"1";"4";"10";"63";"71436"
"3";"1";"2";"10";"63";"71437"
"1";"0";"1";"10";"63";"71438"
"7";"3";"4";"10";"63";"71441"
"6";"2";"4";"10";"63";"71447"
"3";"1";"2";"10";"63";"71448"
"2";"1";"1";"10";"63";"71449"
"4";"0";"4";"10";"63";"71450"
"3";"0";"3";"10";"63";"71451"
"2";"1";"1";"10";"63";"71453"
"1";"0";"1";"10";"63";"71456"
"5";"1";"4";"10";"63";"71459"
"3";"2";"1";"10";"63";"71462"
"1";"1";"0";"10";"63";"71469"
"20";"16";"4";"10";"63";"71470"
"2";"2";"0";"10";"63";"71472"
"3";"1";"2";"10";"63";"71475"
"6";"1";"5";"10";"63";"71477"
"5";"1";"4";"10";"63";"71480"
"1";"1";"0";"10";"63";"71482"
"83";"60";"23";"10";"63";"71483"
"2";"0";"2";"10";"63";"71485"
"6";"1";"5";"10";"63";"71488"
"1";"0";"1";"10";"63";"71489"
"5";"1";"4";"10";"63";"71491"
"3";"0";"3";"10";"63";"71494"
"2";"0";"2";"10";"63";"71498"
"4";"0";"4";"10";"63";"71499"
"3";"1";"2";"10";"63";"71502"
"3";"0";"3";"10";"63";"71503"
"6";"2";"4";"10";"63";"71507"
"6";"2";"4";"10";"63";"71510"
"2";"0";"2";"10";"63";"71516"
"1";"0";"1";"10";"63";"71517"
"5";"2";"3";"10";"63";"71523"
"2";"0";"2";"10";"63";"71524"
"5";"1";"4";"10";"63";"71526"
"1";"0";"1";"10";"63";"71527"
"2";"0";"2";"10";"63";"71528"
"2";"0";"2";"10";"63";"71532"
"1";"0";"1";"10";"63";"71538"
"2";"2";"0";"10";"63";"71539"
"3";"1";"2";"10";"63";"71544"
"2";"0";"2";"10";"63";"71550"
"3";"1";"2";"10";"63";"71555"
"3";"0";"3";"10";"63";"71557"
"2";"0";"2";"10";"63";"71560"
"8";"1";"7";"10";"63";"71562"
"4";"2";"2";"10";"63";"71569"
"1";"1";"0";"10";"63";"71571"
"1";"1";"0";"10";"63";"71574"
"5";"0";"5";"10";"63";"71578"
"5";"0";"5";"10";"63";"71584"
"1";"1";"0";"10";"63";"71588"
"6";"2";"4";"10";"63";"71590"
"1";"1";"0";"10";"63";"71591"
"4";"0";"4";"10";"63";"71592"
"3";"1";"2";"10";"63";"71593"
"6";"0";"6";"10";"63";"71596"
"1";"0";"1";"10";"63";"71598"
"2";"0";"2";"10";"63";"71599"
"12";"2";"10";"10";"63";"71600"
"7";"2";"5";"10";"63";"71602"
"1";"1";"0";"10";"63";"71605"
"2";"1";"1";"10";"63";"71607"
"4";"1";"3";"10";"63";"71609"
"6";"3";"3";"10";"63";"71613"
"3";"0";"3";"10";"63";"71614"
"1";"0";"1";"10";"63";"71615"
"4";"2";"2";"10";"63";"71616"
"7";"2";"5";"10";"63";"71620"
"2";"0";"2";"10";"63";"71621"
"2";"0";"2";"10";"63";"71624"
"2";"1";"1";"10";"63";"71625"
"1";"0";"1";"10";"63";"71628"
"1";"1";"0";"10";"63";"71629"
"1";"1";"0";"10";"63";"71633"
"3";"1";"2";"10";"63";"71634"
"1";"1";"0";"10";"63";"71635"
"1";"1";"0";"10";"63";"71637"
"3";"0";"3";"10";"63";"71638"
"5";"2";"3";"10";"63";"71645"
"2";"0";"2";"10";"63";"71648"
"1";"0";"1";"10";"63";"71652"
"3";"1";"2";"10";"63";"71653"
"6";"3";"3";"10";"63";"71656"
"2";"0";"2";"10";"63";"71657"
"8";"1";"7";"10";"63";"71660"
"2";"0";"2";"10";"63";"71663"
"4";"0";"4";"10";"63";"71668"
"7";"2";"5";"10";"63";"71671"
"1";"1";"0";"10";"63";"71679"
"1";"1";"0";"10";"63";"71685"
"1";"1";"0";"10";"63";"71691"
"8";"1";"7";"10";"63";"71692"
"1";"0";"1";"10";"63";"71694"
"8";"1";"7";"10";"63";"71695"
"10";"2";"8";"10";"63";"71702"
"13";"1";"12";"10";"63";"71705"
"19";"4";"15";"10";"63";"71713"
"5";"0";"5";"10";"63";"71716"
"5";"1";"4";"10";"63";"71721"
"9";"1";"8";"10";"63";"71728"
"2";"1";"1";"10";"63";"71730"
"5";"0";"5";"10";"63";"71732"
"16";"8";"8";"10";"63";"71733"
"5";"1";"4";"10";"63";"71737"
"1";"1";"0";"10";"63";"71740"
"6";"2";"4";"10";"63";"71742"
"1";"0";"1";"10";"63";"71751"
"1";"1";"0";"10";"63";"71754"
"1";"1";"0";"10";"63";"71756"
"10";"1";"9";"10";"63";"71759"
"1";"1";"0";"10";"63";"71761"
"1";"1";"0";"10";"63";"71770"
"2";"1";"1";"10";"63";"71775"
"5";"0";"5";"10";"63";"71779"
"2";"0";"2";"10";"63";"71786"
"1";"0";"1";"10";"63";"71787"
"2";"0";"2";"10";"63";"71789"
"5";"2";"3";"10";"63";"71791"
"1";"1";"0";"10";"63";"71794"
"1";"1";"0";"10";"63";"71800"
"1";"1";"0";"10";"63";"71803"
"28";"7";"21";"10";"63";"71806"
"29";"6";"23";"10";"63";"71809"
"5";"1";"4";"10";"63";"71812"
"5";"2";"3";"10";"63";"71814"
"2";"0";"2";"10";"63";"71824"
"1";"1";"0";"10";"63";"71829"
"8";"1";"7";"10";"63";"71842"
"1";"0";"1";"10";"63";"71846"
"4";"1";"3";"10";"63";"71852"
"5";"1";"4";"10";"63";"71853"
"5";"2";"3";"10";"63";"71854"
"1";"0";"1";"10";"63";"71857"
"4";"0";"4";"10";"63";"71859"
"1";"0";"1";"10";"63";"71866"
"3";"3";"0";"10";"63";"71870"
"3";"1";"2";"10";"63";"71872"
"2";"0";"2";"10";"63";"71878"
"1";"1";"0";"10";"63";"71879"
"1";"0";"1";"10";"63";"71882"
"5";"0";"5";"10";"63";"71887"
"1";"1";"0";"10";"63";"71889"
"4";"1";"3";"10";"63";"71892"
"7";"2";"5";"10";"63";"71895"
"4";"1";"3";"10";"63";"71898"
"7";"3";"4";"10";"63";"71906"
"3";"0";"3";"10";"63";"71908"
"6";"1";"5";"10";"63";"71918"
"7";"0";"7";"10";"63";"71922"
"1";"0";"1";"10";"63";"71924"
"6";"2";"4";"10";"63";"71931"
"3";"1";"2";"10";"63";"71934"
"1";"1";"0";"10";"63";"71936"
"1";"0";"1";"10";"63";"71937"
"9";"1";"8";"10";"63";"71939"
"4";"0";"4";"10";"63";"71944"
"2";"0";"2";"10";"63";"71946"
"4";"1";"3";"10";"63";"71947"
"3";"0";"3";"10";"63";"71948"
"1";"1";"0";"10";"63";"71951"
"5";"1";"4";"10";"63";"71958"
"3";"1";"2";"10";"63";"71959"
"53";"41";"12";"10";"63";"71962"
"1";"1";"0";"10";"63";"71964"
"1";"1";"0";"10";"63";"71971"
"2";"0";"2";"10";"63";"71980"
"1";"0";"1";"10";"63";"71983"
"4";"1";"3";"10";"63";"71989"
"1";"1";"0";"10";"63";"71992"
"3";"0";"3";"10";"63";"71996"
"1";"0";"1";"10";"63";"71997"
"2";"0";"2";"10";"63";"71999"
"8";"3";"5";"10";"63";"72002"
"1";"1";"0";"10";"63";"72003"
"4";"1";"3";"10";"63";"72004"
"6";"2";"4";"10";"63";"72007"
"3";"0";"3";"10";"63";"72020"
"2";"0";"2";"10";"63";"72021"
"2";"1";"1";"10";"63";"72022"
"3";"0";"3";"10";"63";"72025"
"5";"1";"4";"10";"63";"72031"
"10";"3";"7";"10";"63";"72033"
"8";"3";"5";"10";"63";"72037"
"1";"0";"1";"10";"63";"72042"
"3";"0";"3";"10";"63";"72045"
"2";"1";"1";"10";"63";"72049"
"2";"1";"1";"10";"63";"72054"
"32";"19";"13";"10";"63";"72065"
"3";"1";"2";"10";"63";"72066"
"2";"0";"2";"10";"63";"72067"
"1";"0";"1";"10";"63";"72075"
"1";"0";"1";"10";"63";"72097"
"29";"15";"14";"10";"63";"72103"
"4";"1";"3";"10";"63";"72107"
"4";"0";"4";"10";"63";"72109"
"1";"1";"0";"10";"63";"72116"
"8";"3";"5";"10";"63";"72118"
"1";"0";"1";"10";"63";"72121"
"17";"13";"4";"10";"63";"72123"
"1";"0";"1";"10";"63";"72126"
"8";"3";"5";"10";"63";"72130"
"31";"5";"26";"10";"63";"72131"
"1";"1";"0";"10";"63";"72132"
"3";"1";"2";"10";"63";"72134"
"1";"1";"0";"10";"63";"72136"
"6";"1";"5";"10";"63";"72138"
"3";"0";"3";"10";"63";"72140"
"3";"1";"2";"10";"63";"72142"
"2";"1";"1";"10";"63";"72148"
"4";"0";"4";"10";"63";"72149"
"5";"1";"4";"10";"63";"72153"
"1";"1";"0";"10";"63";"72155"
"4";"0";"4";"10";"63";"72159"
"3";"0";"3";"10";"63";"72160"
"12";"2";"10";"10";"63";"72171"
"2";"1";"1";"10";"63";"72176"
"5";"0";"5";"10";"63";"72177"
"1";"0";"1";"10";"63";"72181"
"2";"1";"1";"10";"63";"72182"
"2";"1";"1";"10";"63";"72185"
"1";"0";"1";"10";"63";"72187"
"3";"0";"3";"10";"63";"72190"
"3";"1";"2";"10";"63";"72191"
"2";"1";"1";"10";"63";"72198"
"1";"0";"1";"10";"63";"72202"
"1";"1";"0";"10";"63";"72203"
"1";"0";"1";"10";"63";"72207"
"7";"3";"4";"10";"63";"72215"
"7";"2";"5";"10";"63";"72217"
"4";"1";"3";"10";"63";"72219"
"4";"0";"4";"10";"63";"72222"
"2";"0";"2";"10";"63";"72232"
"1";"0";"1";"10";"63";"72233"
"5";"0";"5";"10";"63";"72235"
"2";"1";"1";"10";"63";"72236"
"21";"3";"18";"10";"63";"72238"
"1";"0";"1";"10";"63";"72239"
"18";"3";"15";"10";"63";"72240"
"17";"10";"7";"10";"63";"72241"
"4";"0";"4";"10";"63";"72246"
"11";"4";"7";"10";"63";"72250"
"2";"0";"2";"10";"63";"72251"
"3";"2";"1";"10";"63";"72252"
"1";"0";"1";"10";"63";"72254"
"2";"2";"0";"10";"63";"72258"
"7";"1";"6";"10";"63";"72261"
"2";"0";"2";"10";"63";"72262"
"5";"0";"5";"10";"63";"72264"
"3";"0";"3";"10";"63";"72270"
"3";"1";"2";"10";"63";"72273"
"4";"0";"4";"10";"63";"72279"
"2";"1";"1";"10";"63";"72280"
"2";"1";"1";"10";"63";"72281"
"1";"0";"1";"10";"63";"72282"
"1";"1";"0";"10";"63";"72286"
"3";"0";"3";"10";"63";"72288"
"1";"0";"1";"10";"63";"72303"
"4";"2";"2";"10";"63";"72306"
"63";"40";"23";"10";"63";"72308"
"2";"0";"2";"10";"63";"72310"
"1";"1";"0";"10";"63";"72311"
"3";"0";"3";"10";"63";"72312"
"1";"0";"1";"10";"63";"72315"
"6";"1";"5";"10";"63";"72323"
"2";"1";"1";"10";"63";"72324"
"4";"2";"2";"10";"63";"72325"
"4";"1";"3";"10";"63";"72328"
"1";"1";"0";"10";"63";"72329"
"6";"2";"4";"10";"63";"72330"
"1";"1";"0";"10";"63";"72331"
"1";"0";"1";"10";"63";"72332"
"1";"0";"1";"10";"63";"72334"
"2";"1";"1";"10";"63";"72335"
"4";"1";"3";"10";"63";"72339"
"4";"1";"3";"10";"63";"72340"
"2";"0";"2";"10";"63";"72349"
"6";"1";"5";"10";"63";"72356"
"2";"0";"2";"10";"63";"72369"
"1";"1";"0";"10";"63";"72372"
"2";"0";"2";"10";"63";"72376"
"11";"3";"8";"10";"63";"72377"
"3";"0";"3";"10";"63";"72379"
"1";"1";"0";"10";"63";"72383"
"2";"0";"2";"10";"63";"72394"
"8";"1";"7";"10";"63";"72395"
"1";"1";"0";"10";"63";"72407"
"1";"1";"0";"10";"63";"72410"
"10";"4";"6";"10";"63";"72411"
"1";"1";"0";"10";"63";"72416"
"1";"1";"0";"10";"63";"72417"
"2";"1";"1";"10";"63";"72419"
"1";"1";"0";"10";"63";"72420"
"5";"1";"4";"10";"63";"72421"
"4";"0";"4";"10";"63";"72431"
"2";"0";"2";"10";"63";"72432"
"6";"2";"4";"10";"63";"72434"
"1";"1";"0";"10";"63";"72437"
"4";"0";"4";"10";"63";"72440"
"3";"0";"3";"10";"63";"72445"
"5";"1";"4";"10";"63";"72447"
"4";"0";"4";"10";"63";"72451"
"3";"1";"2";"10";"63";"72452"
"16";"11";"5";"10";"63";"72461"
"3";"1";"2";"10";"63";"72462"
"1";"1";"0";"10";"63";"72466"
"2";"0";"2";"10";"63";"72472"
"14";"2";"12";"10";"63";"72475"
"1";"0";"1";"10";"63";"72478"
"2";"0";"2";"10";"63";"72479"
"5";"1";"4";"10";"63";"72480"
"5";"2";"3";"10";"63";"72481"
"4";"0";"4";"10";"63";"72482"
"7";"1";"6";"10";"63";"72496"
"4";"1";"3";"10";"63";"72507"
"4";"2";"2";"10";"63";"72508"
"1";"0";"1";"10";"63";"72514"
"3";"1";"2";"10";"63";"72518"
"3";"0";"3";"10";"63";"72526"
"1";"1";"0";"10";"63";"72528"
"2";"1";"1";"10";"63";"72529"
"3";"0";"3";"10";"63";"72532"
"14";"4";"10";"10";"63";"72536"
"3";"0";"3";"10";"63";"72537"
"1";"0";"1";"10";"63";"72539"
"1";"0";"1";"10";"63";"72544"
"3";"1";"2";"10";"63";"72545"
"1";"1";"0";"10";"63";"72554"
"1";"0";"1";"10";"63";"72555"
"1";"1";"0";"10";"63";"72556"
"8";"3";"5";"10";"63";"72559"
"4";"0";"4";"10";"63";"72566"
"1";"1";"0";"10";"63";"72568"
"1";"1";"0";"10";"63";"72570"
"4";"1";"3";"10";"63";"72571"
"3";"0";"3";"10";"63";"72575"
"4";"1";"3";"10";"63";"72577"
"3";"1";"2";"10";"63";"72578"
"4";"0";"4";"10";"63";"72580"
"2";"1";"1";"10";"63";"72581"
"12";"9";"3";"10";"63";"72590"
"7";"1";"6";"10";"63";"72591"
"2";"0";"2";"10";"63";"72593"
"1";"1";"0";"10";"63";"72597"
"2";"1";"1";"10";"63";"72605"
"7";"4";"3";"10";"63";"72606"
"17";"4";"13";"10";"63";"72607"
"16";"3";"13";"10";"63";"72611"
"1";"1";"0";"10";"63";"72614"
"7";"0";"7";"10";"63";"72620"
"1";"0";"1";"10";"63";"72621"
"2";"1";"1";"10";"63";"72622"
"1";"1";"0";"10";"63";"72632"
"2";"0";"2";"10";"63";"72633"
"4";"2";"2";"10";"63";"72635"
"5";"0";"5";"10";"63";"72636"
"2";"1";"1";"10";"63";"72638"
"8";"1";"7";"10";"63";"72639"
"2";"1";"1";"10";"63";"72641"
"10";"2";"8";"10";"63";"72645"
"10";"2";"8";"10";"63";"72646"
"2";"0";"2";"10";"63";"72648"
"1";"0";"1";"10";"63";"72649"
"1";"0";"1";"10";"63";"72650"
"1";"0";"1";"10";"63";"72652"
"6";"1";"5";"10";"63";"72657"
"2";"1";"1";"10";"63";"72659"
"3";"1";"2";"10";"63";"72664"
"2";"0";"2";"10";"63";"72665"
"1";"0";"1";"10";"63";"72667"
"4";"0";"4";"10";"63";"72671"
"2";"0";"2";"10";"63";"72674"
"1";"1";"0";"10";"63";"72682"
"7";"1";"6";"10";"63";"72690"
"2";"0";"2";"10";"63";"72698"
"1";"0";"1";"10";"63";"72699"
"2";"2";"0";"10";"63";"72702"
"1";"1";"0";"10";"63";"72705"
"5";"1";"4";"10";"63";"72707"
"3";"0";"3";"10";"63";"72709"
"1";"1";"0";"10";"63";"72711"
"2";"0";"2";"10";"63";"72712"
"2";"1";"1";"10";"63";"72714"
"1";"0";"1";"10";"63";"72717"
"3";"1";"2";"10";"63";"72725"
"1";"1";"0";"10";"63";"72729"
"1";"1";"0";"10";"63";"72736"
"1";"1";"0";"10";"63";"72737"
"4";"1";"3";"10";"63";"72738"
"8";"3";"5";"10";"63";"72743"
"2";"0";"2";"10";"63";"72745"
"7";"2";"5";"10";"63";"72749"
"5";"0";"5";"10";"63";"72752"
"5";"1";"4";"10";"63";"72760"
"5";"3";"2";"10";"63";"72764"
"2";"0";"2";"10";"63";"72769"
"3";"1";"2";"10";"63";"72773"
"2";"1";"1";"10";"63";"72774"
"2";"1";"1";"10";"63";"72776"
"1";"0";"1";"10";"63";"72777"
"1";"1";"0";"10";"63";"72779"
"3";"0";"3";"10";"63";"72784"
"1";"1";"0";"10";"63";"72785"
"5";"0";"5";"10";"63";"72786"
"6";"1";"5";"10";"63";"72788"
"3";"1";"2";"10";"63";"72789"
"3";"1";"2";"10";"63";"72796"
"3";"0";"3";"10";"63";"72800"
"9";"4";"5";"10";"63";"72806"
"2";"0";"2";"10";"63";"72807"
"4";"1";"3";"10";"63";"72809"
"18";"2";"16";"10";"63";"72812"
"2";"0";"2";"10";"63";"72817"
"4";"3";"1";"10";"63";"72818"
"2";"0";"2";"10";"63";"72820"
"6";"1";"5";"10";"63";"72822"
"2";"0";"2";"10";"63";"72825"
"1";"1";"0";"10";"63";"72827"
"2";"0";"2";"10";"63";"72828"
"1";"0";"1";"10";"63";"72829"
"9";"2";"7";"10";"63";"72839"
"5";"0";"5";"10";"63";"72840"
"1";"0";"1";"10";"63";"72844"
"5";"2";"3";"10";"63";"72847"
"2";"1";"1";"10";"63";"72850"
"1";"0";"1";"10";"63";"72854"
"2";"0";"2";"10";"63";"72855"
"1";"1";"0";"10";"63";"72860"
"4";"1";"3";"10";"63";"72861"
"11";"3";"8";"10";"63";"72864"
"4";"0";"4";"10";"63";"72865"
"6";"3";"3";"10";"63";"72870"
"2";"0";"2";"10";"63";"72872"
"3";"0";"3";"10";"63";"72873"
"1";"0";"1";"10";"63";"72891"
"2";"0";"2";"10";"63";"72893"
"6";"2";"4";"10";"63";"72895"
"5";"1";"4";"10";"63";"72896"
"1";"0";"1";"10";"63";"72898"
"10";"3";"7";"10";"63";"72900"
"2";"0";"2";"10";"63";"72901"
"2";"0";"2";"10";"63";"72905"
"1";"1";"0";"10";"63";"72908"
"1";"1";"0";"10";"63";"72911"
"4";"0";"4";"10";"63";"72914"
"2";"1";"1";"10";"63";"72916"
"5";"1";"4";"10";"63";"72920"
"1";"1";"0";"10";"63";"72923"
"4";"1";"3";"10";"63";"72924"
"6";"1";"5";"10";"63";"72925"
"2";"1";"1";"10";"63";"72926"
"2";"1";"1";"10";"63";"72934"
"1";"0";"1";"10";"63";"72935"
"2";"0";"2";"10";"63";"72938"
"1";"1";"0";"10";"63";"72940"
"1";"0";"1";"10";"63";"72941"
"2";"0";"2";"10";"63";"72943"
"3";"1";"2";"10";"63";"72953"
"3";"1";"2";"10";"63";"72954"
"1";"1";"0";"10";"63";"72960"
"15";"3";"12";"10";"63";"72962"
"3";"1";"2";"10";"63";"72964"
"192";"155";"37";"10";"63";"72969"
"1";"0";"1";"10";"63";"72975"
"4";"1";"3";"10";"63";"72976"
"5";"0";"5";"10";"63";"72987"
"9";"5";"4";"10";"63";"72991"
"4";"1";"3";"10";"63";"72994"
"2";"1";"1";"10";"63";"72999"
"5";"2";"3";"10";"63";"73000"
"4";"1";"3";"10";"63";"73002"
"5";"2";"3";"10";"63";"73006"
"4";"1";"3";"10";"63";"73009"
"5";"1";"4";"10";"63";"73010"
"4";"1";"3";"10";"63";"73011"
"23";"14";"9";"10";"63";"73016"
"9";"2";"7";"10";"63";"73017"
"7";"2";"5";"10";"63";"73018"
"5";"2";"3";"10";"63";"73020"
"4";"0";"4";"10";"63";"73022"
"6";"1";"5";"10";"63";"73024"
"4";"1";"3";"10";"63";"73028"
"4";"2";"2";"10";"63";"73029"
"4";"1";"3";"10";"63";"73032"
"21";"4";"17";"10";"63";"73039"
"1";"1";"0";"10";"63";"73042"
"4";"0";"4";"10";"63";"73044"
"3";"1";"2";"10";"63";"73045"
"2";"0";"2";"10";"63";"73048"
"7";"1";"6";"10";"63";"73049"
"2";"0";"2";"10";"63";"73053"
"7";"1";"6";"10";"63";"73059"
"3";"1";"2";"10";"63";"73060"
"2";"1";"1";"10";"63";"73064"
"3";"0";"3";"10";"63";"73065"
"15";"2";"13";"10";"63";"73070"
"2";"0";"2";"10";"63";"73072"
"1";"1";"0";"10";"63";"73075"
"1";"0";"1";"10";"63";"73083"
"3";"1";"2";"10";"63";"73088"
"2";"0";"2";"10";"63";"73095"
"103";"78";"25";"10";"63";"73098"
"3";"2";"1";"10";"63";"73099"
"2";"1";"1";"10";"63";"73100"
"2";"1";"1";"10";"63";"73103"
"2";"0";"2";"10";"63";"73104"
"4";"1";"3";"10";"63";"73108"
"8";"3";"5";"10";"63";"73109"
"4";"1";"3";"10";"63";"73110"
"5";"1";"4";"10";"63";"73127"
"6";"1";"5";"10";"63";"73136"
"1";"0";"1";"10";"63";"73149"
"1";"1";"0";"10";"63";"73151"
"7";"1";"6";"10";"63";"73154"
"2";"0";"2";"10";"63";"73156"
"20";"17";"3";"10";"63";"73163"
"5";"1";"4";"10";"63";"73164"
"1";"1";"0";"10";"63";"73165"
"23";"9";"14";"10";"63";"73173"
"6";"1";"5";"10";"63";"73176"
"6";"1";"5";"10";"63";"73180"
"4";"2";"2";"10";"63";"73190"
"2";"0";"2";"10";"63";"73191"
"1";"1";"0";"10";"63";"73195"
"3";"1";"2";"10";"63";"73197"
"15";"4";"11";"10";"63";"73199"
"6";"2";"4";"10";"63";"73202"
"23";"2";"21";"10";"63";"73204"
"1";"1";"0";"10";"63";"73207"
"5";"1";"4";"10";"63";"73209"
"6";"1";"5";"10";"63";"73210"
"8";"2";"6";"10";"63";"73213"
"2";"1";"1";"10";"63";"73217"
"4";"2";"2";"10";"63";"73219"
"6";"0";"6";"10";"63";"73220"
"1";"0";"1";"10";"63";"73222"
"1";"1";"0";"10";"63";"73232"
"2";"1";"1";"10";"63";"73234"
"1";"1";"0";"10";"63";"73236"
"4";"0";"4";"10";"63";"73238"
"3";"0";"3";"10";"63";"73239"
"3";"0";"3";"10";"63";"73242"
"2";"1";"1";"10";"63";"73243"
"2";"0";"2";"10";"63";"73261"
"5";"4";"1";"10";"63";"73268"
"9";"1";"8";"10";"63";"73269"
"1";"1";"0";"10";"63";"73270"
"3";"0";"3";"10";"63";"73285"
"2";"0";"2";"10";"63";"73290"
"5";"1";"4";"10";"63";"73292"
"1";"1";"0";"10";"63";"73294"
"88";"58";"30";"10";"63";"73297"
"1";"1";"0";"10";"63";"73300"
"1";"1";"0";"10";"63";"73301"
"1";"0";"1";"10";"63";"73303"
"1";"1";"0";"10";"63";"73305"
"3";"0";"3";"10";"63";"73310"
"5";"2";"3";"10";"63";"73313"
"6";"0";"6";"10";"63";"73317"
"4";"0";"4";"10";"63";"73320"
"1";"1";"0";"10";"63";"73321"
"3";"1";"2";"10";"63";"73322"
"1";"0";"1";"10";"63";"73328"
"1";"0";"1";"10";"63";"73329"
"1";"1";"0";"10";"63";"73335"
"3";"1";"2";"10";"63";"73339"
"6";"0";"6";"10";"63";"73346"
"1";"0";"1";"10";"63";"73355"
"7";"1";"6";"10";"63";"73359"
"2";"1";"1";"10";"63";"73363"
"2";"0";"2";"10";"63";"73364"
"22";"9";"13";"10";"63";"73367"
"3";"1";"2";"10";"63";"73369"
"5";"1";"4";"10";"63";"73370"
"1";"0";"1";"10";"63";"73371"
"5";"0";"5";"10";"63";"73374"
"3";"0";"3";"10";"63";"73378"
"2";"0";"2";"10";"63";"73380"
"22";"4";"18";"10";"63";"73393"
"2";"0";"2";"10";"63";"73395"
"5";"1";"4";"10";"63";"73396"
"1";"1";"0";"10";"63";"73402"
"5";"0";"5";"10";"63";"73404"
"3";"0";"3";"10";"63";"73405"
"3";"0";"3";"10";"63";"73409"
"5";"1";"4";"10";"63";"73410"
"2";"0";"2";"10";"63";"73412"
"1";"0";"1";"10";"63";"73417"
"3";"0";"3";"10";"63";"73418"
"7";"2";"5";"10";"63";"73430"
"5";"2";"3";"10";"63";"73432"
"3";"0";"3";"10";"63";"73435"
"2";"1";"1";"10";"63";"73436"
"1";"1";"0";"10";"63";"73438"
"20";"4";"16";"10";"63";"73447"
"10";"5";"5";"10";"63";"73449"
"2";"1";"1";"10";"63";"73450"
"2";"0";"2";"10";"63";"73456"
"4";"1";"3";"10";"63";"73458"
"5";"1";"4";"10";"63";"73462"
"1";"0";"1";"10";"63";"73468"
"6";"0";"6";"10";"63";"73472"
"2";"0";"2";"10";"63";"73475"
"5";"1";"4";"10";"63";"73476"
"2";"0";"2";"10";"63";"73482"
"5";"1";"4";"10";"63";"73485"
"1";"1";"0";"10";"63";"73491"
"2";"0";"2";"10";"63";"73500"
"4";"0";"4";"10";"63";"73501"
"8";"2";"6";"10";"63";"73503"
"2";"0";"2";"10";"63";"73505"
"8";"0";"8";"10";"63";"73507"
"1";"1";"0";"10";"63";"73508"
"3";"1";"2";"10";"63";"73520"
"2";"0";"2";"10";"63";"73522"
"1";"1";"0";"10";"63";"73523"
"4";"0";"4";"10";"63";"73526"
"4";"2";"2";"10";"63";"73532"
"2";"0";"2";"10";"63";"73536"
"16";"6";"10";"10";"63";"73537"
"1";"0";"1";"10";"63";"73539"
"1";"1";"0";"10";"63";"73542"
"3";"1";"2";"10";"63";"73544"
"2";"0";"2";"10";"63";"73548"
"3";"1";"2";"10";"63";"73552"
"1";"1";"0";"10";"63";"73559"
"3";"1";"2";"10";"63";"73562"
"2";"0";"2";"10";"63";"73568"
"3";"0";"3";"10";"63";"73575"
"6";"1";"5";"10";"63";"73584"
"5";"5";"0";"10";"63";"73589"
"1";"0";"1";"10";"63";"73590"
"1";"1";"0";"10";"63";"73594"
"2";"1";"1";"10";"63";"73598"
"4";"0";"4";"10";"63";"73601"
"2";"0";"2";"10";"63";"73609"
"2";"1";"1";"10";"63";"73610"
"9";"3";"6";"10";"63";"73612"
"67";"44";"23";"10";"63";"73623"
"2";"0";"2";"10";"63";"73624"
"7";"2";"5";"10";"63";"73630"
"1";"0";"1";"10";"63";"73632"
"1";"0";"1";"10";"63";"73644"
"8";"0";"8";"10";"63";"73651"
"6";"2";"4";"10";"63";"73654"
"2";"0";"2";"10";"63";"73655"
"4";"0";"4";"10";"63";"73658"
"4";"0";"4";"10";"63";"73659"
"6";"2";"4";"10";"63";"73663"
"6";"1";"5";"10";"63";"73674"
"1";"0";"1";"10";"63";"73676"
"2";"1";"1";"10";"63";"73679"
"4";"0";"4";"10";"63";"73680"
"4";"1";"3";"10";"63";"73681"
"2";"1";"1";"10";"63";"73684"
"1";"0";"1";"10";"63";"73685"
"10";"1";"9";"10";"63";"73699"
"1";"0";"1";"10";"63";"73701"
"3";"1";"2";"10";"63";"73705"
"2";"0";"2";"10";"63";"73712"
"3";"0";"3";"10";"63";"73721"
"3";"0";"3";"10";"63";"73724"
"4";"1";"3";"10";"63";"73725"
"2";"1";"1";"10";"63";"73730"
"2";"1";"1";"10";"63";"73742"
"39";"8";"31";"10";"63";"73744"
"2";"1";"1";"10";"63";"73748"
"20";"4";"16";"10";"63";"73749"
"4";"1";"3";"10";"63";"73751"
"100";"57";"43";"10";"63";"73752"
"5";"2";"3";"10";"63";"73755"
"1";"0";"1";"10";"63";"73756"
"1";"1";"0";"10";"63";"73758"
"2";"0";"2";"10";"63";"73771"
"1";"0";"1";"10";"63";"73773"
"1";"1";"0";"10";"63";"73774"
"2";"0";"2";"10";"63";"73785"
"2";"0";"2";"10";"63";"73792"
"7";"2";"5";"10";"63";"73800"
"2";"0";"2";"10";"63";"73801"
"1";"0";"1";"10";"63";"73803"
"1";"0";"1";"10";"63";"73804"
"2";"1";"1";"10";"63";"73805"
"5";"0";"5";"10";"63";"73809"
"2";"1";"1";"10";"63";"73811"
"4";"1";"3";"10";"63";"73815"
"5";"1";"4";"10";"63";"73820"
"1";"1";"0";"10";"63";"73821"
"2";"0";"2";"10";"63";"73823"
"1";"1";"0";"10";"63";"73824"
"1";"0";"1";"10";"63";"73840"
"1";"1";"0";"10";"63";"73852"
"4";"1";"3";"10";"63";"73858"
"20";"3";"17";"10";"63";"73863"
"1";"1";"0";"10";"63";"73864"
"1";"1";"0";"10";"63";"73865"
"3";"0";"3";"10";"63";"73869"
"3";"1";"2";"10";"63";"73877"
"2";"0";"2";"10";"63";"73878"
"8";"3";"5";"10";"63";"73882"
"3";"0";"3";"10";"63";"73883"
"6";"1";"5";"10";"63";"73885"
"3";"1";"2";"10";"63";"73898"
"8";"2";"6";"10";"63";"73901"
"4";"1";"3";"10";"63";"73905"
"2";"0";"2";"10";"63";"73914"
"2";"0";"2";"10";"63";"73915"
"1";"0";"1";"10";"63";"73917"
"7";"2";"5";"10";"63";"73922"
"1";"0";"1";"10";"63";"73924"
"2";"0";"2";"10";"63";"73930"
"2";"0";"2";"10";"63";"73933"
"3";"0";"3";"10";"63";"73936"
"2";"1";"1";"10";"63";"73938"
"1";"1";"0";"10";"63";"73941"
"4";"2";"2";"10";"63";"73942"
"1";"0";"1";"10";"63";"73946"
"2";"0";"2";"10";"63";"73947"
"2";"0";"2";"10";"63";"73948"
"1";"1";"0";"10";"63";"73950"
"5";"1";"4";"10";"63";"73959"
"3";"0";"3";"10";"63";"73964"
"1";"0";"1";"10";"63";"73966"
"1";"1";"0";"10";"63";"73968"
"15";"5";"10";"10";"63";"73969"
"4";"1";"3";"10";"63";"73971"
"9";"5";"4";"10";"63";"73977"
"7";"0";"7";"10";"63";"73983"
"1";"1";"0";"10";"63";"73993"
"8";"1";"7";"10";"63";"73996"
"3";"0";"3";"10";"63";"73998"
"2";"0";"2";"10";"63";"73999"
"4";"2";"2";"10";"63";"74000"
"4";"1";"3";"10";"63";"74003"
"10";"7";"3";"10";"63";"74009"
"1";"0";"1";"10";"63";"74024"
"2";"1";"1";"10";"63";"74025"
"3";"1";"2";"10";"63";"74026"
"2";"0";"2";"10";"63";"74033"
"1";"1";"0";"10";"63";"74036"
"1";"0";"1";"10";"63";"74041"
"1";"0";"1";"10";"63";"74042"
"2";"0";"2";"10";"63";"74044"
"2";"0";"2";"10";"63";"74046"
"2";"0";"2";"10";"63";"74047"
"2";"0";"2";"10";"63";"74051"
"2";"1";"1";"10";"63";"74052"
"1";"1";"0";"10";"63";"74054"
"1";"1";"0";"10";"63";"74056"
"1";"0";"1";"10";"63";"74057"
"1";"0";"1";"10";"63";"74065"
"2";"0";"2";"10";"63";"74069"
"1";"1";"0";"10";"63";"74071"
"1";"0";"1";"10";"63";"74074"
"2";"0";"2";"10";"63";"74084"
"1";"1";"0";"10";"63";"74091"
"7";"0";"7";"10";"63";"74094"
"2";"1";"1";"10";"63";"74105"
"4";"1";"3";"10";"63";"74108"
"2";"0";"2";"10";"63";"74111"
"2";"0";"2";"10";"63";"74113"
"5";"1";"4";"10";"63";"74114"
"1";"0";"1";"10";"63";"74119"
"4";"1";"3";"10";"63";"74122"
"1";"1";"0";"10";"63";"74123"
"2";"0";"2";"10";"63";"74126"
"4";"0";"4";"10";"63";"74127"
"3";"1";"2";"10";"63";"74128"
"387";"310";"77";"10";"63";"74134"
"8";"1";"7";"10";"63";"74144"
"3";"1";"2";"10";"63";"74145"
"3";"1";"2";"10";"63";"74159"
"1";"1";"0";"10";"63";"74165"
"3";"1";"2";"10";"63";"74168"
"3";"1";"2";"10";"63";"74169"
"1";"0";"1";"10";"63";"74174"
"7";"3";"4";"10";"63";"74176"
"7";"0";"7";"10";"63";"74181"
"2";"0";"2";"10";"63";"74182"
"1";"1";"0";"10";"63";"74183"
"3";"1";"2";"10";"63";"74186"
"1";"1";"0";"10";"63";"74187"
"15";"4";"11";"10";"63";"74188"
"3";"2";"1";"10";"63";"74189"
"1";"0";"1";"10";"63";"74200"
"3";"1";"2";"10";"63";"74212"
"1";"1";"0";"10";"63";"74221"
"1";"0";"1";"10";"63";"74223"
"3";"0";"3";"10";"63";"74224"
"1";"0";"1";"10";"63";"74226"
"1";"0";"1";"10";"63";"74228"
"2";"0";"2";"10";"63";"74229"
"1";"1";"0";"10";"63";"74231"
"2";"0";"2";"10";"63";"74236"
"2";"0";"2";"10";"63";"74244"
"2";"0";"2";"10";"63";"74245"
"31";"7";"24";"10";"63";"74249"
"2";"0";"2";"10";"63";"74252"
"1";"1";"0";"10";"63";"74258"
"2";"0";"2";"10";"63";"74260"
"4";"0";"4";"10";"63";"74270"
"4";"0";"4";"10";"63";"74272"
"3";"1";"2";"10";"63";"74276"
"1";"0";"1";"10";"63";"74291"
"3";"1";"2";"10";"63";"74296"
"1";"1";"0";"10";"63";"74306"
"1";"0";"1";"10";"63";"74308"
"3";"1";"2";"10";"63";"74318"
"2";"1";"1";"10";"63";"74322"
"1";"0";"1";"10";"63";"74327"
"3";"1";"2";"10";"63";"74328"
"2";"0";"2";"10";"63";"74329"
"3";"1";"2";"10";"63";"74334"
"1";"0";"1";"10";"63";"74340"
"7";"1";"6";"10";"63";"74346"
"5";"1";"4";"10";"63";"74350"
"3";"3";"0";"10";"63";"74351"
"2";"0";"2";"10";"63";"74355"
"1";"0";"1";"10";"63";"74359"
"6";"4";"2";"10";"63";"74364"
"1";"0";"1";"10";"63";"74367"
"2";"0";"2";"10";"63";"74371"
"8";"2";"6";"10";"63";"74374"
"3";"0";"3";"10";"63";"74375"
"3";"1";"2";"10";"63";"74379"
"2";"1";"1";"10";"63";"74385"
"2";"1";"1";"10";"63";"74389"
"5";"0";"5";"10";"63";"74390"
"9";"2";"7";"10";"63";"74391"
"1";"0";"1";"10";"63";"74403"
"6";"1";"5";"10";"63";"74404"
"5";"1";"4";"10";"63";"74407"
"1";"0";"1";"10";"63";"74408"
"27";"19";"8";"10";"63";"74412"
"2";"1";"1";"10";"63";"74414"
"2";"0";"2";"10";"63";"74417"
"3";"0";"3";"10";"63";"74422"
"7";"3";"4";"10";"63";"74423"
"5";"2";"3";"10";"63";"74426"
"5";"2";"3";"10";"63";"74427"
"1";"1";"0";"10";"63";"74431"
"1";"1";"0";"10";"63";"74437"
"2";"0";"2";"10";"63";"74442"
"3";"1";"2";"10";"63";"74444"
"8";"4";"4";"10";"63";"74447"
"3";"1";"2";"10";"63";"74451"
"2";"1";"1";"10";"63";"74464"
"1";"0";"1";"10";"63";"74485"
"6";"0";"6";"10";"63";"74487"
"6";"1";"5";"10";"63";"74490"
"3";"0";"3";"10";"63";"74492"
"1";"0";"1";"10";"63";"74496"
"15";"1";"14";"10";"63";"74499"
"1";"1";"0";"10";"63";"74501"
"2";"1";"1";"10";"63";"74504"
"8";"2";"6";"10";"63";"74508"
"7";"1";"6";"10";"63";"74513"
"1";"0";"1";"10";"63";"74519"
"5";"1";"4";"10";"63";"74520"
"2";"1";"1";"10";"63";"74524"
"4";"1";"3";"10";"63";"74525"
"2";"1";"1";"10";"63";"74529"
"4";"1";"3";"10";"63";"74540"
"1";"1";"0";"10";"63";"74550"
"1";"0";"1";"10";"63";"74552"
"15";"4";"11";"10";"63";"74560"
"4";"0";"4";"10";"63";"74562"
"23";"1";"22";"10";"63";"74565"
"6";"1";"5";"10";"63";"74567"
"3";"0";"3";"10";"63";"74568"
"2";"0";"2";"10";"63";"74569"
"22";"7";"15";"10";"63";"74570"
"1";"1";"0";"10";"63";"74574"
"2";"1";"1";"10";"63";"74576"
"1";"1";"0";"10";"63";"74578"
"6";"1";"5";"10";"63";"74580"
"22";"15";"7";"10";"63";"74581"
"2";"0";"2";"10";"63";"74582"
"2";"0";"2";"10";"63";"74584"
"3";"1";"2";"10";"63";"74592"
"1";"0";"1";"10";"63";"74595"
"6";"1";"5";"10";"63";"74597"
"3";"2";"1";"10";"63";"74601"
"4";"0";"4";"10";"63";"74606"
"4";"1";"3";"10";"63";"74612"
"1";"1";"0";"10";"63";"74613"
"1";"1";"0";"10";"63";"74621"
"11";"3";"8";"10";"63";"74622"
"4";"1";"3";"10";"63";"74626"
"3";"1";"2";"10";"63";"74628"
"11";"2";"9";"10";"63";"74629"
"2";"0";"2";"10";"63";"74631"
"15";"2";"13";"10";"63";"74634"
"2";"0";"2";"10";"63";"74636"
"1";"1";"0";"10";"63";"74640"
"1";"1";"0";"10";"63";"74642"
"1";"0";"1";"10";"63";"74645"
"1";"0";"1";"10";"63";"74647"
"1";"1";"0";"10";"63";"74661"
"9";"6";"3";"10";"63";"74662"
"1";"0";"1";"10";"63";"74666"
"2";"0";"2";"10";"63";"74667"
"4";"1";"3";"10";"63";"74669"
"2";"2";"0";"10";"63";"74670"
"4";"0";"4";"10";"63";"74675"
"1";"1";"0";"10";"63";"74677"
"3";"0";"3";"10";"63";"74680"
"1";"1";"0";"10";"63";"74682"
"4";"1";"3";"10";"63";"74685"
"1";"0";"1";"10";"63";"74686"
"5";"2";"3";"10";"63";"74687"
"1";"1";"0";"10";"63";"74689"
"1";"0";"1";"10";"63";"74699"
"8";"1";"7";"10";"63";"74702"
"1";"0";"1";"10";"63";"74714"
"6";"1";"5";"10";"63";"74716"
"11";"3";"8";"10";"63";"74717"
"5";"0";"5";"10";"63";"74718"
"4";"0";"4";"10";"63";"74722"
"1";"1";"0";"10";"63";"74740"
"2";"1";"1";"10";"63";"74741"
"2";"1";"1";"10";"63";"74743"
"5";"2";"3";"10";"63";"74744"
"8";"1";"7";"10";"63";"74745"
"1";"0";"1";"10";"63";"74749"
"1";"1";"0";"10";"63";"74751"
"1";"0";"1";"10";"63";"74752"
"2";"0";"2";"10";"63";"74753"
"1";"1";"0";"10";"63";"74756"
"4";"1";"3";"10";"63";"74757"
"1";"1";"0";"10";"63";"74758"
"8";"2";"6";"10";"63";"74762"
"1";"1";"0";"10";"63";"74770"
"1";"0";"1";"10";"63";"74772"
"3";"1";"2";"10";"63";"74777"
"3";"1";"2";"10";"63";"74780"
"1";"0";"1";"10";"63";"74784"
"2";"0";"2";"10";"63";"74787"
"4";"1";"3";"10";"63";"74789"
"2";"1";"1";"10";"63";"74795"
"1";"0";"1";"10";"63";"74804"
"1";"1";"0";"10";"63";"74810"
"2";"1";"1";"10";"63";"74821"
"3";"0";"3";"10";"63";"74825"
"2";"0";"2";"10";"63";"74828"
"1";"0";"1";"10";"63";"74831"
"1";"1";"0";"10";"63";"74847"
"19";"10";"9";"10";"63";"74848"
"1";"1";"0";"10";"63";"74849"
"3";"1";"2";"10";"63";"74850"
"1";"1";"0";"10";"63";"74852"
"3";"1";"2";"10";"63";"74854"
"14";"7";"7";"10";"63";"74856"
"4";"1";"3";"10";"63";"74860"
"1";"1";"0";"10";"63";"74864"
"1";"0";"1";"10";"63";"74865"
"3";"0";"3";"10";"63";"74877"
"11";"0";"11";"10";"63";"74879"
"4";"0";"4";"10";"63";"74882"
"1";"0";"1";"10";"63";"74883"
"1";"1";"0";"10";"63";"74892"
"6";"1";"5";"10";"63";"74897"
"2";"0";"2";"10";"63";"74900"
"4";"1";"3";"10";"63";"74904"
"29";"6";"23";"10";"63";"74905"
"3";"0";"3";"10";"63";"74908"
"6";"1";"5";"10";"63";"74918"
"2";"0";"2";"10";"63";"74921"
"4";"1";"3";"10";"63";"74946"
"1";"1";"0";"10";"63";"74949"
"1";"1";"0";"10";"63";"74951"
"1";"0";"1";"10";"63";"74954"
"5";"1";"4";"10";"63";"74955"
"1";"0";"1";"10";"63";"74967"
"4";"0";"4";"10";"63";"74968"
"1";"1";"0";"10";"63";"74974"
"2";"0";"2";"10";"63";"74984"
"2";"0";"2";"10";"63";"74989"
"1";"1";"0";"10";"63";"74991"
"2";"0";"2";"10";"63";"74992"
"2";"1";"1";"10";"63";"74997"
"2";"1";"1";"10";"63";"75000"
"1";"0";"1";"10";"63";"75010"
"7";"1";"6";"10";"63";"75012"
"2";"1";"1";"10";"63";"75027"
"4";"1";"3";"10";"63";"75029"
"3";"1";"2";"10";"63";"75036"
"1";"0";"1";"10";"63";"75045"
"5";"2";"3";"10";"63";"75056"
"2";"1";"1";"10";"63";"75057"
"2";"0";"2";"10";"63";"75063"
"8";"3";"5";"10";"63";"75067"
"5";"1";"4";"10";"63";"75075"
"3";"1";"2";"10";"63";"75079"
"1";"1";"0";"10";"63";"75080"
"6";"2";"4";"10";"63";"75081"
"4";"0";"4";"10";"63";"75084"
"1";"1";"0";"10";"63";"75085"
"1";"1";"0";"10";"63";"75094"
"2";"0";"2";"10";"63";"75097"
"12";"2";"10";"10";"63";"75101"
"4";"1";"3";"10";"63";"75113"
"3";"1";"2";"10";"63";"75114"
"3";"1";"2";"10";"63";"75119"
"3";"0";"3";"10";"63";"75130"
"1";"0";"1";"10";"63";"75136"
"1";"0";"1";"10";"63";"75140"
"8";"4";"4";"10";"63";"75150"
"3";"1";"2";"10";"63";"75151"
"26";"3";"23";"10";"63";"75165"
"4";"0";"4";"10";"63";"75166"
"1";"1";"0";"10";"63";"75187"
"4";"1";"3";"10";"63";"75188"
"5";"1";"4";"10";"63";"75195"
"3";"0";"3";"10";"63";"75196"
"7";"1";"6";"10";"63";"75206"
"3";"0";"3";"10";"63";"75208"
"5";"2";"3";"10";"63";"75210"
"4";"1";"3";"10";"63";"75213"
"1";"0";"1";"10";"63";"75216"
"1";"0";"1";"10";"63";"75217"
"2";"0";"2";"10";"63";"75219"
"3";"0";"3";"10";"63";"75220"
"3";"1";"2";"10";"63";"75226"
"5";"1";"4";"10";"63";"75228"
"3";"0";"3";"10";"63";"75232"
"1";"1";"0";"10";"63";"75238"
"1";"1";"0";"10";"63";"75245"
"2";"0";"2";"10";"63";"75253"
"2";"2";"0";"10";"63";"75256"
"2";"0";"2";"10";"63";"75257"
"2";"1";"1";"10";"63";"75259"
"3";"0";"3";"10";"63";"75261"
"3";"0";"3";"10";"63";"75264"
"2";"0";"2";"10";"63";"75265"
"2";"2";"0";"10";"63";"75266"
"5";"2";"3";"10";"63";"75270"
"2";"0";"2";"10";"63";"75272"
"3";"1";"2";"10";"63";"75274"
"1";"1";"0";"10";"63";"75277"
"16";"4";"12";"10";"63";"75280"
"4";"1";"3";"10";"63";"75283"
"4";"0";"4";"10";"63";"75286"
"5";"3";"2";"10";"63";"75287"
"2";"1";"1";"10";"63";"75289"
"3";"0";"3";"10";"63";"75290"
"4";"1";"3";"10";"63";"75298"
"5";"1";"4";"10";"63";"75304"
"5";"0";"5";"10";"63";"75308"
"5";"1";"4";"10";"63";"75311"
"129";"86";"43";"10";"63";"75314"
"3";"0";"3";"10";"63";"75316"
"1";"0";"1";"10";"63";"75320"
"6";"1";"5";"10";"63";"75323"
"4";"1";"3";"10";"63";"75327"
"4";"0";"4";"10";"63";"75328"
"4";"0";"4";"10";"63";"75329"
"4";"1";"3";"10";"63";"75331"
"1";"1";"0";"10";"63";"75333"
"2";"0";"2";"10";"63";"75334"
"3";"0";"3";"10";"63";"75335"
"1";"1";"0";"10";"63";"75338"
"8";"2";"6";"10";"63";"75342"
"2";"0";"2";"10";"63";"75345"
"5";"0";"5";"10";"63";"75350"
"1";"1";"0";"10";"63";"75362"
"3";"1";"2";"10";"63";"75363"
"5";"0";"5";"10";"63";"75365"
"1";"1";"0";"10";"63";"75366"
"1";"0";"1";"10";"63";"75367"
"3";"0";"3";"10";"63";"75368"
"5";"0";"5";"10";"63";"75369"
"2";"0";"2";"10";"63";"75370"
"1";"0";"1";"10";"63";"75373"
"4";"2";"2";"10";"63";"75376"
"9";"1";"8";"10";"63";"75378"
"1";"1";"0";"10";"63";"75380"
"3";"1";"2";"10";"63";"75395"
"2";"1";"1";"10";"63";"75397"
"3";"1";"2";"10";"63";"75402"
"1";"0";"1";"10";"63";"75408"
"5";"0";"5";"10";"63";"75409"
"3";"0";"3";"10";"63";"75413"
"2";"0";"2";"10";"63";"75434"
"2";"0";"2";"10";"63";"75441"
"6";"2";"4";"10";"63";"75443"
"1";"1";"0";"10";"63";"75456"
"4";"2";"2";"10";"63";"75458"
"1";"1";"0";"10";"63";"75461"
"5";"0";"5";"10";"63";"75462"
"1";"1";"0";"10";"63";"75463"
"1";"0";"1";"10";"63";"75464"
"4";"1";"3";"10";"63";"75468"
"6";"1";"5";"10";"63";"75471"
"1";"1";"0";"10";"63";"75474"
"11";"2";"9";"10";"63";"75475"
"4";"0";"4";"10";"63";"75478"
"1";"1";"0";"10";"63";"75480"
"8";"2";"6";"10";"63";"75484"
"6";"2";"4";"10";"63";"75486"
"5";"1";"4";"10";"63";"75490"
"6";"0";"6";"10";"63";"75491"
"8";"5";"3";"10";"63";"75498"
"2";"1";"1";"10";"63";"75508"
"2";"0";"2";"10";"63";"75509"
"2";"0";"2";"10";"63";"75512"
"4";"1";"3";"10";"63";"75519"
"2";"0";"2";"10";"63";"75520"
"1";"1";"0";"10";"63";"75522"
"2";"0";"2";"10";"63";"75524"
"6";"2";"4";"10";"63";"75536"
"1";"0";"1";"10";"63";"75537"
"1";"0";"1";"10";"63";"75542"
"10";"0";"10";"10";"63";"75551"
"4";"1";"3";"10";"63";"75552"
"1";"1";"0";"10";"63";"75556"
"6";"5";"1";"10";"63";"75557"
"4";"2";"2";"10";"63";"75566"
"1";"1";"0";"10";"63";"75569"
"3";"0";"3";"10";"63";"75573"
"2";"0";"2";"10";"63";"75578"
"5";"1";"4";"10";"63";"75586"
"2";"0";"2";"10";"63";"75592"
"1";"1";"0";"10";"63";"75609"
"1";"0";"1";"10";"63";"75615"
"1";"1";"0";"10";"63";"75616"
"2";"0";"2";"10";"63";"75617"
"2";"1";"1";"10";"63";"75620"
"3";"1";"2";"10";"63";"75622"
"6";"4";"2";"10";"63";"75628"
"8";"0";"8";"10";"63";"75629"
"2";"0";"2";"10";"63";"75630"
"10";"7";"3";"10";"63";"75632"
"3";"0";"3";"10";"63";"75637"
"4";"1";"3";"10";"63";"75638"
"6";"0";"6";"10";"63";"75644"
"2";"0";"2";"10";"63";"75646"
"14";"7";"7";"10";"63";"75649"
"1";"1";"0";"10";"63";"75650"
"1";"0";"1";"10";"63";"75651"
"1";"0";"1";"10";"63";"75652"
"3";"0";"3";"10";"63";"75655"
"3";"1";"2";"10";"63";"75660"
"1";"1";"0";"10";"63";"75662"
"1";"1";"0";"10";"63";"75664"
"2";"1";"1";"10";"63";"75666"
"6";"4";"2";"10";"63";"75675"
"10";"7";"3";"10";"63";"75679"
"6";"3";"3";"10";"63";"75681"
"5";"2";"3";"10";"63";"75689"
"3";"1";"2";"10";"63";"75692"
"1";"1";"0";"10";"63";"75697"
"6";"1";"5";"10";"63";"75698"
"1";"1";"0";"10";"63";"75701"
"2";"1";"1";"10";"63";"75702"
"1";"1";"0";"10";"63";"75703"
"1";"1";"0";"10";"63";"75709"
"8";"0";"8";"10";"63";"75715"
"9";"3";"6";"10";"63";"75716"
"1";"1";"0";"10";"63";"75718"
"1";"1";"0";"10";"63";"75730"
"2";"0";"2";"10";"63";"75733"
"5";"1";"4";"10";"63";"75736"
"4";"0";"4";"10";"63";"75741"
"27";"10";"17";"10";"63";"75745"
"1";"0";"1";"10";"63";"75746"
"5";"1";"4";"10";"63";"75750"
"3";"1";"2";"10";"63";"75754"
"4";"2";"2";"10";"63";"75766"
"1";"1";"0";"10";"63";"75768"
"8";"1";"7";"10";"63";"75775"
"4";"1";"3";"10";"63";"75783"
"35";"24";"11";"10";"63";"75790"
"4";"1";"3";"10";"63";"75800"
"1";"1";"0";"10";"63";"75802"
"12";"8";"4";"10";"63";"75805"
"1";"1";"0";"10";"63";"75806"
"7";"2";"5";"10";"63";"75819"
"1";"0";"1";"10";"63";"75821"
"6";"1";"5";"10";"63";"75822"
"2";"0";"2";"10";"63";"75825"
"1";"1";"0";"10";"63";"75827"
"3";"0";"3";"10";"63";"75830"
"1";"1";"0";"10";"63";"75833"
"2";"0";"2";"10";"63";"75842"
"2";"0";"2";"10";"63";"75844"
"1";"1";"0";"10";"63";"75847"
"1";"0";"1";"10";"63";"75849"
"4";"2";"2";"10";"63";"75857"
"5";"0";"5";"10";"63";"75860"
"3";"1";"2";"10";"63";"75865"
"1";"0";"1";"10";"63";"75869"
"2";"0";"2";"10";"63";"75873"
"5";"1";"4";"10";"63";"75875"
"6";"2";"4";"10";"63";"75884"
"4";"0";"4";"10";"63";"75886"
"4";"0";"4";"10";"63";"75887"
"8";"2";"6";"10";"63";"75888"
"3";"0";"3";"10";"63";"75891"
"2";"0";"2";"10";"63";"75892"
"4";"0";"4";"10";"63";"75899"
"4";"1";"3";"10";"63";"75903"
"3";"0";"3";"10";"63";"75904"
"2";"0";"2";"10";"63";"75908"
"1";"1";"0";"10";"63";"75912"
"2";"0";"2";"10";"63";"75915"
"2";"1";"1";"10";"63";"75917"
"2";"0";"2";"10";"63";"75920"
"1";"0";"1";"10";"63";"75929"
"3";"1";"2";"10";"63";"75930"
"2";"0";"2";"10";"63";"75934"
"4";"1";"3";"10";"63";"75941"
"4";"1";"3";"10";"63";"75948"
"3";"0";"3";"10";"63";"75952"
"2";"1";"1";"10";"63";"75955"
"8";"2";"6";"10";"63";"75956"
"6";"2";"4";"10";"63";"75957"
"1";"1";"0";"10";"63";"75958"
"3";"1";"2";"10";"63";"75959"
"2";"0";"2";"10";"63";"75960"
"1";"1";"0";"10";"63";"75963"
"1";"1";"0";"10";"63";"75964"
"13";"5";"8";"10";"63";"75966"
"6";"2";"4";"10";"63";"75968"
"14";"9";"5";"10";"63";"75969"
"3";"0";"3";"10";"63";"75976"
"1";"1";"0";"10";"63";"75978"
"2";"0";"2";"10";"63";"75979"
"2";"0";"2";"10";"63";"75982"
"1";"0";"1";"10";"63";"75983"
"5";"1";"4";"10";"63";"75985"
"6";"0";"6";"10";"63";"75989"
"1";"0";"1";"10";"63";"75990"
"3";"1";"2";"10";"63";"75999"
"2";"2";"0";"10";"63";"76001"
"4";"1";"3";"10";"63";"76002"
"4";"1";"3";"10";"63";"76005"
"2";"0";"2";"10";"63";"76008"
"1";"1";"0";"10";"63";"76014"
"4";"1";"3";"10";"63";"76016"
"9";"2";"7";"10";"63";"76027"
"4";"2";"2";"10";"63";"76030"
"4";"1";"3";"10";"63";"76038"
"6";"1";"5";"10";"63";"76039"
"4";"1";"3";"10";"63";"76056"
"5";"1";"4";"10";"63";"76057"
"9";"4";"5";"10";"63";"76059"
"1";"0";"1";"10";"63";"76064"
"5";"1";"4";"10";"63";"76067"
"2";"1";"1";"10";"63";"76070"
"2";"1";"1";"10";"63";"76071"
"2";"0";"2";"10";"63";"76078"
"1";"1";"0";"10";"63";"76079"
"4";"0";"4";"10";"63";"76080"
"2";"0";"2";"10";"63";"76084"
"1";"1";"0";"10";"63";"76086"
"2";"1";"1";"10";"63";"76093"
"4";"1";"3";"10";"63";"76094"
"7";"1";"6";"10";"63";"76096"
"2";"0";"2";"10";"63";"76097"
"3";"1";"2";"10";"63";"76098"
"2";"1";"1";"10";"63";"76103"
"5";"2";"3";"10";"63";"76105"
"5";"2";"3";"10";"63";"76106"
"5";"1";"4";"10";"63";"76108"
"5";"2";"3";"10";"63";"76114"
"2";"0";"2";"10";"63";"76115"
"2";"1";"1";"10";"63";"76117"
"7";"2";"5";"10";"63";"76131"
"3";"1";"2";"10";"63";"76132"
"1";"1";"0";"10";"63";"76148"
"3";"1";"2";"10";"63";"76150"
"1";"1";"0";"10";"63";"76153"
"4";"1";"3";"10";"63";"76156"
"9";"0";"9";"10";"63";"76162"
"1";"1";"0";"10";"63";"76169"
"6";"2";"4";"10";"63";"76176"
"3";"1";"2";"10";"63";"76178"
"2";"1";"1";"10";"63";"76181"
"6";"2";"4";"10";"63";"76190"
"1";"1";"0";"10";"63";"76193"
"1";"1";"0";"10";"63";"76196"
"1";"0";"1";"10";"63";"76208"
"3";"0";"3";"10";"63";"76210"
"2";"1";"1";"10";"63";"76213"
"1";"1";"0";"10";"63";"76214"
"8";"2";"6";"10";"63";"76217"
"5";"0";"5";"10";"63";"76218"
"2";"1";"1";"10";"63";"76219"
"5";"0";"5";"10";"63";"76224"
"2";"0";"2";"10";"63";"76226"
"2";"0";"2";"10";"63";"76228"
"4";"1";"3";"10";"63";"76229"
"3";"1";"2";"10";"63";"76230"
"1";"0";"1";"10";"63";"76231"
"22";"13";"9";"10";"63";"76232"
"3";"2";"1";"10";"63";"76234"
"1";"0";"1";"10";"63";"76237"
"5";"1";"4";"10";"63";"76244"
"2";"0";"2";"10";"63";"76260"
"3";"1";"2";"10";"63";"76262"
"1";"0";"1";"10";"63";"76266"
"3";"1";"2";"10";"63";"76275"
"5";"2";"3";"10";"63";"76282"
"2";"0";"2";"10";"63";"76284"
"3";"1";"2";"10";"63";"76291"
"1";"0";"1";"10";"63";"76305"
"2";"0";"2";"10";"63";"76310"
"5";"0";"5";"10";"63";"76318"
"2";"1";"1";"10";"63";"76319"
"2";"0";"2";"10";"63";"76321"
"5";"1";"4";"10";"63";"76325"
"9";"2";"7";"10";"63";"76326"
"1";"0";"1";"10";"63";"76327"
"2";"1";"1";"10";"63";"76328"
"3";"1";"2";"10";"63";"76331"
"3";"0";"3";"10";"63";"76334"
"5";"1";"4";"10";"63";"76344"
"2";"2";"0";"10";"63";"76354"
"2";"1";"1";"10";"63";"76359"
"5";"1";"4";"10";"63";"76375"
"4";"2";"2";"10";"63";"76376"
"2";"1";"1";"10";"63";"76379"
"1";"1";"0";"10";"63";"76387"
"2";"0";"2";"10";"63";"76392"
"3";"0";"3";"10";"63";"76394"
"8";"2";"6";"10";"63";"76395"
"2";"0";"2";"10";"63";"76406"
"1";"0";"1";"10";"63";"76407"
"3";"0";"3";"10";"63";"76417"
"1";"1";"0";"10";"63";"76418"
"9";"3";"6";"10";"63";"76419"
"4";"1";"3";"10";"63";"76424"
"1";"1";"0";"10";"63";"76431"
"2";"1";"1";"10";"63";"76433"
"2";"0";"2";"10";"63";"76434"
"3";"1";"2";"10";"63";"76435"
"2";"1";"1";"10";"63";"76442"
"4";"1";"3";"10";"63";"76455"
"1";"0";"1";"10";"63";"76460"
"3";"1";"2";"10";"63";"76461"
"3";"0";"3";"10";"63";"76462"
"1";"1";"0";"10";"63";"76463"
"5";"3";"2";"10";"63";"76466"
"4";"2";"2";"10";"63";"76468"
"8";"4";"4";"10";"63";"76471"
"3";"1";"2";"10";"63";"76474"
"5";"0";"5";"10";"63";"76489"
"3";"0";"3";"10";"63";"76491"
"1";"0";"1";"10";"63";"76496"
"1";"1";"0";"10";"63";"76501"
"5";"0";"5";"10";"63";"76504"
"1";"0";"1";"10";"63";"76505"
"2";"1";"1";"10";"63";"76506"
"11";"6";"5";"10";"63";"76507"
"4";"2";"2";"10";"63";"76509"
"1";"1";"0";"10";"63";"76522"
"3";"0";"3";"10";"63";"76523"
"1";"1";"0";"10";"63";"76524"
"28";"18";"10";"10";"63";"76531"
"5";"1";"4";"10";"63";"76535"
"1";"0";"1";"10";"63";"76538"
"3";"0";"3";"10";"63";"76540"
"1";"0";"1";"10";"63";"76545"
"1";"1";"0";"10";"63";"76548"
"5";"1";"4";"10";"63";"76551"
"2";"0";"2";"10";"63";"76552"
"3";"0";"3";"10";"63";"76555"
"2";"0";"2";"10";"63";"76556"
"2";"0";"2";"10";"63";"76558"
"1";"0";"1";"10";"63";"76565"
"2";"0";"2";"10";"63";"76567"
"5";"5";"0";"10";"63";"76570"
"3";"1";"2";"10";"63";"76571"
"3";"0";"3";"10";"63";"76574"
"3";"0";"3";"10";"63";"76576"
"1";"1";"0";"10";"63";"76577"
"2";"0";"2";"10";"63";"76584"
"4";"1";"3";"10";"63";"76585"
"2";"0";"2";"10";"63";"76588"
"1";"0";"1";"10";"63";"76589"
"5";"1";"4";"10";"63";"76591"
"5";"2";"3";"10";"63";"76593"
"3";"0";"3";"10";"63";"76594"
"3";"1";"2";"10";"63";"76595"
"1";"0";"1";"10";"63";"76596"
"6";"2";"4";"10";"63";"76598"
"3";"0";"3";"10";"63";"76603"
"4";"0";"4";"10";"63";"76608"
"3";"1";"2";"10";"63";"76610"
"1";"1";"0";"10";"63";"76611"
"6";"2";"4";"10";"63";"76612"
"3";"1";"2";"10";"63";"76618"
"5";"1";"4";"10";"63";"76619"
"9";"1";"8";"10";"63";"76620"
"2";"1";"1";"10";"63";"76626"
"7";"1";"6";"10";"63";"76631"
"2";"1";"1";"10";"63";"76632"
"7";"3";"4";"10";"63";"76634"
"3";"1";"2";"10";"63";"76635"
"4";"1";"3";"10";"63";"76643"
"1";"0";"1";"10";"63";"76644"
"3";"2";"1";"10";"63";"76645"
"3";"2";"1";"10";"63";"76646"
"2";"0";"2";"10";"63";"76647"
"1";"0";"1";"10";"63";"76649"
"4";"1";"3";"10";"63";"76650"
"1";"0";"1";"10";"63";"76652"
"1";"0";"1";"10";"63";"76654"
"1";"0";"1";"10";"63";"76658"
"1";"1";"0";"10";"63";"76660"
"8";"2";"6";"10";"63";"76663"
"2";"2";"0";"10";"63";"76672"
"5";"2";"3";"10";"63";"76675"
"2";"2";"0";"10";"63";"76679"
"5";"1";"4";"10";"63";"76683"
"1";"0";"1";"10";"63";"76686"
"2";"0";"2";"10";"63";"76696"
"1";"1";"0";"10";"63";"76697"
"5";"2";"3";"10";"63";"76705"
"3";"0";"3";"10";"63";"76708"
"4";"1";"3";"10";"63";"76718"
"3";"1";"2";"10";"63";"76720"
"4";"1";"3";"10";"63";"76723"
"1";"1";"0";"10";"63";"76725"
"2";"0";"2";"10";"63";"76726"
"7";"1";"6";"10";"63";"76727"
"5";"1";"4";"10";"63";"76731"
"1";"1";"0";"10";"63";"76736"
"5";"1";"4";"10";"63";"76737"
"2";"0";"2";"10";"63";"76745"
"2";"0";"2";"10";"63";"76760"
"5";"1";"4";"10";"63";"76762"
"1";"1";"0";"10";"63";"76765"
"2";"0";"2";"10";"63";"76766"
"2";"0";"2";"10";"63";"76767"
"4";"0";"4";"10";"63";"76774"
"1";"1";"0";"10";"63";"76779"
"1";"1";"0";"10";"63";"76783"
"1";"1";"0";"10";"63";"76785"
"3";"1";"2";"10";"63";"76787"
"3";"1";"2";"10";"63";"76796"
"6";"2";"4";"10";"63";"76801"
"3";"1";"2";"10";"63";"76803"
"3";"1";"2";"10";"63";"76812"
"4";"3";"1";"10";"63";"76814"
"1";"0";"1";"10";"63";"76818"
"1";"1";"0";"10";"63";"76819"
"3";"0";"3";"10";"63";"76820"
"5";"0";"5";"10";"63";"76823"
"6";"1";"5";"10";"63";"76824"
"4";"1";"3";"10";"63";"76829"
"4";"0";"4";"10";"63";"76830"
"2";"1";"1";"10";"63";"76833"
"1";"1";"0";"10";"63";"76836"
"1";"0";"1";"10";"63";"76838"
"1";"0";"1";"10";"63";"76841"
"2";"1";"1";"10";"63";"76844"
"3";"1";"2";"10";"63";"76847"
"3";"0";"3";"10";"63";"76848"
"2";"0";"2";"10";"63";"76850"
"1";"0";"1";"10";"63";"76851"
"3";"1";"2";"10";"63";"76858"
"3";"0";"3";"10";"63";"76863"
"4";"2";"2";"10";"63";"76865"
"1";"0";"1";"10";"63";"76868"
"3";"0";"3";"10";"63";"76875"
"1";"0";"1";"10";"63";"76878"
"2";"1";"1";"10";"63";"76879"
"3";"1";"2";"10";"63";"76880"
"5";"1";"4";"10";"63";"76883"
"15";"2";"13";"10";"63";"76888"
"3";"1";"2";"10";"63";"76891"
"1";"1";"0";"10";"63";"76892"
"6";"2";"4";"10";"63";"76893"
"1";"1";"0";"10";"63";"76894"
"2";"1";"1";"10";"63";"76895"
"14";"4";"10";"10";"63";"76896"
"3";"0";"3";"10";"63";"76901"
"11";"3";"8";"10";"63";"76905"
"2";"0";"2";"10";"63";"76909"
"1";"1";"0";"10";"63";"76919"
"4";"1";"3";"10";"63";"76920"
"1";"0";"1";"10";"63";"76922"
"4";"1";"3";"10";"63";"76923"
"8";"3";"5";"10";"63";"76924"
"3";"0";"3";"10";"63";"76927"
"1";"1";"0";"10";"63";"76928"
"4";"1";"3";"10";"63";"76935"
"13";"2";"11";"10";"63";"76936"
"1";"0";"1";"10";"63";"76937"
"1";"1";"0";"10";"63";"76938"
"2";"0";"2";"10";"63";"76940"
"5";"1";"4";"10";"63";"76950"
"3";"0";"3";"10";"63";"76953"
"6";"2";"4";"10";"63";"76958"
"1";"0";"1";"10";"63";"76960"
"1";"1";"0";"10";"63";"76962"
"2";"0";"2";"10";"63";"76967"
"8";"1";"7";"10";"63";"76975"
"2";"0";"2";"10";"63";"76976"
"7";"2";"5";"10";"63";"76977"
"1";"0";"1";"10";"63";"76985"
"2";"1";"1";"10";"63";"76990"
"3";"1";"2";"10";"63";"76993"
"20";"12";"8";"10";"63";"76994"
"5";"1";"4";"10";"63";"76996"
"2";"1";"1";"10";"63";"76998"
"1";"1";"0";"10";"63";"77002"
"5";"0";"5";"10";"63";"77007"
"1";"0";"1";"10";"63";"77016"
"5";"2";"3";"10";"63";"77018"
"2";"1";"1";"10";"63";"77020"
"4";"1";"3";"10";"63";"77023"
"1";"1";"0";"10";"63";"77028"
"3";"1";"2";"10";"63";"77029"
"17";"7";"10";"10";"63";"77037"
"6";"1";"5";"10";"63";"77041"
"33";"17";"16";"10";"63";"77047"
"2";"0";"2";"10";"63";"77063"
"6";"2";"4";"10";"63";"77066"
"2";"0";"2";"10";"63";"77067"
"5";"1";"4";"10";"63";"77077"
"2";"0";"2";"10";"63";"77080"
"15";"12";"3";"10";"63";"77083"
"3";"1";"2";"10";"63";"77085"
"4";"1";"3";"10";"63";"77086"
"4";"1";"3";"10";"63";"77095"
"2";"0";"2";"10";"63";"77097"
"5";"1";"4";"10";"63";"77100"
"1";"0";"1";"10";"63";"77103"
"24";"17";"7";"10";"63";"77105"
"1";"0";"1";"10";"63";"77109"
"3";"0";"3";"10";"63";"77111"
"2";"1";"1";"10";"63";"77113"
"1";"1";"0";"10";"63";"77123"
"1";"1";"0";"10";"63";"77126"
"3";"1";"2";"10";"63";"77128"
"1";"0";"1";"10";"63";"77134"
"9";"1";"8";"10";"63";"77142"
"2";"1";"1";"10";"63";"77144"
"4";"0";"4";"10";"63";"77147"
"4";"0";"4";"10";"63";"77153"
"2";"0";"2";"10";"63";"77162"
"2";"1";"1";"10";"63";"77164"
"1";"1";"0";"10";"63";"77165"
"1";"1";"0";"10";"63";"77166"
"7";"3";"4";"10";"63";"77170"
"5";"1";"4";"10";"63";"77171"
"1";"1";"0";"10";"63";"77173"
"2";"0";"2";"10";"63";"77174"
"5";"0";"5";"10";"63";"77177"
"4";"1";"3";"10";"63";"77185"
"1";"1";"0";"10";"63";"77187"
"1";"0";"1";"10";"63";"77194"
"5";"2";"3";"10";"63";"77195"
"2";"0";"2";"10";"63";"77196"
"2";"0";"2";"10";"63";"77198"
"1";"0";"1";"10";"63";"77199"
"4";"1";"3";"10";"63";"77202"
"5";"0";"5";"10";"63";"77206"
"3";"1";"2";"10";"63";"77207"
"9";"2";"7";"10";"63";"77208"
"1";"1";"0";"10";"63";"77210"
"1";"1";"0";"10";"63";"77211"
"3";"0";"3";"10";"63";"77214"
"4";"0";"4";"10";"63";"77215"
"5";"1";"4";"10";"63";"77228"
"2";"1";"1";"10";"63";"77233"
"6";"1";"5";"10";"63";"77237"
"4";"0";"4";"10";"63";"77238"
"3";"0";"3";"10";"63";"77239"
"7";"2";"5";"10";"63";"77240"
"1";"1";"0";"10";"63";"77243"
"1";"1";"0";"10";"63";"77247"
"8";"3";"5";"10";"63";"77250"
"5";"0";"5";"10";"63";"77251"
"1";"0";"1";"10";"63";"77258"
"5";"0";"5";"10";"63";"77259"
"23";"15";"8";"10";"63";"77263"
"1";"0";"1";"10";"63";"77264"
"3";"0";"3";"10";"63";"77265"
"1";"1";"0";"10";"63";"77268"
"1";"1";"0";"10";"63";"77269"
"4";"1";"3";"10";"63";"77270"
"2";"0";"2";"10";"63";"77271"
"8";"4";"4";"10";"63";"77272"
"1";"0";"1";"10";"63";"77276"
"1";"0";"1";"10";"63";"77277"
"1";"0";"1";"10";"63";"77282"
"2";"0";"2";"10";"63";"77285"
"8";"2";"6";"10";"63";"77292"
"1";"0";"1";"10";"63";"77300"
"5";"1";"4";"10";"63";"77305"
"1";"1";"0";"10";"63";"77306"
"1";"0";"1";"10";"63";"77309"
"2";"1";"1";"10";"63";"77310"
"5";"1";"4";"10";"63";"77315"
"5";"1";"4";"10";"63";"77317"
"2";"1";"1";"10";"63";"77318"
"1";"0";"1";"10";"63";"77320"
"2";"0";"2";"10";"63";"77325"
"8";"1";"7";"10";"63";"77329"
"1";"1";"0";"10";"63";"77333"
"6";"0";"6";"10";"63";"77334"
"4";"1";"3";"10";"63";"77339"
"3";"0";"3";"10";"63";"77343"
"1";"1";"0";"10";"63";"77348"
"2";"1";"1";"10";"63";"77349"
"1";"1";"0";"10";"63";"77351"
"3";"0";"3";"10";"63";"77352"
"1";"1";"0";"10";"63";"77354"
"2";"0";"2";"10";"63";"77357"
"1";"1";"0";"10";"63";"77361"
"6";"1";"5";"10";"63";"77362"
"3";"0";"3";"10";"63";"77366"
"2";"1";"1";"10";"63";"77369"
"2";"1";"1";"10";"63";"77371"
"1";"1";"0";"10";"63";"77374"
"1";"0";"1";"10";"63";"77377"
"1";"1";"0";"10";"63";"77379"
"5";"2";"3";"10";"63";"77390"
"1";"0";"1";"10";"63";"77391"
"2";"1";"1";"10";"63";"77397"
"6";"1";"5";"10";"63";"77399"
"5";"2";"3";"10";"63";"77400"
"5";"1";"4";"10";"63";"77406"
"1";"1";"0";"10";"63";"77410"
"1";"0";"1";"10";"63";"77411"
"6";"0";"6";"10";"63";"77415"
"1";"1";"0";"10";"63";"77417"
"9";"1";"8";"10";"63";"77418"
"6";"2";"4";"10";"63";"77425"
"3";"1";"2";"10";"63";"77426"
"3";"0";"3";"10";"63";"77429"
"1";"1";"0";"10";"63";"77431"
"8";"2";"6";"10";"63";"77439"
"1";"0";"1";"10";"63";"77441"
"1";"0";"1";"10";"63";"77444"
"6";"2";"4";"10";"63";"77445"
"2";"0";"2";"10";"63";"77447"
"4";"0";"4";"10";"63";"77448"
"2";"0";"2";"10";"63";"77449"
"4";"0";"4";"10";"63";"77455"
"1";"1";"0";"10";"63";"77457"
"1";"1";"0";"10";"63";"77459"
"2";"1";"1";"10";"63";"77460"
"5";"2";"3";"10";"63";"77461"
"3";"0";"3";"10";"63";"77466"
"1";"0";"1";"10";"63";"77467"
"2";"0";"2";"10";"63";"77473"
"1";"1";"0";"10";"63";"77475"
"4";"0";"4";"10";"63";"77476"
"5";"2";"3";"10";"63";"77479"
"1";"0";"1";"10";"63";"77485"
"6";"2";"4";"10";"63";"77487"
"4";"1";"3";"10";"63";"77488"
"3";"1";"2";"10";"63";"77491"
"3";"0";"3";"10";"63";"77493"
"4";"1";"3";"10";"63";"77495"
"5";"1";"4";"10";"63";"77496"
"2";"0";"2";"10";"63";"77497"
"4";"2";"2";"10";"63";"77498"
"4";"1";"3";"10";"63";"77501"
"1";"1";"0";"10";"63";"77502"
"2";"1";"1";"10";"63";"77509"
"3";"0";"3";"10";"63";"77514"
"2";"0";"2";"10";"63";"77524"
"2";"0";"2";"10";"63";"77527"
"4";"1";"3";"10";"63";"77531"
"5";"2";"3";"10";"63";"77532"
"8";"2";"6";"10";"63";"77537"
"1";"0";"1";"10";"63";"77538"
"1";"0";"1";"10";"63";"77540"
"1";"0";"1";"10";"63";"77541"
"1";"0";"1";"10";"63";"77542"
"3";"1";"2";"10";"63";"77543"
"1";"1";"0";"10";"63";"77544"
"2";"2";"0";"10";"63";"77546"
"2";"0";"2";"10";"63";"77548"
"8";"1";"7";"10";"63";"77551"
"7";"2";"5";"10";"63";"77554"
"5";"2";"3";"10";"63";"77558"
"1";"0";"1";"10";"63";"77562"
"3";"0";"3";"10";"63";"77565"
"6";"1";"5";"10";"63";"77573"
"5";"1";"4";"10";"63";"77574"
"4";"1";"3";"10";"63";"77578"
"4";"1";"3";"10";"63";"77579"
"3";"1";"2";"10";"63";"77581"
"6";"1";"5";"10";"63";"77582"
"4";"1";"3";"10";"63";"77583"
"3";"1";"2";"10";"63";"77586"
"3";"0";"3";"10";"63";"77589"
"5";"1";"4";"10";"63";"77592"
"3";"1";"2";"10";"63";"77593"
"6";"1";"5";"10";"63";"77595"
"3";"0";"3";"10";"63";"77599"
"2";"0";"2";"10";"63";"77603"
"5";"2";"3";"10";"63";"77604"
"2";"0";"2";"10";"63";"77607"
"2";"0";"2";"10";"63";"77608"
"1";"0";"1";"10";"63";"77611"
"2";"0";"2";"10";"63";"77613"
"3";"0";"3";"10";"63";"77614"
"1";"0";"1";"10";"63";"77616"
"3";"0";"3";"10";"63";"77619"
"3";"1";"2";"10";"63";"77622"
"1";"0";"1";"10";"63";"77623"
"1";"0";"1";"10";"63";"77624"
"1";"0";"1";"10";"63";"77627"
"1";"0";"1";"10";"63";"77630"
"4";"0";"4";"10";"63";"77631"
"2";"0";"2";"10";"63";"77632"
"2";"0";"2";"10";"63";"77633"
"1";"0";"1";"10";"63";"77635"
"1";"0";"1";"10";"63";"77638"
"3";"0";"3";"10";"63";"77639"
"1";"0";"1";"10";"63";"77641"
"1";"0";"1";"10";"63";"77643"
"4";"0";"4";"10";"63";"77645"
"1";"1";"0";"10";"63";"77648"
"2";"0";"2";"10";"63";"77649"
"2";"0";"2";"10";"63";"77651"
"2";"0";"2";"10";"63";"77655"
"1";"0";"1";"10";"63";"77656"
"3";"0";"3";"10";"63";"77663"
"3";"0";"3";"10";"63";"77664"
"1";"0";"1";"10";"63";"77666"
"2";"0";"2";"10";"63";"77667"
"1";"0";"1";"10";"63";"77668"
"2";"0";"2";"10";"63";"77672"
"2";"1";"1";"10";"63";"77674"
"3";"0";"3";"10";"63";"77675"
"1";"0";"1";"10";"63";"77683"
"4";"1";"3";"10";"63";"77685"
"2";"0";"2";"10";"63";"77687"
"2";"1";"1";"10";"63";"77690"
